date_sk,machine_sk,shift_sk,product_sk,units_good,units_scrap,units_total,ideal_rate_per_min,planned_minutes
1,1,1,37,464,35,499,1.2,480
1,1,2,16,348,51,399,1.2,480
1,1,3,1,781,80,861,1.5,480
1,2,1,29,421,30,451,0.8,480
1,2,2,1,598,13,611,1.5,480
1,2,3,39,728,20,748,1.0,480
1,3,1,21,624,59,683,1.5,480
1,3,2,19,254,9,263,1.5,480
1,3,3,22,567,74,641,1.2,480
1,4,1,26,558,8,566,1.0,480
1,4,2,3,558,26,584,1.5,480
1,4,3,16,689,41,730,1.2,480
1,5,2,16,463,41,504,1.2,480
1,5,3,22,605,86,691,1.2,480
1,6,1,7,414,14,428,1.0,480
1,6,2,34,258,15,273,1.0,480
1,6,3,39,204,20,224,1.0,480
1,7,1,20,724,10,734,1.5,480
1,7,2,27,707,89,796,0.8,480
1,8,2,12,287,24,311,1.5,480
1,9,1,8,229,6,235,1.0,480
1,9,3,24,541,4,545,1.0,480
1,10,1,16,327,11,338,1.2,480
1,10,2,39,725,61,786,1.0,480
1,10,3,19,486,23,509,1.5,480
1,11,1,3,215,23,238,1.5,480
1,11,2,15,744,13,757,1.2,480
1,12,1,30,456,5,461,1.5,480
1,12,3,21,234,20,254,1.5,480
1,13,1,35,413,55,468,0.8,480
1,13,2,21,673,90,763,1.5,480
1,13,3,17,760,35,795,1.2,480
1,14,1,1,645,77,722,1.5,480
1,14,2,34,451,56,507,1.0,480
1,14,3,33,719,67,786,0.8,480
1,15,1,39,507,6,513,1.0,480
1,15,2,30,315,9,324,1.5,480
1,15,3,5,307,18,325,1.0,480
2,1,2,14,791,40,831,1.0,480
2,1,3,4,771,25,796,0.8,480
2,2,2,18,770,59,829,1.2,480
2,3,1,24,548,68,616,1.0,480
2,3,3,18,628,86,714,1.2,480
2,4,1,10,457,11,468,1.2,480
2,4,3,21,671,80,751,1.5,480
2,5,1,13,630,12,642,1.0,480
2,5,3,26,571,33,604,1.0,480
2,6,1,7,230,15,245,1.0,480
2,6,3,9,555,9,564,1.0,480
2,7,1,37,487,12,499,1.2,480
2,7,2,24,425,19,444,1.0,480
2,8,1,10,576,35,611,1.2,480
2,8,2,26,640,5,645,1.0,480
2,8,3,1,658,68,726,1.5,480
2,9,1,33,704,11,715,0.8,480
2,9,3,30,726,96,822,1.5,480
2,10,2,21,302,1,303,1.5,480
2,10,3,11,351,36,387,1.0,480
2,11,1,10,783,66,849,1.2,480
2,11,2,13,554,9,563,1.0,480
2,11,3,7,252,0,252,1.0,480
2,12,1,23,763,97,860,1.2,480
2,12,2,22,462,45,507,1.2,480
2,12,3,10,314,35,349,1.2,480
2,13,1,23,342,40,382,1.2,480
2,14,1,24,403,50,453,1.0,480
2,14,2,13,380,35,415,1.0,480
2,14,3,13,388,38,426,1.0,480
2,15,1,35,382,7,389,0.8,480
2,15,2,31,729,54,783,1.2,480
2,15,3,8,431,40,471,1.0,480
3,1,1,32,257,17,274,0.8,480
3,1,2,27,747,92,839,0.8,480
3,1,3,15,396,4,400,1.2,480
3,2,3,29,408,1,409,0.8,480
3,3,1,27,328,8,336,0.8,480
3,3,3,23,297,11,308,1.2,480
3,4,1,40,594,52,646,1.5,480
3,4,2,5,706,14,720,1.0,480
3,4,3,28,698,54,752,1.5,480
3,5,1,16,597,48,645,1.2,480
3,5,2,29,348,10,358,0.8,480
3,5,3,14,556,6,562,1.0,480
3,6,1,31,547,71,618,1.2,480
3,6,2,12,319,35,354,1.5,480
3,6,3,21,279,34,313,1.5,480
3,7,1,6,642,87,729,1.5,480
3,7,2,34,383,42,425,1.0,480
3,7,3,34,713,19,732,1.0,480
3,8,1,8,730,94,824,1.0,480
3,8,2,16,471,6,477,1.2,480
3,8,3,3,665,52,717,1.5,480
3,9,1,34,400,22,422,1.0,480
3,9,2,10,511,71,582,1.2,480
3,9,3,31,368,14,382,1.2,480
3,10,1,9,648,61,709,1.0,480
3,10,2,36,733,20,753,0.8,480
3,10,3,19,586,11,597,1.5,480
3,11,3,29,252,28,280,0.8,480
3,12,1,13,584,17,601,1.0,480
3,12,2,8,554,62,616,1.0,480
3,12,3,9,466,10,476,1.0,480
3,13,1,16,485,2,487,1.2,480
3,13,2,18,525,8,533,1.2,480
3,13,3,16,212,22,234,1.2,480
3,14,1,2,698,26,724,0.8,480
3,14,2,37,676,13,689,1.2,480
3,14,3,38,795,15,810,1.5,480
3,15,1,6,747,92,839,1.5,480
3,15,3,18,255,25,280,1.2,480
4,1,1,40,307,8,315,1.5,480
4,1,2,39,467,64,531,1.0,480
4,1,3,31,472,64,536,1.2,480
4,2,1,34,661,14,675,1.0,480
4,2,2,3,292,1,293,1.5,480
4,2,3,16,387,25,412,1.2,480
4,3,1,29,637,5,642,0.8,480
4,4,2,3,436,48,484,1.5,480
4,4,3,10,454,2,456,1.2,480
4,5,1,34,273,6,279,1.0,480
4,5,3,8,765,20,785,1.0,480
4,6,1,35,359,13,372,0.8,480
4,6,2,22,694,53,747,1.2,480
4,6,3,20,521,77,598,1.5,480
4,7,1,16,309,40,349,1.2,480
4,7,2,11,281,14,295,1.0,480
4,8,2,5,606,87,693,1.0,480
4,8,3,30,503,33,536,1.5,480
4,9,2,20,657,30,687,1.5,480
4,9,3,40,239,17,256,1.5,480
4,10,1,10,713,93,806,1.2,480
4,10,2,32,697,102,799,0.8,480
4,10,3,31,377,47,424,1.2,480
4,11,1,39,641,32,673,1.0,480
4,11,2,13,248,27,275,1.0,480
4,11,3,16,751,93,844,1.2,480
4,12,1,24,706,98,804,1.0,480
4,12,2,12,508,21,529,1.5,480
4,13,1,4,463,55,518,0.8,480
4,13,2,24,681,47,728,1.0,480
4,13,3,29,691,97,788,0.8,480
4,14,1,10,449,0,449,1.2,480
4,14,2,28,631,31,662,1.5,480
4,14,3,17,325,2,327,1.2,480
4,15,1,23,277,2,279,1.2,480
4,15,2,32,209,20,229,0.8,480
4,15,3,39,485,29,514,1.0,480
5,1,1,22,513,70,583,1.2,480
5,1,2,30,771,64,835,1.5,480
5,1,3,2,759,71,830,0.8,480
5,2,1,2,271,25,296,0.8,480
5,2,2,31,244,28,272,1.2,480
5,2,3,24,206,5,211,1.0,480
5,3,2,30,472,58,530,1.5,480
5,3,3,31,265,21,286,1.2,480
5,4,1,7,479,58,537,1.0,480
5,4,2,25,420,42,462,1.5,480
5,4,3,17,443,6,449,1.2,480
5,5,1,23,300,33,333,1.2,480
5,5,2,17,479,5,484,1.2,480
5,5,3,31,237,11,248,1.2,480
5,6,1,33,428,24,452,0.8,480
5,6,2,34,777,51,828,1.0,480
5,6,3,36,220,23,243,0.8,480
5,7,2,16,496,41,537,1.2,480
5,7,3,31,606,22,628,1.2,480
5,8,1,24,267,7,274,1.0,480
5,8,2,26,375,13,388,1.0,480
5,9,1,18,393,25,418,1.2,480
5,9,2,10,548,63,611,1.2,480
5,10,1,38,401,16,417,1.5,480
5,10,3,38,611,11,622,1.5,480
5,11,2,3,524,38,562,1.5,480
5,11,3,40,452,18,470,1.5,480
5,12,1,34,295,20,315,1.0,480
5,12,2,28,474,58,532,1.5,480
5,12,3,15,380,11,391,1.2,480
5,13,1,21,623,74,697,1.5,480
5,13,2,31,308,33,341,1.2,480
5,13,3,20,467,17,484,1.5,480
5,14,1,3,547,20,567,1.5,480
5,14,2,16,425,17,442,1.2,480
5,14,3,26,374,26,400,1.0,480
5,15,1,36,578,14,592,0.8,480
5,15,3,9,715,32,747,1.0,480
6,1,1,16,240,23,263,1.2,480
6,1,2,17,430,45,475,1.2,480
6,1,3,7,282,1,283,1.0,480
6,2,1,13,426,30,456,1.0,480
6,2,3,24,572,68,640,1.0,480
6,3,1,31,232,11,243,1.2,480
6,3,2,37,462,5,467,1.2,480
6,3,3,20,430,28,458,1.5,480
6,4,1,20,281,34,315,1.5,480
6,4,2,6,766,32,798,1.5,480
6,5,1,1,310,18,328,1.5,480
6,5,2,7,708,1,709,1.0,480
6,5,3,7,297,1,298,1.0,480
6,6,1,11,505,13,518,1.0,480
6,6,2,6,443,54,497,1.5,480
6,6,3,17,602,14,616,1.2,480
6,7,3,14,229,0,229,1.0,480
6,8,1,27,414,47,461,0.8,480
6,8,2,5,772,5,777,1.0,480
6,8,3,36,365,17,382,0.8,480
6,9,1,35,698,70,768,0.8,480
6,9,3,37,657,65,722,1.2,480
6,10,1,16,542,16,558,1.2,480
6,10,2,39,660,33,693,1.0,480
6,10,3,11,211,12,223,1.0,480
6,11,1,29,559,34,593,0.8,480
6,11,3,4,402,31,433,0.8,480
6,12,1,4,532,14,546,0.8,480
6,12,2,39,468,38,506,1.0,480
6,12,3,38,454,61,515,1.5,480
6,13,1,16,712,19,731,1.2,480
6,13,2,17,254,29,283,1.2,480
6,13,3,4,285,2,287,0.8,480
6,14,1,32,676,21,697,0.8,480
6,14,2,31,763,86,849,1.2,480
6,14,3,11,453,8,461,1.0,480
6,15,1,21,270,36,306,1.5,480
6,15,2,21,543,44,587,1.5,480
6,15,3,21,250,7,257,1.5,480
7,1,1,11,692,62,754,1.0,480
7,1,2,24,577,31,608,1.0,480
7,2,1,19,630,71,701,1.5,480
7,2,2,9,644,16,660,1.0,480
7,2,3,16,300,31,331,1.2,480
7,3,1,5,215,10,225,1.0,480
7,3,2,39,337,10,347,1.0,480
7,3,3,20,367,47,414,1.5,480
7,4,2,19,429,18,447,1.5,480
7,4,3,21,246,30,276,1.5,480
7,5,1,9,311,7,318,1.0,480
7,5,2,32,479,32,511,0.8,480
7,5,3,9,734,101,835,1.0,480
7,6,1,4,543,44,587,0.8,480
7,6,2,21,436,8,444,1.5,480
7,7,1,33,682,35,717,0.8,480
7,7,2,3,469,60,529,1.5,480
7,8,1,20,513,17,530,1.5,480
7,8,2,15,654,7,661,1.2,480
7,8,3,12,687,44,731,1.5,480
7,9,1,19,650,93,743,1.5,480
7,9,2,17,225,24,249,1.2,480
7,9,3,16,306,3,309,1.2,480
7,10,1,10,772,65,837,1.2,480
7,10,2,24,669,32,701,1.0,480
7,10,3,28,651,74,725,1.5,480
7,11,1,24,781,64,845,1.0,480
7,11,2,19,549,63,612,1.5,480
7,11,3,20,520,48,568,1.5,480
7,12,1,24,281,34,315,1.0,480
7,12,2,22,389,23,412,1.2,480
7,12,3,31,423,43,466,1.2,480
7,13,1,22,304,25,329,1.2,480
7,13,2,34,690,69,759,1.0,480
7,13,3,37,430,15,445,1.2,480
7,14,1,25,709,19,728,1.5,480
7,14,2,37,520,25,545,1.2,480
7,14,3,20,481,35,516,1.5,480
7,15,1,37,671,17,688,1.2,480
7,15,2,40,514,45,559,1.5,480
7,15,3,30,617,12,629,1.5,480
8,1,1,24,789,89,878,1.0,480
8,1,2,31,464,55,519,1.2,480
8,1,3,36,668,25,693,0.8,480
8,2,2,1,489,33,522,1.5,480
8,2,3,10,504,36,540,1.2,480
8,3,1,7,317,13,330,1.0,480
8,3,2,35,329,46,375,0.8,480
8,3,3,6,335,17,352,1.5,480
8,4,1,30,368,20,388,1.5,480
8,4,2,2,684,77,761,0.8,480
8,4,3,9,442,28,470,1.0,480
8,5,1,31,329,43,372,1.2,480
8,5,3,3,641,47,688,1.5,480
8,6,1,11,782,51,833,1.0,480
8,6,2,32,761,77,838,0.8,480
8,6,3,6,694,49,743,1.5,480
8,7,1,14,783,22,805,1.0,480
8,7,2,28,295,39,334,1.5,480
8,7,3,29,255,31,286,0.8,480
8,8,2,14,433,58,491,1.0,480
8,8,3,35,240,17,257,0.8,480
8,9,1,23,702,59,761,1.2,480
8,9,2,34,607,56,663,1.0,480
8,9,3,40,751,91,842,1.5,480
8,10,1,27,669,70,739,0.8,480
8,10,3,36,329,22,351,0.8,480
8,11,3,17,764,75,839,1.2,480
8,12,1,17,330,37,367,1.2,480
8,12,2,17,468,14,482,1.2,480
8,12,3,16,641,13,654,1.2,480
8,13,1,34,652,4,656,1.0,480
8,13,2,23,424,50,474,1.2,480
8,13,3,21,340,25,365,1.5,480
8,14,1,12,513,57,570,1.5,480
8,14,2,20,393,18,411,1.5,480
8,14,3,26,353,5,358,1.0,480
8,15,1,7,653,29,682,1.0,480
8,15,2,12,595,3,598,1.5,480
8,15,3,37,546,75,621,1.2,480
9,1,1,11,715,65,780,1.0,480
9,1,2,31,292,9,301,1.2,480
9,1,3,29,535,77,612,0.8,480
9,2,1,30,352,40,392,1.5,480
9,2,3,9,470,42,512,1.0,480
9,3,3,33,512,67,579,0.8,480
9,4,1,25,371,18,389,1.5,480
9,4,2,38,202,11,213,1.5,480
9,4,3,2,289,3,292,0.8,480
9,5,1,34,399,32,431,1.0,480
9,5,2,3,333,45,378,1.5,480
9,5,3,37,322,28,350,1.2,480
9,6,1,29,556,20,576,0.8,480
9,7,1,38,255,33,288,1.5,480
9,7,2,13,702,23,725,1.0,480
9,7,3,5,275,27,302,1.0,480
9,8,1,26,357,8,365,1.0,480
9,8,3,21,399,10,409,1.5,480
9,9,1,4,511,51,562,0.8,480
9,9,2,27,570,2,572,0.8,480
9,9,3,5,338,29,367,1.0,480
9,10,2,37,584,52,636,1.2,480
9,10,3,21,273,35,308,1.5,480
9,11,1,6,277,15,292,1.5,480
9,11,2,28,775,91,866,1.5,480
9,11,3,26,306,30,336,1.0,480
9,12,3,2,752,97,849,0.8,480
9,13,1,37,386,20,406,1.2,480
9,13,2,21,630,41,671,1.5,480
9,13,3,10,627,65,692,1.2,480
9,14,3,21,678,28,706,1.5,480
9,15,2,5,257,7,264,1.0,480
10,1,1,2,637,5,642,0.8,480
10,1,2,5,502,49,551,1.0,480
10,2,2,18,589,13,602,1.2,480
10,2,3,28,700,93,793,1.5,480
10,3,1,25,724,62,786,1.5,480
10,3,2,17,690,42,732,1.2,480
10,3,3,1,794,23,817,1.5,480
10,4,1,20,785,46,831,1.5,480
10,4,2,22,435,27,462,1.2,480
10,4,3,14,234,18,252,1.0,480
10,5,1,11,661,53,714,1.0,480
10,5,2,36,502,74,576,0.8,480
10,5,3,12,755,19,774,1.5,480
10,6,3,30,479,46,525,1.5,480
10,7,1,35,547,65,612,0.8,480
10,7,2,31,631,59,690,1.2,480
10,7,3,14,328,45,373,1.0,480
10,8,1,11,684,70,754,1.0,480
10,8,2,22,765,39,804,1.2,480
10,8,3,22,355,22,377,1.2,480
10,9,1,25,547,54,601,1.5,480
10,10,2,33,306,7,313,0.8,480
10,10,3,39,578,74,652,1.0,480
10,11,2,16,512,46,558,1.2,480
10,11,3,9,772,33,805,1.0,480
10,12,1,14,276,4,280,1.0,480
10,12,3,33,755,1,756,0.8,480
10,13,1,30,280,40,320,1.5,480
10,13,2,8,350,21,371,1.0,480
10,13,3,28,323,46,369,1.5,480
10,14,1,27,665,39,704,0.8,480
10,14,2,29,742,105,847,0.8,480
10,14,3,10,446,20,466,1.2,480
10,15,2,31,503,23,526,1.2,480
10,15,3,36,687,9,696,0.8,480
11,1,1,1,794,33,827,1.5,480
11,1,2,2,450,64,514,0.8,480
11,1,3,28,296,14,310,1.5,480
11,2,1,9,524,36,560,1.0,480
11,2,2,5,390,32,422,1.0,480
11,2,3,5,517,61,578,1.0,480
11,3,1,19,282,7,289,1.5,480
11,3,2,22,393,24,417,1.2,480
11,4,1,33,506,55,561,0.8,480
11,4,2,5,326,36,362,1.0,480
11,4,3,34,354,42,396,1.0,480
11,5,1,40,662,41,703,1.5,480
11,5,2,36,667,53,720,0.8,480
11,5,3,8,542,58,600,1.0,480
11,6,1,16,723,70,793,1.2,480
11,6,2,19,761,32,793,1.5,480
11,7,1,32,617,82,699,0.8,480
11,8,1,17,256,37,293,1.2,480
11,8,2,17,244,32,276,1.2,480
11,8,3,20,269,21,290,1.5,480
11,9,1,22,420,41,461,1.2,480
11,9,2,13,305,37,342,1.0,480
11,10,1,28,541,35,576,1.5,480
11,10,2,1,241,34,275,1.5,480
11,10,3,18,721,80,801,1.2,480
11,11,1,27,357,41,398,0.8,480
11,11,2,13,736,107,843,1.0,480
11,11,3,4,414,46,460,0.8,480
11,12,1,9,288,32,320,1.0,480
11,12,2,21,607,49,656,1.5,480
11,12,3,5,714,63,777,1.0,480
11,13,1,3,342,50,392,1.5,480
11,13,2,2,661,76,737,0.8,480
11,14,1,4,526,69,595,0.8,480
11,14,2,4,721,48,769,0.8,480
11,14,3,3,733,21,754,1.5,480
11,15,1,36,394,38,432,0.8,480
11,15,2,24,323,44,367,1.0,480
11,15,3,20,316,21,337,1.5,480
12,1,1,15,372,30,402,1.2,480
12,1,2,37,656,5,661,1.2,480
12,1,3,27,644,8,652,0.8,480
12,2,1,17,728,89,817,1.2,480
12,2,2,24,313,20,333,1.0,480
12,2,3,21,549,32,581,1.5,480
12,3,2,24,466,28,494,1.0,480
12,3,3,36,731,18,749,0.8,480
12,4,1,29,612,74,686,0.8,480
12,4,2,2,778,61,839,0.8,480
12,4,3,12,369,45,414,1.5,480
12,5,1,14,708,10,718,1.0,480
12,5,2,25,701,9,710,1.5,480
12,5,3,13,239,16,255,1.0,480
12,6,2,39,292,5,297,1.0,480
12,7,1,19,274,20,294,1.5,480
12,7,2,20,718,43,761,1.5,480
12,7,3,25,749,61,810,1.5,480
12,8,1,33,585,41,626,0.8,480
12,8,2,32,793,114,907,0.8,480
12,8,3,4,424,57,481,0.8,480
12,9,1,34,357,49,406,1.0,480
12,9,2,23,275,38,313,1.2,480
12,9,3,4,324,35,359,0.8,480
12,10,1,4,220,9,229,0.8,480
12,11,2,27,200,7,207,0.8,480
12,12,1,16,526,4,530,1.2,480
12,12,2,29,750,70,820,0.8,480
12,12,3,39,571,73,644,1.0,480
12,13,1,39,415,61,476,1.0,480
12,13,2,4,571,11,582,0.8,480
12,13,3,32,797,24,821,0.8,480
12,14,1,23,705,99,804,1.2,480
12,14,2,16,799,94,893,1.2,480
12,14,3,37,694,34,728,1.2,480
12,15,1,3,749,33,782,1.5,480
12,15,2,8,656,87,743,1.0,480
12,15,3,15,603,63,666,1.2,480
13,1,1,30,767,10,777,1.5,480
13,1,2,16,230,5,235,1.2,480
13,1,3,21,716,70,786,1.5,480
13,2,1,28,227,18,245,1.5,480
13,2,3,10,791,62,853,1.2,480
13,3,1,36,763,87,850,0.8,480
13,3,2,7,435,35,470,1.0,480
13,3,3,10,762,49,811,1.2,480
13,4,1,30,714,8,722,1.5,480
13,4,2,31,783,49,832,1.2,480
13,4,3,1,269,7,276,1.5,480
13,5,1,18,513,46,559,1.2,480
13,5,3,25,599,34,633,1.5,480
13,6,1,20,480,43,523,1.5,480
13,6,2,17,256,18,274,1.2,480
13,6,3,13,345,47,392,1.0,480
13,7,1,6,538,23,561,1.5,480
13,7,2,18,708,12,720,1.2,480
13,7,3,14,302,40,342,1.0,480
13,8,1,8,532,46,578,1.0,480
13,8,2,18,671,95,766,1.2,480
13,8,3,1,779,93,872,1.5,480
13,9,1,27,265,24,289,0.8,480
13,9,3,32,624,23,647,0.8,480
13,10,1,11,366,36,402,1.0,480
13,10,2,29,236,32,268,0.8,480
13,10,3,32,399,39,438,0.8,480
13,11,1,1,594,52,646,1.5,480
13,11,2,4,678,58,736,0.8,480
13,11,3,9,468,33,501,1.0,480
13,12,1,10,265,18,283,1.2,480
13,12,2,16,418,15,433,1.2,480
13,12,3,4,635,59,694,0.8,480
13,13,3,3,663,36,699,1.5,480
13,14,1,11,468,26,494,1.0,480
13,14,2,16,492,23,515,1.2,480
13,14,3,22,205,19,224,1.2,480
13,15,1,39,430,7,437,1.0,480
13,15,2,28,569,51,620,1.5,480
13,15,3,16,537,50,587,1.2,480
14,1,1,1,704,23,727,1.5,480
14,1,2,11,244,33,277,1.0,480
14,2,1,27,200,3,203,0.8,480
14,2,2,27,276,10,286,0.8,480
14,2,3,36,347,18,365,0.8,480
14,3,1,5,270,8,278,1.0,480
14,3,2,13,412,43,455,1.0,480
14,4,1,31,674,66,740,1.2,480
14,4,2,6,421,27,448,1.5,480
14,4,3,20,693,37,730,1.5,480
14,5,1,30,755,33,788,1.5,480
14,5,2,1,795,24,819,1.5,480
14,6,2,25,766,73,839,1.5,480
14,6,3,27,422,47,469,0.8,480
14,7,2,25,370,21,391,1.5,480
14,7,3,8,618,38,656,1.0,480
14,8,1,18,266,9,275,1.2,480
14,8,2,18,603,20,623,1.2,480
14,8,3,19,322,19,341,1.5,480
14,9,1,31,313,26,339,1.2,480
14,9,2,4,619,21,640,0.8,480
14,9,3,24,690,9,699,1.0,480
14,10,1,38,261,25,286,1.5,480
14,10,2,37,693,85,778,1.2,480
14,10,3,30,476,49,525,1.5,480
14,11,1,21,378,37,415,1.5,480
14,11,2,27,599,30,629,0.8,480
14,11,3,34,293,16,309,1.0,480
14,12,1,20,796,50,846,1.5,480
14,12,3,15,608,54,662,1.2,480
14,13,1,40,283,21,304,1.5,480
14,13,2,1,435,2,437,1.5,480
14,13,3,39,667,75,742,1.0,480
14,14,2,30,678,58,736,1.5,480
14,14,3,18,442,33,475,1.2,480
14,15,1,18,384,8,392,1.2,480
14,15,3,13,437,14,451,1.0,480
15,1,2,1,779,96,875,1.5,480
15,1,3,35,660,42,702,0.8,480
15,2,1,18,263,30,293,1.2,480
15,2,2,5,796,48,844,1.0,480
15,3,1,26,794,3,797,1.0,480
15,3,2,29,743,61,804,0.8,480
15,3,3,28,223,32,255,1.5,480
15,4,1,38,618,17,635,1.5,480
15,4,2,30,591,25,616,1.5,480
15,4,3,19,231,24,255,1.5,480
15,5,1,18,668,67,735,1.2,480
15,5,2,20,203,13,216,1.5,480
15,5,3,5,794,72,866,1.0,480
15,6,1,32,461,34,495,0.8,480
15,6,2,9,261,19,280,1.0,480
15,6,3,8,461,66,527,1.0,480
15,7,1,28,711,5,716,1.5,480
15,7,2,28,743,43,786,1.5,480
15,7,3,5,376,8,384,1.0,480
15,8,1,17,521,5,526,1.2,480
15,8,2,14,487,39,526,1.0,480
15,8,3,28,385,41,426,1.5,480
15,9,1,5,308,15,323,1.0,480
15,9,2,13,732,82,814,1.0,480
15,10,1,35,219,5,224,0.8,480
15,10,2,12,279,37,316,1.5,480
15,10,3,17,409,52,461,1.2,480
15,11,1,15,415,53,468,1.2,480
15,11,2,36,314,41,355,0.8,480
15,11,3,1,569,72,641,1.5,480
15,12,1,26,794,112,906,1.0,480
15,12,2,3,280,33,313,1.5,480
15,12,3,21,240,31,271,1.5,480
15,13,1,17,382,39,421,1.2,480
15,13,2,4,312,39,351,0.8,480
15,13,3,39,307,32,339,1.0,480
15,14,1,11,248,35,283,1.0,480
15,14,2,10,609,17,626,1.2,480
15,14,3,20,448,34,482,1.5,480
15,15,1,13,582,71,653,1.0,480
15,15,2,8,262,24,286,1.0,480
15,15,3,33,486,31,517,0.8,480
16,1,1,25,525,68,593,1.5,480
16,1,3,9,588,28,616,1.0,480
16,2,1,6,732,86,818,1.5,480
16,2,2,12,345,43,388,1.5,480
16,2,3,25,717,86,803,1.5,480
16,3,1,20,219,14,233,1.5,480
16,3,2,25,488,42,530,1.5,480
16,3,3,14,642,79,721,1.0,480
16,4,1,22,298,27,325,1.2,480
16,4,2,16,537,76,613,1.2,480
16,5,2,2,606,79,685,0.8,480
16,5,3,11,240,0,240,1.0,480
16,6,1,17,365,12,377,1.2,480
16,6,2,4,469,22,491,0.8,480
16,6,3,1,203,8,211,1.5,480
16,7,3,10,429,35,464,1.2,480
16,8,1,5,725,78,803,1.0,480
16,8,2,31,710,17,727,1.2,480
16,8,3,27,427,27,454,0.8,480
16,9,1,14,663,40,703,1.0,480
16,9,2,5,372,25,397,1.0,480
16,9,3,16,639,35,674,1.2,480
16,10,1,30,498,53,551,1.5,480
16,10,2,8,673,51,724,1.0,480
16,10,3,9,628,35,663,1.0,480
16,11,1,31,708,85,793,1.2,480
16,11,2,31,632,82,714,1.2,480
16,11,3,7,414,15,429,1.0,480
16,12,1,24,272,15,287,1.0,480
16,12,2,16,418,40,458,1.2,480
16,12,3,35,665,33,698,0.8,480
16,13,1,6,275,34,309,1.5,480
16,13,2,32,316,46,362,0.8,480
16,13,3,11,411,10,421,1.0,480
16,14,1,40,406,18,424,1.5,480
16,14,2,27,781,80,861,0.8,480
16,14,3,23,624,33,657,1.2,480
16,15,1,30,472,4,476,1.5,480
16,15,3,31,363,19,382,1.2,480
17,1,1,18,363,27,390,1.2,480
17,1,2,8,358,28,386,1.0,480
17,1,3,15,616,40,656,1.2,480
17,2,1,17,471,20,491,1.2,480
17,2,2,9,786,114,900,1.0,480
17,2,3,12,522,52,574,1.5,480
17,3,1,15,731,98,829,1.2,480
17,3,3,7,450,46,496,1.0,480
17,4,1,15,755,74,829,1.2,480
17,4,2,17,655,68,723,1.2,480
17,4,3,28,619,21,640,1.5,480
17,5,1,38,621,27,648,1.5,480
17,5,2,16,535,67,602,1.2,480
17,5,3,36,361,44,405,0.8,480
17,6,2,12,510,3,513,1.5,480
17,6,3,2,589,16,605,0.8,480
17,7,1,7,798,23,821,1.0,480
17,7,2,33,297,21,318,0.8,480
17,7,3,36,200,21,221,0.8,480
17,8,1,27,352,11,363,0.8,480
17,8,2,4,383,28,411,0.8,480
17,8,3,10,668,71,739,1.2,480
17,9,1,19,416,30,446,1.5,480
17,9,2,3,443,46,489,1.5,480
17,9,3,7,743,29,772,1.0,480
17,10,1,3,669,11,680,1.5,480
17,10,2,5,562,44,606,1.0,480
17,10,3,12,344,38,382,1.5,480
17,11,1,15,676,68,744,1.2,480
17,12,1,28,470,46,516,1.5,480
17,12,2,17,581,82,663,1.2,480
17,12,3,29,322,33,355,0.8,480
17,13,1,27,272,11,283,0.8,480
17,13,3,36,557,26,583,0.8,480
17,14,2,4,534,31,565,0.8,480
17,15,3,39,339,9,348,1.0,480
18,1,1,2,375,3,378,0.8,480
18,1,3,11,395,11,406,1.0,480
18,2,1,9,788,58,846,1.0,480
18,2,2,8,739,36,775,1.0,480
18,2,3,28,395,49,444,1.5,480
18,3,1,37,395,12,407,1.2,480
18,3,3,34,269,14,283,1.0,480
18,4,3,35,251,7,258,0.8,480
18,5,1,35,734,25,759,0.8,480
18,5,2,29,384,6,390,0.8,480
18,5,3,37,200,5,205,1.2,480
18,6,1,9,405,19,424,1.0,480
18,6,2,40,655,44,699,1.5,480
18,7,1,36,377,17,394,0.8,480
18,7,2,33,735,102,837,0.8,480
18,7,3,8,285,32,317,1.0,480
18,8,1,24,320,33,353,1.0,480
18,8,2,23,430,4,434,1.2,480
18,8,3,10,437,11,448,1.2,480
18,9,3,20,615,71,686,1.5,480
18,10,1,20,386,19,405,1.5,480
18,10,3,11,547,66,613,1.0,480
18,11,1,38,330,39,369,1.5,480
18,11,2,3,639,81,720,1.5,480
18,11,3,33,202,29,231,0.8,480
18,12,1,4,786,45,831,0.8,480
18,12,2,12,279,8,287,1.5,480
18,12,3,21,463,44,507,1.5,480
18,13,1,29,693,1,694,0.8,480
18,13,3,23,375,11,386,1.2,480
18,14,2,34,671,33,704,1.0,480
18,14,3,39,700,75,775,1.0,480
18,15,1,15,463,53,516,1.2,480
18,15,2,32,737,4,741,0.8,480
18,15,3,16,667,63,730,1.2,480
19,1,1,3,519,1,520,1.5,480
19,1,2,25,707,11,718,1.5,480
19,2,2,9,766,73,839,1.0,480
19,2,3,22,714,87,801,1.2,480
19,3,1,22,627,0,627,1.2,480
19,3,2,34,415,3,418,1.0,480
19,3,3,34,616,44,660,1.0,480
19,4,1,37,468,54,522,1.2,480
19,4,3,13,446,53,499,1.0,480
19,5,1,14,532,18,550,1.0,480
19,5,2,16,265,17,282,1.2,480
19,5,3,31,707,60,767,1.2,480
19,6,1,28,416,12,428,1.5,480
19,6,2,31,628,56,684,1.2,480
19,6,3,40,534,37,571,1.5,480
19,7,1,36,339,25,364,0.8,480
19,7,2,28,252,9,261,1.5,480
19,7,3,39,608,22,630,1.0,480
19,8,1,17,689,6,695,1.2,480
19,8,3,26,701,55,756,1.0,480
19,9,1,24,750,78,828,1.0,480
19,9,2,26,302,17,319,1.0,480
19,9,3,9,532,25,557,1.0,480
19,10,1,37,341,37,378,1.2,480
19,10,3,7,661,30,691,1.0,480
19,11,1,19,644,28,672,1.5,480
19,11,2,24,694,29,723,1.0,480
19,11,3,2,355,25,380,0.8,480
19,12,2,38,693,3,696,1.5,480
19,12,3,10,606,49,655,1.2,480
19,13,1,24,728,33,761,1.0,480
19,13,2,36,393,43,436,0.8,480
19,13,3,17,431,35,466,1.2,480
19,14,2,32,385,52,437,0.8,480
19,14,3,28,299,43,342,1.5,480
19,15,1,31,647,56,703,1.2,480
19,15,2,1,287,5,292,1.5,480
19,15,3,31,626,13,639,1.2,480
20,1,1,5,680,37,717,1.0,480
20,1,3,37,455,24,479,1.2,480
20,2,1,35,305,16,321,0.8,480
20,2,2,20,536,12,548,1.5,480
20,2,3,31,238,27,265,1.2,480
20,3,1,19,682,66,748,1.5,480
20,4,1,8,738,87,825,1.0,480
20,4,2,18,299,12,311,1.2,480
20,4,3,15,787,105,892,1.2,480
20,5,1,24,455,53,508,1.0,480
20,5,2,6,698,82,780,1.5,480
20,5,3,1,732,19,751,1.5,480
20,6,1,38,767,75,842,1.5,480
20,6,2,1,638,54,692,1.5,480
20,6,3,13,664,23,687,1.0,480
20,7,1,16,441,56,497,1.2,480
20,7,2,31,239,19,258,1.2,480
20,7,3,10,448,63,511,1.2,480
20,8,1,18,538,39,577,1.2,480
20,8,2,21,485,45,530,1.5,480
20,8,3,7,255,22,277,1.0,480
20,9,1,9,476,45,521,1.0,480
20,9,2,24,226,15,241,1.0,480
20,9,3,37,216,29,245,1.2,480
20,10,1,18,528,9,537,1.2,480
20,10,2,33,353,35,388,0.8,480
20,10,3,37,562,68,630,1.2,480
20,11,1,15,630,12,642,1.2,480
20,11,2,26,357,5,362,1.0,480
20,11,3,31,451,0,451,1.2,480
20,12,2,26,505,56,561,1.0,480
20,12,3,9,769,46,815,1.0,480
20,13,1,25,223,32,255,1.5,480
20,13,3,34,459,24,483,1.0,480
20,14,1,5,309,45,354,1.0,480
20,14,3,13,351,40,391,1.0,480
20,15,1,24,211,3,214,1.0,480
20,15,2,3,277,27,304,1.5,480
20,15,3,28,716,31,747,1.5,480
21,1,1,9,540,9,549,1.0,480
21,1,2,7,252,7,259,1.0,480
21,1,3,8,335,25,360,1.0,480
21,2,1,17,640,1,641,1.2,480
21,2,2,25,306,31,337,1.5,480
21,2,3,13,361,26,387,1.0,480
21,3,1,18,503,7,510,1.2,480
21,3,2,36,645,65,710,0.8,480
21,3,3,15,346,10,356,1.2,480
21,4,1,11,548,16,564,1.0,480
21,4,2,38,396,53,449,1.5,480
21,5,1,5,635,82,717,1.0,480
21,5,2,33,469,20,489,0.8,480
21,5,3,35,726,92,818,0.8,480
21,6,1,5,305,1,306,1.0,480
21,6,2,28,667,90,757,1.5,480
21,6,3,2,641,66,707,0.8,480
21,7,1,18,515,24,539,1.2,480
21,7,2,28,260,19,279,1.5,480
21,8,1,3,501,66,567,1.5,480
21,8,2,3,518,65,583,1.5,480
21,8,3,13,701,24,725,1.0,480
21,9,1,24,362,28,390,1.0,480
21,9,2,10,398,0,398,1.2,480
21,9,3,20,714,70,784,1.5,480
21,10,1,35,215,6,221,0.8,480
21,10,2,4,291,36,327,0.8,480
21,10,3,22,649,73,722,1.2,480
21,11,1,18,764,53,817,1.2,480
21,11,3,11,579,69,648,1.0,480
21,12,1,15,675,63,738,1.2,480
21,12,2,7,407,49,456,1.0,480
21,12,3,11,233,10,243,1.0,480
21,13,1,40,355,9,364,1.5,480
21,13,2,31,618,44,662,1.2,480
21,14,1,21,641,35,676,1.5,480
21,14,2,14,510,29,539,1.0,480
21,15,2,21,698,75,773,1.5,480
21,15,3,22,500,9,509,1.2,480
22,1,2,5,285,1,286,1.0,480
22,1,3,10,205,22,227,1.2,480
22,2,1,23,776,38,814,1.2,480
22,2,3,14,369,26,395,1.0,480
22,3,1,39,257,4,261,1.0,480
22,3,2,4,424,48,472,0.8,480
22,4,1,2,762,95,857,0.8,480
22,5,1,12,552,70,622,1.5,480
22,5,2,2,621,81,702,0.8,480
22,5,3,34,278,20,298,1.0,480
22,6,1,12,719,57,776,1.5,480
22,6,2,37,605,69,674,1.2,480
22,6,3,11,310,34,344,1.0,480
22,7,1,8,604,25,629,1.0,480
22,7,2,7,259,5,264,1.0,480
22,7,3,13,410,1,411,1.0,480
22,8,1,27,561,66,627,0.8,480
22,8,2,2,542,73,615,0.8,480
22,9,2,10,658,41,699,1.2,480
22,9,3,19,704,50,754,1.5,480
22,10,3,16,238,13,251,1.2,480
22,11,2,37,683,22,705,1.2,480
22,11,3,18,617,54,671,1.2,480
22,12,1,20,707,26,733,1.5,480
22,12,2,8,229,19,248,1.0,480
22,13,1,11,647,70,717,1.0,480
22,13,2,5,442,13,455,1.0,480
22,13,3,24,295,29,324,1.0,480
22,14,1,6,640,55,695,1.5,480
22,15,1,20,617,62,679,1.5,480
22,15,2,14,766,28,794,1.0,480
23,1,1,26,243,35,278,1.0,480
23,1,2,3,518,35,553,1.5,480
23,1,3,5,426,48,474,1.0,480
23,2,1,27,429,46,475,0.8,480
23,2,3,8,488,24,512,1.0,480
23,3,2,38,621,87,708,1.5,480
23,3,3,40,202,19,221,1.5,480
23,4,1,35,648,39,687,0.8,480
23,4,2,29,227,2,229,0.8,480
23,4,3,34,567,80,647,1.0,480
23,5,1,11,281,22,303,1.0,480
23,5,2,34,649,12,661,1.0,480
23,5,3,14,691,9,700,1.0,480
23,6,1,10,259,17,276,1.2,480
23,6,2,32,566,19,585,0.8,480
23,7,1,17,401,8,409,1.2,480
23,7,2,35,782,110,892,0.8,480
23,7,3,12,790,3,793,1.5,480
23,8,1,3,452,19,471,1.5,480
23,8,2,23,581,29,610,1.2,480
23,8,3,2,779,12,791,0.8,480
23,9,1,19,332,4,336,1.5,480
23,9,2,20,669,23,692,1.5,480
23,10,1,23,590,50,640,1.2,480
23,10,2,29,205,7,212,0.8,480
23,10,3,33,480,51,531,0.8,480
23,11,1,7,585,80,665,1.0,480
23,11,2,40,448,23,471,1.5,480
23,11,3,6,235,18,253,1.5,480
23,12,1,21,789,93,882,1.5,480
23,12,3,39,463,36,499,1.0,480
23,13,1,23,591,73,664,1.2,480
23,13,2,7,567,5,572,1.0,480
23,13,3,26,629,28,657,1.0,480
23,14,1,14,326,37,363,1.0,480
23,14,2,39,569,1,570,1.0,480
23,14,3,34,741,102,843,1.0,480
23,15,2,21,360,39,399,1.5,480
23,15,3,16,706,18,724,1.2,480
24,1,2,18,309,40,349,1.2,480
24,1,3,31,633,24,657,1.2,480
24,2,2,7,469,40,509,1.0,480
24,2,3,6,796,116,912,1.5,480
24,3,1,39,241,7,248,1.0,480
24,3,2,29,734,79,813,0.8,480
24,3,3,17,278,34,312,1.2,480
24,4,1,1,437,55,492,1.5,480
24,4,3,9,648,41,689,1.0,480
24,5,1,8,781,105,886,1.0,480
24,5,3,8,665,39,704,1.0,480
24,6,2,38,775,75,850,1.5,480
24,6,3,12,479,15,494,1.5,480
24,7,1,19,413,1,414,1.5,480
24,7,2,40,617,91,708,1.5,480
24,7,3,34,593,20,613,1.0,480
24,8,1,40,761,94,855,1.5,480
24,8,2,19,751,66,817,1.5,480
24,9,3,25,357,19,376,1.5,480
24,10,1,35,340,43,383,0.8,480
24,10,2,4,371,42,413,0.8,480
24,11,2,10,578,75,653,1.2,480
24,11,3,4,468,23,491,0.8,480
24,12,1,23,403,16,419,1.2,480
24,12,2,28,356,22,378,1.5,480
24,12,3,21,229,26,255,1.5,480
24,13,1,7,466,7,473,1.0,480
24,13,2,26,791,48,839,1.0,480
24,13,3,35,530,25,555,0.8,480
24,14,1,36,602,10,612,0.8,480
24,14,2,26,529,52,581,1.0,480
24,14,3,28,367,25,392,1.5,480
24,15,1,25,678,21,699,1.5,480
24,15,2,33,749,93,842,0.8,480
24,15,3,39,601,50,651,1.0,480
25,1,1,35,748,102,850,0.8,480
25,1,3,13,427,37,464,1.0,480
25,2,1,22,559,63,622,1.2,480
25,2,3,7,646,36,682,1.0,480
25,3,1,28,623,85,708,1.5,480
25,3,2,20,361,26,387,1.5,480
25,3,3,2,387,19,406,0.8,480
25,4,1,18,316,15,331,1.2,480
25,4,2,25,608,73,681,1.5,480
25,4,3,29,633,26,659,0.8,480
25,5,1,11,382,50,432,1.0,480
25,5,3,3,753,57,810,1.5,480
25,6,1,29,706,44,750,0.8,480
25,6,2,10,493,49,542,1.2,480
25,6,3,9,715,54,769,1.0,480
25,7,1,21,436,4,440,1.5,480
25,7,2,12,324,38,362,1.5,480
25,7,3,29,598,8,606,0.8,480
25,8,1,25,674,38,712,1.5,480
25,8,2,10,767,51,818,1.2,480
25,8,3,8,302,43,345,1.0,480
25,9,2,36,690,53,743,0.8,480
25,10,1,24,221,14,235,1.0,480
25,10,2,40,329,24,353,1.5,480
25,10,3,29,641,68,709,0.8,480
25,11,1,35,454,22,476,0.8,480
25,11,2,40,417,46,463,1.5,480
25,11,3,3,267,39,306,1.5,480
25,12,2,29,490,66,556,0.8,480
25,12,3,16,734,43,777,1.2,480
25,13,1,36,289,18,307,0.8,480
25,13,2,30,346,35,381,1.5,480
25,13,3,27,759,61,820,0.8,480
25,14,1,31,201,5,206,1.2,480
25,14,2,8,273,8,281,1.0,480
25,14,3,12,347,41,388,1.5,480
25,15,1,21,743,97,840,1.5,480
26,1,2,14,285,2,287,1.0,480
26,1,3,39,401,37,438,1.0,480
26,2,1,4,690,39,729,0.8,480
26,2,2,9,613,19,632,1.0,480
26,3,1,1,578,23,601,1.5,480
26,3,2,13,638,81,719,1.0,480
26,3,3,31,640,73,713,1.2,480
26,4,1,40,770,20,790,1.5,480
26,4,2,4,372,17,389,0.8,480
26,4,3,21,688,58,746,1.5,480
26,5,2,19,449,3,452,1.5,480
26,6,1,33,788,65,853,0.8,480
26,6,3,37,263,3,266,1.2,480
26,7,1,11,312,17,329,1.0,480
26,7,2,25,441,33,474,1.5,480
26,7,3,8,607,4,611,1.0,480
26,8,1,32,394,28,422,0.8,480
26,8,3,19,649,78,727,1.5,480
26,9,1,29,772,42,814,0.8,480
26,9,2,3,224,31,255,1.5,480
26,9,3,30,768,54,822,1.5,480
26,10,1,8,239,31,270,1.0,480
26,10,2,39,504,28,532,1.0,480
26,10,3,38,618,89,707,1.5,480
26,11,1,22,348,48,396,1.2,480
26,11,2,10,594,41,635,1.2,480
26,12,1,30,226,18,244,1.5,480
26,12,2,7,586,67,653,1.0,480
26,12,3,8,568,34,602,1.0,480
26,13,1,26,322,11,333,1.0,480
26,13,3,34,767,33,800,1.0,480
26,14,1,20,519,0,519,1.5,480
26,14,2,21,392,14,406,1.5,480
26,14,3,18,620,50,670,1.2,480
26,15,1,24,219,5,224,1.0,480
26,15,3,11,586,63,649,1.0,480
27,1,1,31,624,2,626,1.2,480
27,1,2,14,552,42,594,1.0,480
27,2,1,19,251,29,280,1.5,480
27,2,3,2,774,13,787,0.8,480
27,3,1,33,706,45,751,0.8,480
27,3,2,24,567,34,601,1.0,480
27,3,3,19,209,18,227,1.5,480
27,4,1,39,476,9,485,1.0,480
27,5,1,21,352,39,391,1.5,480
27,5,2,8,533,46,579,1.0,480
27,6,3,32,551,80,631,0.8,480
27,7,1,5,759,7,766,1.0,480
27,7,2,31,273,38,311,1.2,480
27,7,3,13,402,42,444,1.0,480
27,8,1,7,266,38,304,1.0,480
27,8,2,27,614,65,679,0.8,480
27,8,3,19,597,35,632,1.5,480
27,9,1,23,218,2,220,1.2,480
27,9,2,31,644,22,666,1.2,480
27,9,3,8,628,24,652,1.0,480
27,10,1,4,700,34,734,0.8,480
27,10,2,27,590,24,614,0.8,480
27,10,3,4,594,53,647,0.8,480
27,11,2,18,706,102,808,1.2,480
27,11,3,39,739,3,742,1.0,480
27,12,1,23,275,34,309,1.2,480
27,12,2,31,484,71,555,1.2,480
27,12,3,25,562,66,628,1.5,480
27,13,1,34,761,61,822,1.0,480
27,13,2,15,392,52,444,1.2,480
27,13,3,2,700,23,723,0.8,480
27,14,1,17,743,30,773,1.2,480
27,14,2,8,458,10,468,1.0,480
27,14,3,7,368,53,421,1.0,480
27,15,1,16,232,6,238,1.2,480
27,15,3,1,392,39,431,1.5,480
28,1,1,20,318,24,342,1.5,480
28,1,2,10,291,0,291,1.2,480
28,2,1,8,341,8,349,1.0,480
28,2,2,9,392,36,428,1.0,480
28,2,3,7,400,19,419,1.0,480
28,3,2,19,271,33,304,1.5,480
28,3,3,37,537,72,609,1.2,480
28,4,1,20,576,42,618,1.5,480
28,4,2,24,309,38,347,1.0,480
28,5,1,13,522,65,587,1.0,480
28,5,3,29,261,11,272,0.8,480
28,6,1,31,600,26,626,1.2,480
28,6,3,35,234,25,259,0.8,480
28,7,1,3,416,37,453,1.5,480
28,7,2,4,259,8,267,0.8,480
28,7,3,1,604,36,640,1.5,480
28,8,1,23,692,15,707,1.2,480
28,8,3,37,478,0,478,1.2,480
28,9,1,24,552,13,565,1.0,480
28,9,2,39,536,41,577,1.0,480
28,9,3,26,444,24,468,1.0,480
28,10,1,11,315,11,326,1.0,480
28,10,2,12,532,6,538,1.5,480
28,10,3,18,482,46,528,1.2,480
28,11,2,3,729,0,729,1.5,480
28,11,3,16,211,24,235,1.2,480
28,12,1,1,467,38,505,1.5,480
28,12,2,26,309,24,333,1.0,480
28,12,3,16,334,19,353,1.2,480
28,13,3,25,624,13,637,1.5,480
28,14,1,34,464,16,480,1.0,480
28,14,2,16,285,29,314,1.2,480
28,14,3,17,572,64,636,1.2,480
28,15,1,24,473,64,537,1.0,480
29,1,2,6,471,1,472,1.5,480
29,1,3,32,365,32,397,0.8,480
29,2,1,21,322,23,345,1.5,480
29,2,2,17,737,46,783,1.2,480
29,2,3,34,717,82,799,1.0,480
29,3,1,13,781,93,874,1.0,480
29,3,2,37,230,7,237,1.2,480
29,3,3,9,610,18,628,1.0,480
29,4,1,36,573,40,613,0.8,480
29,4,2,20,396,32,428,1.5,480
29,4,3,32,223,27,250,0.8,480
29,5,1,11,660,86,746,1.0,480
29,5,2,5,408,0,408,1.0,480
29,5,3,8,564,68,632,1.0,480
29,6,1,29,717,68,785,0.8,480
29,6,2,28,643,87,730,1.5,480
29,6,3,2,673,13,686,0.8,480
29,7,1,3,637,48,685,1.5,480
29,7,3,26,527,21,548,1.0,480
29,8,1,3,483,27,510,1.5,480
29,8,3,30,443,25,468,1.5,480
29,9,1,15,737,10,747,1.2,480
29,9,2,6,602,5,607,1.5,480
29,9,3,18,537,31,568,1.2,480
29,10,1,26,450,28,478,1.0,480
29,10,2,3,385,25,410,1.5,480
29,10,3,4,322,17,339,0.8,480
29,11,2,21,663,89,752,1.5,480
29,11,3,13,553,14,567,1.0,480
29,12,1,24,643,44,687,1.0,480
29,12,2,22,343,18,361,1.2,480
29,12,3,3,606,69,675,1.5,480
29,13,1,33,298,4,302,0.8,480
29,13,2,33,522,72,594,0.8,480
29,13,3,15,533,26,559,1.2,480
29,14,1,17,329,0,329,1.2,480
29,14,2,21,512,47,559,1.5,480
29,14,3,12,782,62,844,1.5,480
29,15,1,38,789,6,795,1.5,480
29,15,2,28,418,45,463,1.5,480
29,15,3,12,612,30,642,1.5,480
30,1,2,30,269,39,308,1.5,480
30,1,3,31,320,44,364,1.2,480
30,2,1,15,262,34,296,1.2,480
30,2,2,40,240,15,255,1.5,480
30,2,3,29,306,36,342,0.8,480
30,3,1,7,719,54,773,1.0,480
30,3,2,36,681,48,729,0.8,480
30,3,3,3,517,52,569,1.5,480
30,4,2,4,360,36,396,0.8,480
30,4,3,24,392,53,445,1.0,480
30,5,2,9,317,11,328,1.0,480
30,5,3,10,550,36,586,1.2,480
30,6,1,15,377,31,408,1.2,480
30,6,2,11,622,60,682,1.0,480
30,6,3,20,315,0,315,1.5,480
30,7,1,5,577,19,596,1.0,480
30,7,3,18,387,47,434,1.2,480
30,8,1,17,739,45,784,1.2,480
30,8,2,37,463,63,526,1.2,480
30,8,3,35,607,89,696,0.8,480
30,9,1,39,424,36,460,1.0,480
30,9,2,15,557,62,619,1.2,480
30,9,3,10,654,37,691,1.2,480
30,10,2,16,634,72,706,1.2,480
30,10,3,7,251,32,283,1.0,480
30,11,1,12,771,68,839,1.5,480
30,11,2,18,406,30,436,1.2,480
30,11,3,9,482,43,525,1.0,480
30,12,1,17,737,30,767,1.2,480
30,12,2,38,460,56,516,1.5,480
30,12,3,4,732,53,785,0.8,480
30,13,1,29,265,5,270,0.8,480
30,13,2,16,218,10,228,1.2,480
30,13,3,3,631,78,709,1.5,480
30,14,1,2,668,76,744,0.8,480
30,14,2,5,603,43,646,1.0,480
30,14,3,40,509,41,550,1.5,480
30,15,1,16,458,23,481,1.2,480
30,15,2,1,518,45,563,1.5,480
31,1,1,12,370,27,397,1.5,480
31,1,2,40,545,18,563,1.5,480
31,1,3,13,406,50,456,1.0,480
31,2,1,5,466,47,513,1.0,480
31,2,3,24,746,13,759,1.0,480
31,3,1,32,790,56,846,0.8,480
31,3,2,24,388,42,430,1.0,480
31,3,3,5,655,16,671,1.0,480
31,4,1,4,462,19,481,0.8,480
31,4,2,37,582,36,618,1.2,480
31,5,1,14,635,7,642,1.0,480
31,5,2,10,543,60,603,1.2,480
31,5,3,33,490,51,541,0.8,480
31,6,1,9,224,30,254,1.0,480
31,6,2,11,212,10,222,1.0,480
31,7,1,8,335,2,337,1.0,480
31,7,2,9,735,81,816,1.0,480
31,7,3,16,381,40,421,1.2,480
31,8,1,6,639,81,720,1.5,480
31,8,2,19,728,33,761,1.5,480
31,8,3,2,555,80,635,0.8,480
31,9,1,11,385,50,435,1.0,480
31,9,2,19,261,8,269,1.5,480
31,9,3,26,517,4,521,1.0,480
31,10,1,6,566,72,638,1.5,480
31,10,3,12,422,31,453,1.5,480
31,11,2,2,334,44,378,0.8,480
31,11,3,37,399,10,409,1.2,480
31,12,1,20,638,25,663,1.5,480
31,12,2,25,449,2,451,1.5,480
31,12,3,18,209,2,211,1.2,480
31,13,1,4,393,25,418,0.8,480
31,13,2,11,725,19,744,1.0,480
31,14,1,15,622,57,679,1.2,480
31,14,2,15,603,21,624,1.2,480
31,14,3,10,476,62,538,1.2,480
31,15,1,39,431,30,461,1.0,480
31,15,2,30,498,27,525,1.5,480
32,1,1,26,344,7,351,1.0,480
32,1,2,36,569,28,597,0.8,480
32,2,1,3,798,63,861,1.5,480
32,2,2,33,544,18,562,0.8,480
32,2,3,40,651,85,736,1.5,480
32,3,1,34,440,13,453,1.0,480
32,3,2,33,282,16,298,0.8,480
32,3,3,17,699,65,764,1.2,480
32,4,1,17,315,10,325,1.2,480
32,4,2,5,609,16,625,1.0,480
32,5,1,8,283,2,285,1.0,480
32,5,3,27,386,36,422,0.8,480
32,6,1,9,441,21,462,1.0,480
32,6,2,13,413,49,462,1.0,480
32,6,3,29,717,15,732,0.8,480
32,7,1,27,499,19,518,0.8,480
32,7,2,28,336,43,379,1.5,480
32,7,3,37,492,65,557,1.2,480
32,8,1,37,682,40,722,1.2,480
32,8,2,18,244,5,249,1.2,480
32,8,3,19,225,13,238,1.5,480
32,9,2,39,229,26,255,1.0,480
32,9,3,27,225,19,244,0.8,480
32,10,1,23,429,39,468,1.2,480
32,10,3,10,326,16,342,1.2,480
32,11,1,23,691,1,692,1.2,480
32,11,2,34,415,22,437,1.0,480
32,11,3,8,318,31,349,1.0,480
32,12,2,28,587,80,667,1.5,480
32,12,3,31,756,74,830,1.2,480
32,13,1,12,721,71,792,1.5,480
32,13,2,7,317,23,340,1.0,480
32,13,3,30,653,75,728,1.5,480
32,14,2,12,450,56,506,1.5,480
32,14,3,15,242,12,254,1.2,480
32,15,1,1,525,33,558,1.5,480
32,15,2,37,395,26,421,1.2,480
32,15,3,8,367,14,381,1.0,480
33,1,2,24,780,69,849,1.0,480
33,1,3,35,370,42,412,0.8,480
33,2,1,2,479,54,533,0.8,480
33,2,2,33,682,20,702,0.8,480
33,3,1,40,203,2,205,1.5,480
33,3,2,20,761,48,809,1.5,480
33,3,3,11,480,60,540,1.0,480
33,4,2,37,674,29,703,1.2,480
33,4,3,13,319,0,319,1.0,480
33,5,1,17,637,0,637,1.2,480
33,5,2,39,640,27,667,1.0,480
33,5,3,16,203,16,219,1.2,480
33,6,1,15,692,74,766,1.2,480
33,6,2,24,429,51,480,1.0,480
33,6,3,9,279,9,288,1.0,480
33,7,1,17,361,51,412,1.2,480
33,7,2,30,469,55,524,1.5,480
33,7,3,40,497,61,558,1.5,480
33,8,1,16,436,5,441,1.2,480
33,8,3,8,380,12,392,1.0,480
33,9,1,3,452,38,490,1.5,480
33,9,2,4,725,78,803,0.8,480
33,9,3,11,300,22,322,1.0,480
33,10,1,15,608,76,684,1.2,480
33,10,2,7,644,29,673,1.0,480
33,10,3,14,461,53,514,1.0,480
33,11,1,19,653,27,680,1.5,480
33,11,2,38,311,29,340,1.5,480
33,11,3,3,304,5,309,1.5,480
33,12,1,30,387,11,398,1.5,480
33,12,2,4,411,8,419,0.8,480
33,12,3,26,270,38,308,1.0,480
33,13,1,37,749,67,816,1.2,480
33,13,2,24,600,85,685,1.0,480
33,13,3,23,544,68,612,1.2,480
33,14,1,8,763,26,789,1.0,480
33,14,2,26,399,36,435,1.0,480
33,14,3,27,574,78,652,0.8,480
33,15,2,1,613,90,703,1.5,480
33,15,3,8,331,34,365,1.0,480
34,1,2,1,510,15,525,1.5,480
34,1,3,26,606,51,657,1.0,480
34,2,1,36,710,8,718,0.8,480
34,2,3,15,253,29,282,1.2,480
34,3,1,30,792,99,891,1.5,480
34,3,2,40,348,19,367,1.5,480
34,3,3,20,780,113,893,1.5,480
34,4,1,26,467,2,469,1.0,480
34,4,2,32,672,71,743,0.8,480
34,4,3,36,282,21,303,0.8,480
34,5,1,39,256,18,274,1.0,480
34,5,2,1,355,26,381,1.5,480
34,6,1,2,711,59,770,0.8,480
34,6,2,11,611,64,675,1.0,480
34,6,3,35,767,51,818,0.8,480
34,7,2,39,300,28,328,1.0,480
34,7,3,28,727,32,759,1.5,480
34,8,1,9,387,46,433,1.0,480
34,8,2,36,239,24,263,0.8,480
34,8,3,4,530,42,572,0.8,480
34,9,1,7,684,57,741,1.0,480
34,10,2,1,235,13,248,1.5,480
34,10,3,39,747,39,786,1.0,480
34,11,1,17,753,78,831,1.2,480
34,11,2,22,616,34,650,1.2,480
34,11,3,25,519,59,578,1.5,480
34,12,1,25,357,42,399,1.5,480
34,12,2,37,226,23,249,1.2,480
34,12,3,35,227,33,260,0.8,480
34,13,2,37,718,67,785,1.2,480
34,13,3,16,436,20,456,1.2,480
34,14,1,29,364,43,407,0.8,480
34,14,3,15,612,1,613,1.2,480
34,15,1,16,709,37,746,1.2,480
34,15,2,35,737,81,818,0.8,480
34,15,3,31,725,6,731,1.2,480
35,1,2,2,566,21,587,0.8,480
35,1,3,15,791,65,856,1.2,480
35,2,1,8,349,39,388,1.0,480
35,2,2,32,750,15,765,0.8,480
35,2,3,2,699,74,773,0.8,480
35,3,1,12,663,14,677,1.5,480
35,3,2,33,662,63,725,0.8,480
35,3,3,6,762,61,823,1.5,480
35,4,1,14,518,64,582,1.0,480
35,4,2,11,718,105,823,1.0,480
35,4,3,28,406,32,438,1.5,480
35,5,1,25,531,1,532,1.5,480
35,5,3,5,447,21,468,1.0,480
35,6,3,37,216,23,239,1.2,480
35,7,1,12,318,29,347,1.5,480
35,7,2,39,381,37,418,1.0,480
35,7,3,20,329,26,355,1.5,480
35,8,2,6,387,52,439,1.5,480
35,8,3,37,397,8,405,1.2,480
35,9,2,9,420,54,474,1.0,480
35,9,3,10,771,43,814,1.2,480
35,10,1,31,734,56,790,1.2,480
35,10,2,11,444,33,477,1.0,480
35,10,3,2,546,48,594,0.8,480
35,11,1,2,207,27,234,0.8,480
35,11,2,38,241,11,252,1.5,480
35,11,3,11,429,53,482,1.0,480
35,12,1,17,700,33,733,1.2,480
35,12,2,5,671,55,726,1.0,480
35,12,3,12,581,42,623,1.5,480
35,13,1,21,635,54,689,1.5,480
35,13,2,4,621,39,660,0.8,480
35,13,3,24,703,24,727,1.0,480
35,14,1,15,475,33,508,1.2,480
35,14,2,23,331,20,351,1.2,480
35,15,1,34,286,7,293,1.0,480
35,15,2,27,387,16,403,0.8,480
35,15,3,10,301,27,328,1.2,480
36,1,3,12,463,43,506,1.5,480
36,2,1,40,701,100,801,1.5,480
36,2,2,21,618,31,649,1.5,480
36,2,3,29,729,27,756,0.8,480
36,3,1,21,759,18,777,1.5,480
36,3,2,40,560,13,573,1.5,480
36,3,3,7,467,25,492,1.0,480
36,4,1,16,563,7,570,1.2,480
36,4,2,17,675,63,738,1.2,480
36,4,3,3,388,17,405,1.5,480
36,5,1,9,562,33,595,1.0,480
36,5,3,17,384,17,401,1.2,480
36,6,1,36,705,67,772,0.8,480
36,6,2,36,389,11,400,0.8,480
36,6,3,9,780,30,810,1.0,480
36,7,1,25,709,34,743,1.5,480
36,7,3,3,535,12,547,1.5,480
36,8,1,27,238,28,266,0.8,480
36,8,2,24,362,30,392,1.0,480
36,8,3,40,578,24,602,1.5,480
36,9,1,5,681,55,736,1.0,480
36,9,2,34,766,43,809,1.0,480
36,9,3,26,788,97,885,1.0,480
36,10,1,24,652,85,737,1.0,480
36,10,2,7,491,3,494,1.0,480
36,10,3,8,422,52,474,1.0,480
36,11,2,33,268,11,279,0.8,480
36,11,3,26,271,3,274,1.0,480
36,12,1,6,359,9,368,1.5,480
36,12,2,40,799,9,808,1.5,480
36,12,3,5,380,51,431,1.0,480
36,13,1,17,666,32,698,1.2,480
36,13,2,32,354,31,385,0.8,480
36,13,3,24,208,20,228,1.0,480
36,14,2,2,217,14,231,0.8,480
36,14,3,39,728,37,765,1.0,480
36,15,1,36,571,30,601,0.8,480
36,15,2,14,785,73,858,1.0,480
36,15,3,8,370,31,401,1.0,480
37,1,1,17,519,22,541,1.2,480
37,1,2,12,507,24,531,1.5,480
37,1,3,17,243,29,272,1.2,480
37,2,1,8,404,44,448,1.0,480
37,2,2,38,609,73,682,1.5,480
37,2,3,29,438,8,446,0.8,480
37,3,1,34,427,62,489,1.0,480
37,3,3,16,501,74,575,1.2,480
37,4,1,31,425,34,459,1.2,480
37,4,3,12,270,4,274,1.5,480
37,5,1,12,651,27,678,1.5,480
37,5,2,6,700,24,724,1.5,480
37,5,3,21,629,10,639,1.5,480
37,6,1,26,770,78,848,1.0,480
37,6,3,14,292,27,319,1.0,480
37,7,1,37,253,4,257,1.2,480
37,7,2,3,581,11,592,1.5,480
37,7,3,33,317,38,355,0.8,480
37,8,1,13,392,18,410,1.0,480
37,8,2,21,491,48,539,1.5,480
37,8,3,28,521,77,598,1.5,480
37,9,1,38,753,41,794,1.5,480
37,9,2,1,655,9,664,1.5,480
37,10,1,6,707,52,759,1.5,480
37,10,2,28,615,33,648,1.5,480
37,10,3,11,471,7,478,1.0,480
37,11,1,31,758,104,862,1.2,480
37,11,2,19,419,37,456,1.5,480
37,11,3,28,678,71,749,1.5,480
37,12,1,39,486,28,514,1.0,480
37,12,2,8,373,47,420,1.0,480
37,12,3,39,453,26,479,1.0,480
37,13,2,31,540,80,620,1.2,480
37,13,3,35,568,32,600,0.8,480
37,14,1,11,201,14,215,1.0,480
37,14,2,30,462,31,493,1.5,480
37,15,1,29,517,18,535,0.8,480
37,15,2,9,446,1,447,1.0,480
37,15,3,13,518,53,571,1.0,480
38,1,3,4,407,19,426,0.8,480
38,2,1,36,435,11,446,0.8,480
38,2,3,34,609,45,654,1.0,480
38,3,2,28,295,43,338,1.5,480
38,3,3,32,222,5,227,0.8,480
38,4,1,8,547,34,581,1.0,480
38,4,2,8,321,7,328,1.0,480
38,4,3,24,500,57,557,1.0,480
38,5,1,30,726,49,775,1.5,480
38,5,2,31,497,26,523,1.2,480
38,5,3,12,375,10,385,1.5,480
38,6,1,15,288,7,295,1.2,480
38,6,2,16,267,19,286,1.2,480
38,6,3,35,622,8,630,0.8,480
38,7,1,18,353,6,359,1.2,480
38,7,2,7,254,6,260,1.0,480
38,7,3,35,621,61,682,0.8,480
38,8,1,18,472,32,504,1.2,480
38,8,2,3,386,35,421,1.5,480
38,8,3,18,411,20,431,1.2,480
38,9,1,24,347,39,386,1.0,480
38,9,2,9,773,90,863,1.0,480
38,9,3,35,539,70,609,0.8,480
38,10,1,15,780,96,876,1.2,480
38,10,2,18,600,84,684,1.2,480
38,10,3,29,574,12,586,0.8,480
38,11,1,10,326,5,331,1.2,480
38,11,2,15,547,78,625,1.2,480
38,11,3,17,244,19,263,1.2,480
38,12,2,22,225,21,246,1.2,480
38,12,3,33,530,44,574,0.8,480
38,13,1,5,623,33,656,1.0,480
38,13,2,29,354,49,403,0.8,480
38,13,3,3,240,9,249,1.5,480
38,14,1,13,319,40,359,1.0,480
38,14,2,22,533,65,598,1.2,480
38,14,3,19,523,40,563,1.5,480
38,15,2,29,783,4,787,0.8,480
38,15,3,34,219,27,246,1.0,480
39,1,1,25,438,35,473,1.5,480
39,1,2,27,713,20,733,0.8,480
39,1,3,4,497,52,549,0.8,480
39,2,1,27,555,71,626,0.8,480
39,2,2,14,206,7,213,1.0,480
39,2,3,8,603,21,624,1.0,480
39,3,1,3,605,7,612,1.5,480
39,3,2,25,517,45,562,1.5,480
39,3,3,19,267,32,299,1.5,480
39,4,1,40,507,68,575,1.5,480
39,4,2,13,710,104,814,1.0,480
39,4,3,36,486,61,547,0.8,480
39,5,1,36,350,3,353,0.8,480
39,5,2,37,765,7,772,1.2,480
39,5,3,3,682,0,682,1.5,480
39,6,1,18,282,33,315,1.2,480
39,6,2,23,515,1,516,1.2,480
39,7,1,36,532,48,580,0.8,480
39,7,2,15,780,47,827,1.2,480
39,7,3,35,457,51,508,0.8,480
39,8,1,11,390,9,399,1.0,480
39,8,2,5,619,63,682,1.0,480
39,8,3,40,230,29,259,1.5,480
39,9,1,25,260,21,281,1.5,480
39,9,3,1,791,12,803,1.5,480
39,10,1,26,623,26,649,1.0,480
39,10,2,36,648,30,678,0.8,480
39,10,3,26,322,37,359,1.0,480
39,11,2,26,406,23,429,1.0,480
39,11,3,40,248,34,282,1.5,480
39,12,2,24,673,72,745,1.0,480
39,13,1,6,751,2,753,1.5,480
39,13,2,30,489,14,503,1.5,480
39,13,3,35,260,14,274,0.8,480
39,14,1,36,284,3,287,0.8,480
39,14,2,33,327,27,354,0.8,480
39,14,3,31,765,107,872,1.2,480
39,15,1,24,260,13,273,1.0,480
39,15,2,15,341,46,387,1.2,480
39,15,3,24,312,5,317,1.0,480
40,1,1,12,389,8,397,1.5,480
40,1,2,17,349,37,386,1.2,480
40,2,2,21,690,58,748,1.5,480
40,2,3,34,291,3,294,1.0,480
40,3,1,22,726,39,765,1.2,480
40,3,2,21,688,46,734,1.5,480
40,3,3,10,314,27,341,1.2,480
40,4,1,6,757,80,837,1.5,480
40,4,2,14,770,79,849,1.0,480
40,4,3,17,634,92,726,1.2,480
40,5,1,7,764,83,847,1.0,480
40,5,2,24,714,6,720,1.0,480
40,5,3,10,781,101,882,1.2,480
40,6,1,4,265,21,286,0.8,480
40,6,2,9,339,13,352,1.0,480
40,6,3,3,700,86,786,1.5,480
40,7,1,25,442,64,506,1.5,480
40,7,2,36,725,26,751,0.8,480
40,7,3,23,711,13,724,1.2,480
40,8,1,39,282,14,296,1.0,480
40,8,2,31,365,2,367,1.2,480
40,9,1,28,465,36,501,1.5,480
40,9,2,6,793,108,901,1.5,480
40,9,3,34,475,26,501,1.0,480
40,10,1,25,220,20,240,1.5,480
40,10,2,32,289,7,296,0.8,480
40,10,3,1,433,0,433,1.5,480
40,11,1,10,551,58,609,1.2,480
40,11,3,20,686,11,697,1.5,480
40,12,1,23,498,71,569,1.2,480
40,12,2,12,388,39,427,1.5,480
40,12,3,36,599,10,609,0.8,480
40,13,1,1,314,42,356,1.5,480
40,13,3,40,789,112,901,1.5,480
40,14,1,10,386,25,411,1.2,480
40,14,2,5,691,35,726,1.0,480
40,14,3,18,565,58,623,1.2,480
40,15,1,6,729,55,784,1.5,480
40,15,2,9,363,7,370,1.0,480
40,15,3,29,560,52,612,0.8,480
41,1,1,11,405,35,440,1.0,480
41,1,2,6,265,37,302,1.5,480
41,1,3,17,238,0,238,1.2,480
41,2,1,20,371,25,396,1.5,480
41,2,2,36,228,21,249,0.8,480
41,2,3,3,450,58,508,1.5,480
41,3,1,21,250,9,259,1.5,480
41,3,2,9,743,56,799,1.0,480
41,3,3,2,727,78,805,0.8,480
41,4,1,3,507,40,547,1.5,480
41,4,2,12,781,93,874,1.5,480
41,4,3,35,377,17,394,0.8,480
41,5,1,31,347,49,396,1.2,480
41,5,2,19,516,14,530,1.5,480
41,5,3,22,258,29,287,1.2,480
41,6,1,12,527,32,559,1.5,480
41,6,2,32,665,54,719,0.8,480
41,6,3,16,442,27,469,1.2,480
41,7,1,22,635,66,701,1.2,480
41,7,3,38,799,58,857,1.5,480
41,8,1,27,527,11,538,0.8,480
41,8,2,12,360,38,398,1.5,480
41,8,3,5,366,37,403,1.0,480
41,9,1,4,429,20,449,0.8,480
41,9,2,19,402,55,457,1.5,480
41,9,3,30,392,38,430,1.5,480
41,10,1,23,739,93,832,1.2,480
41,10,2,27,422,37,459,0.8,480
41,10,3,3,474,41,515,1.5,480
41,11,1,20,227,11,238,1.5,480
41,11,2,24,777,98,875,1.0,480
41,11,3,24,632,20,652,1.0,480
41,12,1,36,656,32,688,0.8,480
41,12,2,15,355,7,362,1.2,480
41,12,3,9,650,10,660,1.0,480
41,13,1,33,334,10,344,0.8,480
41,13,2,27,569,3,572,0.8,480
41,13,3,25,320,26,346,1.5,480
41,14,1,28,352,28,380,1.5,480
41,14,2,5,489,59,548,1.0,480
41,14,3,35,228,17,245,0.8,480
41,15,1,24,242,3,245,1.0,480
41,15,2,1,314,15,329,1.5,480
41,15,3,16,447,47,494,1.2,480
42,1,1,34,648,46,694,1.0,480
42,1,2,3,676,35,711,1.5,480
42,1,3,2,683,48,731,0.8,480
42,2,1,4,284,39,323,0.8,480
42,2,2,22,545,59,604,1.2,480
42,2,3,16,464,12,476,1.2,480
42,3,1,12,401,21,422,1.5,480
42,3,3,32,768,94,862,0.8,480
42,4,1,2,205,6,211,0.8,480
42,4,2,23,714,101,815,1.2,480
42,5,1,34,607,1,608,1.0,480
42,5,2,6,739,11,750,1.5,480
42,5,3,5,444,0,444,1.0,480
42,6,1,17,495,68,563,1.2,480
42,6,3,37,593,43,636,1.2,480
42,7,1,15,463,49,512,1.2,480
42,7,2,3,692,42,734,1.5,480
42,7,3,38,484,55,539,1.5,480
42,8,1,36,219,30,249,0.8,480
42,8,2,3,326,10,336,1.5,480
42,8,3,39,547,35,582,1.0,480
42,9,1,31,728,88,816,1.2,480
42,9,2,6,205,8,213,1.5,480
42,9,3,25,706,90,796,1.5,480
42,10,1,20,351,46,397,1.5,480
42,10,2,24,365,53,418,1.0,480
42,10,3,22,431,19,450,1.2,480
42,11,1,24,414,35,449,1.0,480
42,11,2,30,593,87,680,1.5,480
42,11,3,34,363,6,369,1.0,480
42,12,1,5,749,41,790,1.0,480
42,12,2,24,737,105,842,1.0,480
42,12,3,10,427,19,446,1.2,480
42,13,1,14,276,7,283,1.0,480
42,13,2,36,433,44,477,0.8,480
42,13,3,25,618,50,668,1.5,480
42,14,1,10,591,59,650,1.2,480
42,14,2,4,516,29,545,0.8,480
42,14,3,34,589,41,630,1.0,480
42,15,1,33,285,18,303,0.8,480
42,15,2,20,524,50,574,1.5,480
43,1,1,38,401,43,444,1.5,480
43,1,2,20,289,36,325,1.5,480
43,1,3,16,501,21,522,1.2,480
43,2,2,6,791,47,838,1.5,480
43,3,1,30,748,96,844,1.5,480
43,3,2,10,554,42,596,1.2,480
43,3,3,2,441,4,445,0.8,480
43,4,1,34,598,72,670,1.0,480
43,4,2,11,370,15,385,1.0,480
43,4,3,5,476,33,509,1.0,480
43,5,1,7,343,25,368,1.0,480
43,5,3,30,548,26,574,1.5,480
43,7,1,23,537,37,574,1.2,480
43,7,2,4,361,31,392,0.8,480
43,7,3,17,453,64,517,1.2,480
43,8,1,15,426,4,430,1.2,480
43,8,2,1,201,26,227,1.5,480
43,9,2,40,247,0,247,1.5,480
43,9,3,36,391,20,411,0.8,480
43,10,1,8,336,45,381,1.0,480
43,10,3,4,351,15,366,0.8,480
43,11,1,35,415,20,435,0.8,480
43,11,2,19,281,24,305,1.5,480
43,11,3,17,326,3,329,1.2,480
43,12,1,32,412,47,459,0.8,480
43,12,2,36,568,55,623,0.8,480
43,12,3,16,587,43,630,1.2,480
43,13,1,33,569,71,640,0.8,480
43,13,2,38,365,24,389,1.5,480
43,13,3,5,760,13,773,1.0,480
43,14,1,1,228,20,248,1.5,480
43,14,2,8,556,63,619,1.0,480
43,15,1,31,227,10,237,1.2,480
43,15,2,33,596,68,664,0.8,480
43,15,3,17,220,13,233,1.2,480
44,1,1,24,360,30,390,1.0,480
44,1,2,1,558,28,586,1.5,480
44,1,3,6,313,16,329,1.5,480
44,2,1,30,349,49,398,1.5,480
44,2,2,8,658,40,698,1.0,480
44,2,3,2,756,70,826,0.8,480
44,3,1,38,464,33,497,1.5,480
44,3,2,35,401,27,428,0.8,480
44,3,3,2,520,2,522,0.8,480
44,4,1,4,589,87,676,0.8,480
44,4,3,4,206,8,214,0.8,480
44,5,1,16,771,26,797,1.2,480
44,5,2,5,461,32,493,1.0,480
44,5,3,4,372,26,398,0.8,480
44,6,1,4,253,7,260,0.8,480
44,6,2,9,756,19,775,1.0,480
44,6,3,14,282,39,321,1.0,480
44,7,1,9,542,18,560,1.0,480
44,7,2,9,421,23,444,1.0,480
44,7,3,2,438,34,472,0.8,480
44,8,2,4,712,101,813,0.8,480
44,8,3,16,368,43,411,1.2,480
44,9,1,6,666,32,698,1.5,480
44,9,2,17,358,17,375,1.2,480
44,10,1,12,625,76,701,1.5,480
44,10,2,2,313,15,328,0.8,480
44,10,3,39,371,3,374,1.0,480
44,11,1,27,373,54,427,0.8,480
44,11,2,8,731,66,797,1.0,480
44,11,3,9,523,25,548,1.0,480
44,12,1,19,776,7,783,1.5,480
44,12,2,11,539,26,565,1.0,480
44,12,3,2,671,96,767,0.8,480
44,13,1,28,664,34,698,1.5,480
44,13,3,10,353,0,353,1.2,480
44,14,1,5,475,16,491,1.0,480
44,14,3,2,466,39,505,0.8,480
44,15,1,18,450,0,450,1.2,480
44,15,2,36,405,25,430,0.8,480
44,15,3,35,286,9,295,0.8,480
45,1,1,13,445,5,450,1.0,480
45,1,3,8,524,40,564,1.0,480
45,2,1,3,598,57,655,1.5,480
45,2,2,1,785,10,795,1.5,480
45,2,3,7,503,55,558,1.0,480
45,3,1,25,726,5,731,1.5,480
45,3,2,10,667,69,736,1.2,480
45,4,2,15,518,27,545,1.2,480
45,4,3,17,643,21,664,1.2,480
45,5,1,25,627,24,651,1.5,480
45,5,2,7,222,11,233,1.0,480
45,6,1,37,569,65,634,1.2,480
45,6,2,38,394,55,449,1.5,480
45,6,3,17,207,23,230,1.2,480
45,7,1,5,462,26,488,1.0,480
45,7,2,34,519,59,578,1.0,480
45,7,3,28,501,44,545,1.5,480
45,8,1,3,426,29,455,1.5,480
45,8,2,20,259,35,294,1.5,480
45,8,3,27,240,32,272,0.8,480
45,9,1,34,227,32,259,1.0,480
45,9,2,22,420,13,433,1.2,480
45,9,3,35,705,74,779,0.8,480
45,10,2,30,768,113,881,1.5,480
45,10,3,16,391,37,428,1.2,480
45,11,1,4,624,45,669,0.8,480
45,11,2,22,550,67,617,1.2,480
45,11,3,12,748,37,785,1.5,480
45,12,2,32,672,1,673,0.8,480
45,12,3,34,399,9,408,1.0,480
45,13,1,35,664,73,737,0.8,480
45,13,2,27,577,78,655,0.8,480
45,14,1,37,363,26,389,1.2,480
45,14,2,18,406,37,443,1.2,480
45,15,2,20,711,72,783,1.5,480
46,1,1,16,709,28,737,1.2,480
46,1,3,32,260,35,295,0.8,480
46,2,2,18,579,16,595,1.2,480
46,2,3,4,431,45,476,0.8,480
46,3,1,2,714,103,817,0.8,480
46,3,2,12,687,84,771,1.5,480
46,3,3,19,339,39,378,1.5,480
46,4,1,10,580,38,618,1.2,480
46,4,2,22,600,9,609,1.2,480
46,4,3,34,376,49,425,1.0,480
46,5,1,26,413,22,435,1.0,480
46,5,2,26,573,66,639,1.0,480
46,5,3,14,382,54,436,1.0,480
46,6,1,5,793,81,874,1.0,480
46,6,2,27,234,16,250,0.8,480
46,6,3,1,780,32,812,1.5,480
46,7,1,11,230,23,253,1.0,480
46,7,2,7,239,3,242,1.0,480
46,7,3,4,462,30,492,0.8,480
46,8,2,34,259,4,263,1.0,480
46,8,3,30,604,68,672,1.5,480
46,9,1,17,734,81,815,1.2,480
46,9,2,35,715,0,715,0.8,480
46,9,3,4,774,3,777,0.8,480
46,10,1,6,568,41,609,1.5,480
46,10,2,11,761,52,813,1.0,480
46,10,3,37,316,39,355,1.2,480
46,11,2,16,334,35,369,1.2,480
46,11,3,10,443,34,477,1.2,480
46,12,1,6,623,71,694,1.5,480
46,12,2,30,371,7,378,1.5,480
46,13,1,40,359,23,382,1.5,480
46,13,2,29,299,31,330,0.8,480
46,13,3,18,513,61,574,1.2,480
46,14,1,35,794,41,835,0.8,480
46,14,2,10,453,5,458,1.2,480
46,15,1,33,240,35,275,0.8,480
46,15,2,22,305,27,332,1.2,480
46,15,3,11,773,24,797,1.0,480
47,1,1,9,571,22,593,1.0,480
47,1,2,8,456,6,462,1.0,480
47,1,3,22,627,58,685,1.2,480
47,2,1,32,235,29,264,0.8,480
47,2,2,39,279,14,293,1.0,480
47,2,3,14,587,35,622,1.0,480
47,3,1,40,787,37,824,1.5,480
47,3,2,27,216,15,231,0.8,480
47,3,3,4,558,26,584,0.8,480
47,4,2,14,529,11,540,1.0,480
47,4,3,9,657,82,739,1.0,480
47,5,1,20,281,7,288,1.5,480
47,5,2,33,791,23,814,0.8,480
47,6,1,24,698,50,748,1.0,480
47,6,2,13,545,25,570,1.0,480
47,6,3,20,759,48,807,1.5,480
47,7,1,37,782,84,866,1.2,480
47,7,2,10,379,22,401,1.2,480
47,7,3,3,246,26,272,1.5,480
47,8,1,16,664,72,736,1.2,480
47,8,2,16,679,0,679,1.2,480
47,8,3,1,759,104,863,1.5,480
47,9,1,18,529,72,601,1.2,480
47,9,3,10,555,77,632,1.2,480
47,10,1,10,292,17,309,1.2,480
47,10,2,22,334,32,366,1.2,480
47,10,3,38,792,93,885,1.5,480
47,11,2,33,719,78,797,0.8,480
47,11,3,26,596,22,618,1.0,480
47,12,1,23,341,3,344,1.2,480
47,12,2,18,519,56,575,1.2,480
47,12,3,12,408,1,409,1.5,480
47,13,1,14,302,43,345,1.0,480
47,13,2,40,447,27,474,1.5,480
47,14,1,12,507,67,574,1.5,480
47,14,2,17,399,11,410,1.2,480
47,14,3,28,326,30,356,1.5,480
47,15,1,17,749,47,796,1.2,480
47,15,2,19,591,50,641,1.5,480
47,15,3,30,780,79,859,1.5,480
48,1,3,8,347,31,378,1.0,480
48,2,1,32,757,5,762,0.8,480
48,2,2,18,446,51,497,1.2,480
48,3,1,23,591,24,615,1.2,480
48,3,2,4,651,10,661,0.8,480
48,3,3,23,413,20,433,1.2,480
48,4,1,37,673,17,690,1.2,480
48,4,2,22,451,55,506,1.2,480
48,4,3,9,381,13,394,1.0,480
48,5,2,33,715,78,793,0.8,480
48,6,1,20,645,88,733,1.5,480
48,6,2,36,468,2,470,0.8,480
48,6,3,26,461,46,507,1.0,480
48,7,1,5,360,50,410,1.0,480
48,7,2,1,492,43,535,1.5,480
48,7,3,9,497,30,527,1.0,480
48,8,1,38,574,78,652,1.5,480
48,8,2,39,616,27,643,1.0,480
48,8,3,38,433,49,482,1.5,480
48,9,1,21,235,16,251,1.5,480
48,9,2,18,538,22,560,1.2,480
48,10,1,7,360,5,365,1.0,480
48,10,2,14,596,26,622,1.0,480
48,10,3,31,325,13,338,1.2,480
48,11,1,11,563,31,594,1.0,480
48,11,2,38,465,15,480,1.5,480
48,11,3,14,561,19,580,1.0,480
48,12,2,26,388,37,425,1.0,480
48,13,1,9,389,40,429,1.0,480
48,13,2,26,344,32,376,1.0,480
48,13,3,30,714,71,785,1.5,480
48,14,1,36,597,67,664,0.8,480
48,14,2,10,653,65,718,1.2,480
48,15,1,27,301,21,322,0.8,480
48,15,2,5,214,28,242,1.0,480
48,15,3,24,406,26,432,1.0,480
49,1,2,7,675,6,681,1.0,480
49,1,3,1,799,61,860,1.5,480
49,2,1,31,571,34,605,1.2,480
49,2,2,23,739,39,778,1.2,480
49,2,3,31,593,39,632,1.2,480
49,3,1,27,525,69,594,0.8,480
49,4,1,27,768,65,833,0.8,480
49,4,2,33,295,18,313,0.8,480
49,4,3,7,212,23,235,1.0,480
49,5,3,8,400,52,452,1.0,480
49,6,1,8,204,28,232,1.0,480
49,6,2,17,462,6,468,1.2,480
49,6,3,7,461,61,522,1.0,480
49,7,1,32,375,11,386,0.8,480
49,7,2,16,614,84,698,1.2,480
49,7,3,34,451,50,501,1.0,480
49,8,1,3,794,28,822,1.5,480
49,8,2,11,605,42,647,1.0,480
49,8,3,20,328,12,340,1.5,480
49,9,1,29,492,24,516,0.8,480
49,9,2,3,724,107,831,1.5,480
49,9,3,28,798,12,810,1.5,480
49,10,1,4,782,114,896,0.8,480
49,10,3,24,632,54,686,1.0,480
49,11,1,25,239,27,266,1.5,480
49,11,2,15,335,45,380,1.2,480
49,11,3,20,329,30,359,1.5,480
49,12,1,10,642,56,698,1.2,480
49,12,2,6,778,3,781,1.5,480
49,12,3,11,460,21,481,1.0,480
49,13,2,34,720,40,760,1.0,480
49,13,3,22,527,1,528,1.2,480
49,14,1,37,353,15,368,1.2,480
49,14,2,19,397,1,398,1.5,480
49,14,3,23,357,29,386,1.2,480
49,15,1,22,587,80,667,1.2,480
49,15,2,23,746,81,827,1.2,480
49,15,3,20,650,57,707,1.5,480
50,1,1,25,577,34,611,1.5,480
50,1,2,7,753,53,806,1.0,480
50,2,1,34,775,102,877,1.0,480
50,2,3,39,740,54,794,1.0,480
50,3,1,33,574,11,585,0.8,480
50,3,2,7,519,7,526,1.0,480
50,3,3,27,393,50,443,0.8,480
50,4,1,29,261,38,299,0.8,480
50,4,3,14,542,1,543,1.0,480
50,5,1,5,275,20,295,1.0,480
50,5,3,21,546,66,612,1.5,480
50,6,1,2,787,58,845,0.8,480
50,6,2,35,326,30,356,0.8,480
50,7,1,14,622,22,644,1.0,480
50,7,2,11,439,21,460,1.0,480
50,7,3,5,777,113,890,1.0,480
50,8,1,10,678,49,727,1.2,480
50,8,2,17,781,108,889,1.2,480
50,9,1,25,264,25,289,1.5,480
50,9,2,34,722,61,783,1.0,480
50,9,3,24,352,44,396,1.0,480
50,10,1,28,491,68,559,1.5,480
50,10,3,4,738,95,833,0.8,480
50,11,1,39,607,86,693,1.0,480
50,11,2,16,419,38,457,1.2,480
50,11,3,9,753,69,822,1.0,480
50,12,2,7,717,1,718,1.0,480
50,12,3,23,370,47,417,1.2,480
50,13,1,31,257,14,271,1.2,480
50,13,2,9,761,84,845,1.0,480
50,13,3,26,442,56,498,1.0,480
50,14,1,38,797,20,817,1.5,480
50,14,2,8,261,32,293,1.0,480
50,14,3,31,401,22,423,1.2,480
50,15,1,21,738,46,784,1.5,480
50,15,2,33,251,1,252,0.8,480
50,15,3,25,324,7,331,1.5,480
51,1,1,39,446,24,470,1.0,480
51,1,3,2,300,4,304,0.8,480
51,2,1,36,353,8,361,0.8,480
51,2,2,2,377,9,386,0.8,480
51,2,3,26,604,8,612,1.0,480
51,3,1,7,451,11,462,1.0,480
51,3,2,15,299,19,318,1.2,480
51,4,1,24,611,42,653,1.0,480
51,4,2,23,674,64,738,1.2,480
51,4,3,26,225,12,237,1.0,480
51,5,1,25,513,32,545,1.5,480
51,5,2,30,787,7,794,1.5,480
51,5,3,18,221,5,226,1.2,480
51,6,1,18,397,48,445,1.2,480
51,6,2,6,602,15,617,1.5,480
51,6,3,14,694,34,728,1.0,480
51,7,1,19,249,22,271,1.5,480
51,7,2,34,511,18,529,1.0,480
51,7,3,13,238,4,242,1.0,480
51,8,3,38,558,69,627,1.5,480
51,9,1,39,373,44,417,1.0,480
51,9,2,28,241,0,241,1.5,480
51,10,1,27,676,5,681,0.8,480
51,10,2,18,519,36,555,1.2,480
51,10,3,25,248,27,275,1.5,480
51,11,1,1,703,27,730,1.5,480
51,11,2,35,777,13,790,0.8,480
51,11,3,34,741,27,768,1.0,480
51,12,1,30,618,12,630,1.5,480
51,12,2,22,471,14,485,1.2,480
51,12,3,39,365,30,395,1.0,480
51,13,1,36,402,40,442,0.8,480
51,13,3,24,296,17,313,1.0,480
51,14,2,13,364,11,375,1.0,480
51,14,3,31,712,104,816,1.2,480
51,15,1,33,657,68,725,0.8,480
51,15,2,31,236,15,251,1.2,480
51,15,3,26,553,65,618,1.0,480
52,1,1,24,214,14,228,1.0,480
52,1,2,40,679,58,737,1.5,480
52,1,3,24,788,91,879,1.0,480
52,2,1,1,750,94,844,1.5,480
52,2,2,25,204,13,217,1.5,480
52,2,3,2,557,62,619,0.8,480
52,3,1,24,737,15,752,1.0,480
52,3,2,26,502,15,517,1.0,480
52,3,3,35,787,75,862,0.8,480
52,4,1,39,603,71,674,1.0,480
52,4,2,8,366,1,367,1.0,480
52,4,3,8,314,45,359,1.0,480
52,5,2,24,239,19,258,1.0,480
52,5,3,13,242,35,277,1.0,480
52,6,1,17,708,5,713,1.2,480
52,6,3,10,738,91,829,1.2,480
52,7,1,12,659,57,716,1.5,480
52,7,2,3,625,33,658,1.5,480
52,8,2,33,559,23,582,0.8,480
52,9,1,2,614,56,670,0.8,480
52,9,2,16,341,45,386,1.2,480
52,9,3,25,366,40,406,1.5,480
52,10,1,2,636,36,672,0.8,480
52,10,2,37,701,17,718,1.2,480
52,11,1,4,338,15,353,0.8,480
52,11,2,35,723,36,759,0.8,480
52,11,3,16,588,58,646,1.2,480
52,12,1,5,445,53,498,1.0,480
52,12,2,30,244,6,250,1.5,480
52,12,3,21,310,14,324,1.5,480
52,13,1,24,450,27,477,1.0,480
52,13,2,38,292,9,301,1.5,480
52,13,3,32,600,77,677,0.8,480
52,14,1,12,498,13,511,1.5,480
52,14,2,7,416,3,419,1.0,480
52,15,1,12,612,44,656,1.5,480
52,15,3,36,771,42,813,0.8,480
53,1,1,33,492,50,542,0.8,480
53,1,2,18,654,43,697,1.2,480
53,1,3,35,459,24,483,0.8,480
53,2,1,2,753,72,825,0.8,480
53,2,2,37,435,26,461,1.2,480
53,2,3,9,785,104,889,1.0,480
53,3,2,27,682,52,734,0.8,480
53,3,3,32,732,9,741,0.8,480
53,4,1,34,568,43,611,1.0,480
53,4,3,31,681,82,763,1.2,480
53,5,1,21,336,3,339,1.5,480
53,5,2,23,254,35,289,1.2,480
53,5,3,18,691,98,789,1.2,480
53,6,2,34,700,56,756,1.0,480
53,6,3,21,528,29,557,1.5,480
53,7,1,39,202,7,209,1.0,480
53,7,2,19,626,23,649,1.5,480
53,7,3,23,451,66,517,1.2,480
53,8,1,20,425,46,471,1.5,480
53,8,2,35,776,84,860,0.8,480
53,8,3,27,611,52,663,0.8,480
53,9,1,10,341,38,379,1.2,480
53,9,2,14,461,37,498,1.0,480
53,9,3,21,525,18,543,1.5,480
53,10,1,17,796,32,828,1.2,480
53,10,3,10,238,3,241,1.2,480
53,11,1,24,423,8,431,1.0,480
53,11,2,32,328,46,374,0.8,480
53,11,3,22,728,26,754,1.2,480
53,12,1,39,283,12,295,1.0,480
53,12,2,25,514,40,554,1.5,480
53,12,3,6,659,51,710,1.5,480
53,13,1,27,531,34,565,0.8,480
53,13,2,17,509,13,522,1.2,480
53,13,3,7,279,39,318,1.0,480
53,14,2,6,696,43,739,1.5,480
53,14,3,3,259,37,296,1.5,480
53,15,2,28,621,36,657,1.5,480
53,15,3,16,621,29,650,1.2,480
54,1,1,27,286,25,311,0.8,480
54,1,2,26,437,58,495,1.0,480
54,1,3,25,682,52,734,1.5,480
54,2,1,38,704,12,716,1.5,480
54,2,2,38,252,20,272,1.5,480
54,2,3,14,674,14,688,1.0,480
54,3,1,3,226,14,240,1.5,480
54,3,2,28,740,88,828,1.5,480
54,3,3,14,314,9,323,1.0,480
54,4,1,28,344,26,370,1.5,480
54,4,2,27,362,15,377,0.8,480
54,4,3,17,614,79,693,1.2,480
54,5,1,11,540,30,570,1.0,480
54,5,2,35,650,95,745,0.8,480
54,5,3,16,739,2,741,1.2,480
54,6,1,32,611,71,682,0.8,480
54,6,3,16,589,43,632,1.2,480
54,7,1,1,556,5,561,1.5,480
54,7,2,17,216,22,238,1.2,480
54,8,1,17,267,38,305,1.2,480
54,8,2,13,309,21,330,1.0,480
54,8,3,38,414,36,450,1.5,480
54,9,3,13,327,14,341,1.0,480
54,10,1,21,264,12,276,1.5,480
54,10,2,34,321,9,330,1.0,480
54,10,3,2,498,0,498,0.8,480
54,11,1,32,420,12,432,0.8,480
54,11,2,27,462,33,495,0.8,480
54,11,3,25,543,1,544,1.5,480
54,12,1,36,613,79,692,0.8,480
54,12,3,29,397,58,455,0.8,480
54,13,1,20,354,38,392,1.5,480
54,13,2,11,691,10,701,1.0,480
54,13,3,4,746,71,817,0.8,480
54,14,1,21,244,12,256,1.5,480
54,14,2,2,321,16,337,0.8,480
54,14,3,34,258,21,279,1.0,480
54,15,1,9,606,13,619,1.0,480
54,15,2,32,421,9,430,0.8,480
54,15,3,30,745,67,812,1.5,480
55,1,1,26,312,29,341,1.0,480
55,1,2,2,255,35,290,0.8,480
55,1,3,30,541,80,621,1.5,480
55,2,1,25,207,25,232,1.5,480
55,2,2,2,681,68,749,0.8,480
55,2,3,26,508,21,529,1.0,480
55,3,1,31,528,15,543,1.2,480
55,3,2,39,718,17,735,1.0,480
55,3,3,24,369,47,416,1.0,480
55,4,1,7,746,81,827,1.0,480
55,4,2,10,539,8,547,1.2,480
55,5,1,13,618,12,630,1.0,480
55,5,2,30,373,19,392,1.5,480
55,5,3,19,688,50,738,1.5,480
55,6,1,15,392,17,409,1.2,480
55,6,3,7,361,15,376,1.0,480
55,7,1,35,270,27,297,0.8,480
55,7,2,10,600,52,652,1.2,480
55,7,3,30,421,41,462,1.5,480
55,8,1,28,472,18,490,1.5,480
55,8,2,7,575,70,645,1.0,480
55,8,3,17,227,0,227,1.2,480
55,9,1,19,409,12,421,1.5,480
55,9,3,9,413,48,461,1.0,480
55,10,3,24,293,39,332,1.0,480
55,11,1,4,317,42,359,0.8,480
55,11,2,32,292,41,333,0.8,480
55,11,3,5,252,23,275,1.0,480
55,12,1,8,552,38,590,1.0,480
55,12,2,8,523,7,530,1.0,480
55,13,1,7,570,32,602,1.0,480
55,13,2,9,252,23,275,1.0,480
55,13,3,40,744,52,796,1.5,480
55,14,1,10,683,41,724,1.2,480
55,14,2,8,691,13,704,1.0,480
55,14,3,15,687,51,738,1.2,480
55,15,1,9,411,5,416,1.0,480
55,15,2,1,299,5,304,1.5,480
56,1,1,23,353,11,364,1.2,480
56,1,3,22,652,46,698,1.2,480
56,2,1,14,267,25,292,1.0,480
56,3,1,12,671,92,763,1.5,480
56,3,2,40,631,36,667,1.5,480
56,3,3,2,470,28,498,0.8,480
56,4,1,39,764,10,774,1.0,480
56,4,2,15,390,6,396,1.2,480
56,4,3,8,277,0,277,1.0,480
56,5,1,3,268,39,307,1.5,480
56,5,2,12,288,30,318,1.5,480
56,5,3,27,265,21,286,0.8,480
56,6,2,14,520,23,543,1.0,480
56,6,3,40,271,18,289,1.5,480
56,7,3,16,419,60,479,1.2,480
56,8,1,17,330,11,341,1.2,480
56,8,2,18,493,48,541,1.2,480
56,8,3,35,242,20,262,0.8,480
56,9,1,23,498,2,500,1.2,480
56,9,2,27,335,17,352,0.8,480
56,9,3,34,242,7,249,1.0,480
56,10,2,40,450,31,481,1.5,480
56,10,3,36,441,3,444,0.8,480
56,11,1,19,311,36,347,1.5,480
56,11,3,10,711,69,780,1.2,480
56,12,3,12,675,97,772,1.5,480
56,13,1,19,616,3,619,1.5,480
56,13,2,19,317,5,322,1.5,480
56,13,3,23,308,44,352,1.2,480
56,14,1,28,538,60,598,1.5,480
56,14,3,21,223,3,226,1.5,480
56,15,1,30,312,39,351,1.5,480
56,15,2,17,368,0,368,1.2,480
56,15,3,37,397,53,450,1.2,480
57,1,1,5,604,54,658,1.0,480
57,1,2,38,427,5,432,1.5,480
57,1,3,5,201,25,226,1.0,480
57,2,1,5,701,40,741,1.0,480
57,2,2,25,716,93,809,1.5,480
57,2,3,17,263,35,298,1.2,480
57,3,3,31,554,20,574,1.2,480
57,4,1,26,702,19,721,1.0,480
57,4,3,4,222,5,227,0.8,480
57,5,1,14,649,19,668,1.0,480
57,5,2,32,325,10,335,0.8,480
57,5,3,18,491,9,500,1.2,480
57,6,2,20,650,43,693,1.5,480
57,6,3,36,571,0,571,0.8,480
57,7,1,38,341,36,377,1.5,480
57,7,2,35,552,59,611,0.8,480
57,7,3,27,362,32,394,0.8,480
57,8,2,8,628,62,690,1.0,480
57,8,3,14,385,21,406,1.0,480
57,9,1,36,533,59,592,0.8,480
57,9,2,22,323,1,324,1.2,480
57,9,3,37,465,11,476,1.2,480
57,10,1,24,251,35,286,1.0,480
57,10,2,31,629,36,665,1.2,480
57,10,3,18,492,35,527,1.2,480
57,11,1,3,405,21,426,1.5,480
57,11,2,18,311,39,350,1.2,480
57,11,3,15,663,51,714,1.2,480
57,12,1,24,655,42,697,1.0,480
57,12,2,32,752,77,829,0.8,480
57,12,3,14,702,95,797,1.0,480
57,13,1,24,492,49,541,1.0,480
57,13,2,11,541,25,566,1.0,480
57,13,3,19,794,86,880,1.5,480
57,14,1,4,240,19,259,0.8,480
57,14,3,10,506,47,553,1.2,480
57,15,1,22,542,3,545,1.2,480
57,15,2,25,533,76,609,1.5,480
57,15,3,25,387,24,411,1.5,480
58,1,1,7,575,38,613,1.0,480
58,1,3,24,605,38,643,1.0,480
58,2,1,30,212,7,219,1.5,480
58,2,2,34,234,20,254,1.0,480
58,2,3,7,751,75,826,1.0,480
58,3,1,4,270,34,304,0.8,480
58,3,2,34,232,10,242,1.0,480
58,3,3,9,601,77,678,1.0,480
58,4,1,40,600,69,669,1.5,480
58,4,2,25,348,7,355,1.5,480
58,4,3,20,778,14,792,1.5,480
58,5,1,24,615,72,687,1.0,480
58,5,2,29,646,29,675,0.8,480
58,5,3,7,432,27,459,1.0,480
58,6,2,14,286,22,308,1.0,480
58,6,3,4,224,28,252,0.8,480
58,7,1,16,214,20,234,1.2,480
58,7,3,21,485,9,494,1.5,480
58,8,1,10,384,5,389,1.2,480
58,8,2,27,298,13,311,0.8,480
58,8,3,18,520,59,579,1.2,480
58,9,1,38,524,52,576,1.5,480
58,9,2,27,707,32,739,0.8,480
58,9,3,4,578,28,606,0.8,480
58,10,1,39,463,4,467,1.0,480
58,10,2,26,254,0,254,1.0,480
58,10,3,25,333,34,367,1.5,480
58,11,1,23,454,29,483,1.2,480
58,11,2,8,432,45,477,1.0,480
58,11,3,16,413,15,428,1.2,480
58,12,1,24,228,31,259,1.0,480
58,12,3,40,538,76,614,1.5,480
58,13,1,29,485,2,487,0.8,480
58,13,2,24,624,21,645,1.0,480
58,13,3,1,404,47,451,1.5,480
58,14,1,18,624,91,715,1.2,480
58,14,2,18,755,54,809,1.2,480
58,14,3,22,717,50,767,1.2,480
58,15,1,27,399,7,406,0.8,480
58,15,2,25,799,30,829,1.5,480
58,15,3,36,728,38,766,0.8,480
59,1,1,36,443,49,492,0.8,480
59,1,2,5,509,40,549,1.0,480
59,1,3,32,629,51,680,0.8,480
59,2,1,27,573,0,573,0.8,480
59,2,2,13,401,49,450,1.0,480
59,2,3,11,343,20,363,1.0,480
59,3,1,10,206,29,235,1.2,480
59,3,3,35,717,29,746,0.8,480
59,4,1,2,747,12,759,0.8,480
59,4,2,24,632,65,697,1.0,480
59,5,1,5,264,30,294,1.0,480
59,5,3,21,458,3,461,1.5,480
59,6,1,35,241,4,245,0.8,480
59,6,2,7,468,41,509,1.0,480
59,6,3,18,533,51,584,1.2,480
59,7,1,15,711,17,728,1.2,480
59,7,2,30,449,7,456,1.5,480
59,7,3,28,256,21,277,1.5,480
59,8,1,6,368,27,395,1.5,480
59,8,2,24,268,17,285,1.0,480
59,8,3,29,504,41,545,0.8,480
59,9,1,21,407,8,415,1.5,480
59,9,2,1,305,21,326,1.5,480
59,9,3,22,214,22,236,1.2,480
59,10,1,30,400,50,450,1.5,480
59,10,2,6,218,13,231,1.5,480
59,10,3,12,334,0,334,1.5,480
59,11,1,38,318,46,364,1.5,480
59,11,2,17,329,29,358,1.2,480
59,12,1,29,224,28,252,0.8,480
59,12,2,4,742,95,837,0.8,480
59,12,3,38,361,50,411,1.5,480
59,13,1,21,466,7,473,1.5,480
59,13,2,18,726,52,778,1.2,480
59,13,3,27,265,0,265,0.8,480
59,14,1,20,585,17,602,1.5,480
59,14,2,13,351,41,392,1.0,480
59,14,3,23,481,53,534,1.2,480
59,15,3,21,357,35,392,1.5,480
60,1,1,10,721,82,803,1.2,480
60,1,2,23,700,71,771,1.2,480
60,2,1,23,208,19,227,1.2,480
60,2,2,33,591,18,609,0.8,480
60,3,1,31,546,60,606,1.2,480
60,3,2,17,491,35,526,1.2,480
60,4,2,35,539,67,606,0.8,480
60,5,1,9,346,17,363,1.0,480
60,5,2,1,514,58,572,1.5,480
60,5,3,14,548,0,548,1.0,480
60,6,1,27,628,49,677,0.8,480
60,6,2,11,334,33,367,1.0,480
60,6,3,22,657,55,712,1.2,480
60,7,1,4,276,34,310,0.8,480
60,7,2,27,572,67,639,0.8,480
60,7,3,26,663,90,753,1.0,480
60,8,2,15,252,5,257,1.2,480
60,8,3,31,664,58,722,1.2,480
60,9,1,14,638,62,700,1.0,480
60,9,2,34,433,9,442,1.0,480
60,9,3,23,364,7,371,1.2,480
60,10,2,13,792,95,887,1.0,480
60,10,3,34,273,34,307,1.0,480
60,11,1,30,537,4,541,1.5,480
60,11,2,15,312,41,353,1.2,480
60,11,3,3,717,31,748,1.5,480
60,12,1,4,406,17,423,0.8,480
60,12,2,14,755,88,843,1.0,480
60,12,3,32,755,34,789,0.8,480
60,13,1,26,630,15,645,1.0,480
60,13,3,1,242,34,276,1.5,480
60,14,1,31,327,26,353,1.2,480
60,14,2,34,496,18,514,1.0,480
60,14,3,18,329,30,359,1.2,480
60,15,1,28,798,42,840,1.5,480
60,15,3,10,510,22,532,1.2,480
61,1,1,16,636,34,670,1.2,480
61,1,2,7,464,16,480,1.0,480
61,1,3,10,729,100,829,1.2,480
61,2,1,31,263,23,286,1.2,480
61,2,2,17,719,1,720,1.2,480
61,3,2,10,531,6,537,1.2,480
61,3,3,13,505,20,525,1.0,480
61,4,1,31,612,57,669,1.2,480
61,4,2,15,396,48,444,1.2,480
61,4,3,19,406,19,425,1.5,480
61,5,1,6,560,56,616,1.5,480
61,5,2,10,282,20,302,1.2,480
61,6,1,2,699,9,708,0.8,480
61,6,2,40,233,2,235,1.5,480
61,6,3,26,258,27,285,1.0,480
61,7,1,2,745,93,838,0.8,480
61,7,3,38,588,27,615,1.5,480
61,8,2,24,631,80,711,1.0,480
61,8,3,27,772,98,870,0.8,480
61,9,1,17,332,28,360,1.2,480
61,9,2,16,627,40,667,1.2,480
61,10,1,32,437,27,464,0.8,480
61,10,2,33,335,5,340,0.8,480
61,10,3,3,278,1,279,1.5,480
61,11,1,25,597,50,647,1.5,480
61,11,2,39,323,20,343,1.0,480
61,12,1,22,578,59,637,1.2,480
61,12,2,33,395,15,410,0.8,480
61,12,3,25,483,29,512,1.5,480
61,13,1,25,322,25,347,1.5,480
61,13,2,26,467,10,477,1.0,480
61,14,1,35,777,45,822,0.8,480
61,14,2,14,258,36,294,1.0,480
61,14,3,36,491,39,530,0.8,480
61,15,1,8,601,52,653,1.0,480
61,15,2,1,429,12,441,1.5,480
61,15,3,37,609,16,625,1.2,480
62,1,1,33,472,46,518,0.8,480
62,1,2,37,606,2,608,1.2,480
62,1,3,26,305,3,308,1.0,480
62,2,1,39,527,27,554,1.0,480
62,2,3,16,573,43,616,1.2,480
62,3,2,38,459,32,491,1.5,480
62,3,3,19,619,57,676,1.5,480
62,4,1,10,443,17,460,1.2,480
62,4,2,3,629,65,694,1.5,480
62,4,3,12,252,10,262,1.5,480
62,5,1,28,383,34,417,1.5,480
62,5,2,15,528,13,541,1.2,480
62,5,3,26,408,19,427,1.0,480
62,6,1,4,460,62,522,0.8,480
62,6,2,23,365,9,374,1.2,480
62,6,3,35,257,8,265,0.8,480
62,7,1,9,701,85,786,1.0,480
62,7,3,5,272,22,294,1.0,480
62,8,1,38,535,68,603,1.5,480
62,8,2,21,373,13,386,1.5,480
62,9,1,13,583,63,646,1.0,480
62,9,3,24,529,12,541,1.0,480
62,10,2,19,584,50,634,1.5,480
62,10,3,26,624,77,701,1.0,480
62,11,1,10,202,0,202,1.2,480
62,11,2,34,525,66,591,1.0,480
62,11,3,12,664,20,684,1.5,480
62,12,1,26,314,35,349,1.0,480
62,12,2,33,272,9,281,0.8,480
62,12,3,36,576,39,615,0.8,480
62,13,2,26,305,6,311,1.0,480
62,13,3,36,353,42,395,0.8,480
62,14,1,8,688,102,790,1.0,480
62,14,2,17,764,69,833,1.2,480
62,14,3,37,511,8,519,1.2,480
62,15,1,26,217,29,246,1.0,480
62,15,2,33,324,25,349,0.8,480
62,15,3,10,694,80,774,1.2,480
63,1,1,8,388,40,428,1.0,480
63,1,2,31,384,40,424,1.2,480
63,1,3,7,261,24,285,1.0,480
63,2,1,23,602,87,689,1.2,480
63,2,2,11,475,35,510,1.0,480
63,2,3,38,689,92,781,1.5,480
63,3,1,23,406,9,415,1.2,480
63,3,2,40,578,21,599,1.5,480
63,3,3,39,617,89,706,1.0,480
63,4,1,26,557,41,598,1.0,480
63,4,2,11,702,81,783,1.0,480
63,4,3,15,707,96,803,1.2,480
63,5,1,4,771,87,858,0.8,480
63,5,2,20,515,20,535,1.5,480
63,5,3,6,634,36,670,1.5,480
63,6,2,24,513,1,514,1.0,480
63,7,1,36,568,84,652,0.8,480
63,7,2,24,268,11,279,1.0,480
63,7,3,7,589,63,652,1.0,480
63,8,1,35,429,52,481,0.8,480
63,8,2,8,218,30,248,1.0,480
63,8,3,17,283,12,295,1.2,480
63,9,1,4,308,6,314,0.8,480
63,9,2,28,523,64,587,1.5,480
63,10,1,19,762,109,871,1.5,480
63,10,2,31,780,113,893,1.2,480
63,10,3,1,216,2,218,1.5,480
63,11,1,5,363,37,400,1.0,480
63,11,2,32,609,5,614,0.8,480
63,11,3,1,204,16,220,1.5,480
63,12,1,24,459,31,490,1.0,480
63,12,2,9,340,38,378,1.0,480
63,12,3,15,348,50,398,1.2,480
63,13,1,39,535,18,553,1.0,480
63,13,2,38,682,30,712,1.5,480
63,13,3,23,433,60,493,1.2,480
63,14,1,26,308,3,311,1.0,480
63,14,2,17,653,13,666,1.2,480
63,14,3,3,635,56,691,1.5,480
63,15,2,40,577,39,616,1.5,480
63,15,3,3,790,101,891,1.5,480
64,1,2,15,342,7,349,1.2,480
64,1,3,22,201,19,220,1.2,480
64,2,1,17,503,59,562,1.2,480
64,2,2,28,589,21,610,1.5,480
64,2,3,27,721,66,787,0.8,480
64,3,1,25,566,10,576,1.5,480
64,3,3,19,742,95,837,1.5,480
64,4,1,19,206,11,217,1.5,480
64,4,2,29,757,57,814,0.8,480
64,4,3,36,641,51,692,0.8,480
64,5,1,20,706,23,729,1.5,480
64,5,2,26,600,14,614,1.0,480
64,5,3,40,771,104,875,1.5,480
64,6,1,27,591,44,635,0.8,480
64,6,2,11,325,20,345,1.0,480
64,6,3,1,366,12,378,1.5,480
64,7,1,14,290,4,294,1.0,480
64,7,3,36,783,49,832,0.8,480
64,8,1,8,530,15,545,1.0,480
64,8,2,20,465,37,502,1.5,480
64,8,3,19,371,25,396,1.5,480
64,9,1,33,609,59,668,0.8,480
64,9,2,11,681,79,760,1.0,480
64,9,3,37,636,46,682,1.2,480
64,10,2,37,447,65,512,1.2,480
64,10,3,10,535,78,613,1.2,480
64,11,1,12,543,45,588,1.5,480
64,11,2,1,632,37,669,1.5,480
64,11,3,14,212,22,234,1.0,480
64,12,1,6,244,15,259,1.5,480
64,12,2,23,284,30,314,1.2,480
64,12,3,8,501,73,574,1.0,480
64,13,1,30,461,56,517,1.5,480
64,14,1,10,443,12,455,1.2,480
64,14,2,38,261,8,269,1.5,480
64,14,3,5,710,53,763,1.0,480
64,15,1,28,289,1,290,1.5,480
65,1,1,17,753,105,858,1.2,480
65,1,2,8,654,16,670,1.0,480
65,1,3,37,750,85,835,1.2,480
65,2,1,38,445,50,495,1.5,480
65,2,2,37,332,19,351,1.2,480
65,2,3,36,243,1,244,0.8,480
65,3,1,3,609,89,698,1.5,480
65,3,2,35,410,36,446,0.8,480
65,3,3,23,747,57,804,1.2,480
65,4,2,1,544,60,604,1.5,480
65,4,3,18,503,22,525,1.2,480
65,5,1,18,213,8,221,1.2,480
65,5,2,40,360,38,398,1.5,480
65,5,3,27,569,48,617,0.8,480
65,6,1,35,767,80,847,0.8,480
65,6,2,35,734,61,795,0.8,480
65,7,1,9,620,6,626,1.0,480
65,7,2,26,379,31,410,1.0,480
65,7,3,5,425,33,458,1.0,480
65,8,1,38,392,19,411,1.5,480
65,8,2,31,611,20,631,1.2,480
65,8,3,37,712,55,767,1.2,480
65,9,1,39,455,44,499,1.0,480
65,9,2,12,271,34,305,1.5,480
65,9,3,29,321,34,355,0.8,480
65,10,2,2,655,67,722,0.8,480
65,11,2,19,747,105,852,1.5,480
65,12,1,17,429,5,434,1.2,480
65,12,2,14,296,26,322,1.0,480
65,12,3,40,292,32,324,1.5,480
65,13,1,1,524,41,565,1.5,480
65,13,3,15,324,34,358,1.2,480
65,14,2,12,628,5,633,1.5,480
65,14,3,4,783,100,883,0.8,480
65,15,1,8,730,75,805,1.0,480
65,15,2,18,633,90,723,1.2,480
65,15,3,12,325,36,361,1.5,480
66,1,3,14,435,32,467,1.0,480
66,2,1,24,703,67,770,1.0,480
66,2,2,1,659,95,754,1.5,480
66,2,3,40,462,10,472,1.5,480
66,3,1,39,656,36,692,1.0,480
66,3,3,4,588,36,624,0.8,480
66,4,1,12,233,12,245,1.5,480
66,4,2,13,495,57,552,1.0,480
66,4,3,37,300,38,338,1.2,480
66,5,1,29,601,13,614,0.8,480
66,5,2,11,237,23,260,1.0,480
66,5,3,7,526,24,550,1.0,480
66,6,1,37,242,17,259,1.2,480
66,6,2,27,455,65,520,0.8,480
66,6,3,2,290,19,309,0.8,480
66,7,2,40,665,30,695,1.5,480
66,8,1,15,770,10,780,1.2,480
66,8,2,15,742,55,797,1.2,480
66,9,1,27,732,64,796,0.8,480
66,9,2,12,377,12,389,1.5,480
66,9,3,32,637,61,698,0.8,480
66,10,1,40,636,70,706,1.5,480
66,10,2,5,270,32,302,1.0,480
66,10,3,12,288,32,320,1.5,480
66,11,1,6,783,20,803,1.5,480
66,11,3,20,766,7,773,1.5,480
66,12,1,29,512,51,563,0.8,480
66,12,2,2,371,31,402,0.8,480
66,12,3,20,530,3,533,1.5,480
66,13,3,1,262,23,285,1.5,480
66,14,1,25,731,46,777,1.5,480
66,14,2,37,635,63,698,1.2,480
66,14,3,1,622,23,645,1.5,480
66,15,1,19,531,3,534,1.5,480
67,1,1,17,253,29,282,1.2,480
67,1,2,25,362,8,370,1.5,480
67,1,3,33,663,58,721,0.8,480
67,2,1,38,265,0,265,1.5,480
67,2,2,9,526,66,592,1.0,480
67,2,3,33,518,65,583,0.8,480
67,3,1,29,334,23,357,0.8,480
67,3,2,4,625,84,709,0.8,480
67,3,3,33,583,57,640,0.8,480
67,4,1,7,296,0,296,1.0,480
67,4,2,33,701,45,746,0.8,480
67,5,1,6,607,55,662,1.5,480
67,5,2,10,731,89,820,1.2,480
67,5,3,25,666,91,757,1.5,480
67,6,1,21,734,18,752,1.5,480
67,6,2,33,648,39,687,0.8,480
67,7,1,3,731,78,809,1.5,480
67,7,2,27,567,12,579,0.8,480
67,7,3,31,702,86,788,1.2,480
67,8,1,9,548,7,555,1.0,480
67,8,2,23,571,82,653,1.2,480
67,8,3,19,344,26,370,1.5,480
67,9,3,23,253,14,267,1.2,480
67,10,1,32,535,1,536,0.8,480
67,10,2,33,392,40,432,0.8,480
67,11,1,4,784,31,815,0.8,480
67,11,2,27,742,69,811,0.8,480
67,11,3,39,453,22,475,1.0,480
67,12,1,7,753,87,840,1.0,480
67,12,2,28,206,18,224,1.5,480
67,13,2,36,444,48,492,0.8,480
67,13,3,2,591,80,671,0.8,480
67,14,1,30,780,24,804,1.5,480
67,14,2,26,562,82,644,1.0,480
67,14,3,40,341,21,362,1.5,480
67,15,1,5,208,9,217,1.0,480
67,15,2,6,734,106,840,1.5,480
67,15,3,38,296,3,299,1.5,480
68,1,1,28,512,3,515,1.5,480
68,1,3,38,461,21,482,1.5,480
68,2,1,31,208,29,237,1.2,480
68,2,2,40,288,2,290,1.5,480
68,2,3,4,430,34,464,0.8,480
68,3,1,7,298,36,334,1.0,480
68,3,2,15,561,29,590,1.2,480
68,3,3,9,651,40,691,1.0,480
68,4,1,19,463,34,497,1.5,480
68,4,2,2,754,10,764,0.8,480
68,4,3,27,418,14,432,0.8,480
68,5,2,8,424,59,483,1.0,480
68,5,3,11,464,2,466,1.0,480
68,6,1,40,385,16,401,1.5,480
68,6,2,22,425,2,427,1.2,480
68,6,3,3,211,17,228,1.5,480
68,7,1,2,443,42,485,0.8,480
68,7,2,40,730,49,779,1.5,480
68,7,3,40,787,5,792,1.5,480
68,8,1,35,506,33,539,0.8,480
68,8,3,38,219,28,247,1.5,480
68,9,1,8,504,45,549,1.0,480
68,9,2,20,262,21,283,1.5,480
68,9,3,25,782,44,826,1.5,480
68,10,1,3,599,15,614,1.5,480
68,10,2,20,391,44,435,1.5,480
68,11,1,15,395,28,423,1.2,480
68,11,2,1,332,33,365,1.5,480
68,11,3,9,497,22,519,1.0,480
68,12,1,1,514,37,551,1.5,480
68,12,3,1,550,33,583,1.5,480
68,13,2,32,227,21,248,0.8,480
68,13,3,20,660,37,697,1.5,480
68,14,1,4,614,47,661,0.8,480
68,14,2,24,698,64,762,1.0,480
68,14,3,9,508,9,517,1.0,480
68,15,1,16,727,55,782,1.2,480
68,15,2,39,741,96,837,1.0,480
68,15,3,5,744,48,792,1.0,480
69,1,1,37,513,62,575,1.2,480
69,1,2,33,208,7,215,0.8,480
69,1,3,34,696,29,725,1.0,480
69,2,2,21,403,55,458,1.5,480
69,2,3,15,766,52,818,1.2,480
69,3,2,31,348,28,376,1.2,480
69,4,1,32,373,42,415,0.8,480
69,4,3,12,656,5,661,1.5,480
69,5,1,19,534,38,572,1.5,480
69,5,2,8,436,43,479,1.0,480
69,5,3,40,352,35,387,1.5,480
69,6,1,36,508,8,516,0.8,480
69,6,2,34,605,83,688,1.0,480
69,7,1,19,771,0,771,1.5,480
69,7,2,26,582,60,642,1.0,480
69,7,3,14,384,4,388,1.0,480
69,8,1,37,541,65,606,1.2,480
69,8,2,34,320,2,322,1.0,480
69,8,3,12,383,13,396,1.5,480
69,9,1,26,612,63,675,1.0,480
69,9,3,39,602,34,636,1.0,480
69,10,1,24,593,64,657,1.0,480
69,10,3,8,585,0,585,1.0,480
69,11,1,5,305,41,346,1.0,480
69,11,2,31,540,21,561,1.2,480
69,11,3,9,464,1,465,1.0,480
69,12,1,25,772,24,796,1.5,480
69,12,2,28,571,47,618,1.5,480
69,12,3,27,664,93,757,0.8,480
69,13,1,16,707,58,765,1.2,480
69,13,3,33,604,20,624,0.8,480
69,14,1,6,367,23,390,1.5,480
69,14,2,27,536,40,576,0.8,480
69,14,3,32,765,11,776,0.8,480
69,15,1,20,321,2,323,1.5,480
69,15,2,28,254,3,257,1.5,480
69,15,3,35,239,4,243,0.8,480
70,1,1,32,709,32,741,0.8,480
70,1,2,9,785,101,886,1.0,480
70,1,3,12,336,18,354,1.5,480
70,2,1,12,760,71,831,1.5,480
70,2,2,7,754,34,788,1.0,480
70,2,3,30,648,70,718,1.5,480
70,3,1,28,313,18,331,1.5,480
70,3,2,30,765,99,864,1.5,480
70,3,3,2,453,1,454,0.8,480
70,4,1,39,510,18,528,1.0,480
70,4,2,28,580,70,650,1.5,480
70,4,3,36,397,50,447,0.8,480
70,5,1,5,408,11,419,1.0,480
70,5,3,39,370,48,418,1.0,480
70,6,1,21,790,71,861,1.5,480
70,6,3,27,568,3,571,0.8,480
70,7,2,21,367,35,402,1.5,480
70,7,3,38,526,15,541,1.5,480
70,8,1,39,288,1,289,1.0,480
70,8,3,29,547,46,593,0.8,480
70,9,1,38,570,18,588,1.5,480
70,9,2,38,649,64,713,1.5,480
70,9,3,16,473,27,500,1.2,480
70,10,1,6,259,27,286,1.5,480
70,10,2,5,338,16,354,1.0,480
70,10,3,4,643,2,645,0.8,480
70,11,1,25,347,8,355,1.5,480
70,11,2,10,357,39,396,1.2,480
70,11,3,20,595,51,646,1.5,480
70,12,1,31,751,5,756,1.2,480
70,12,2,25,383,45,428,1.5,480
70,12,3,34,665,66,731,1.0,480
70,13,1,24,706,79,785,1.0,480
70,13,2,14,221,8,229,1.0,480
70,13,3,11,661,62,723,1.0,480
70,14,1,28,547,50,597,1.5,480
70,14,3,40,511,22,533,1.5,480
70,15,1,17,684,49,733,1.2,480
70,15,3,36,398,19,417,0.8,480
71,1,1,31,671,34,705,1.2,480
71,1,2,39,588,38,626,1.0,480
71,1,3,11,452,29,481,1.0,480
71,2,1,23,603,8,611,1.2,480
71,2,2,23,361,40,401,1.2,480
71,3,1,7,451,26,477,1.0,480
71,3,3,38,409,9,418,1.5,480
71,4,2,36,402,11,413,0.8,480
71,4,3,12,242,26,268,1.5,480
71,5,2,3,537,7,544,1.5,480
71,5,3,7,626,74,700,1.0,480
71,6,1,26,546,33,579,1.0,480
71,6,3,9,240,22,262,1.0,480
71,7,1,26,522,43,565,1.0,480
71,7,2,1,219,26,245,1.5,480
71,7,3,27,767,36,803,0.8,480
71,8,1,9,785,18,803,1.0,480
71,8,2,10,307,16,323,1.2,480
71,8,3,22,347,49,396,1.2,480
71,9,1,37,720,90,810,1.2,480
71,9,2,19,221,11,232,1.5,480
71,9,3,7,570,47,617,1.0,480
71,10,1,1,374,25,399,1.5,480
71,10,2,38,471,46,517,1.5,480
71,11,1,32,397,35,432,0.8,480
71,11,2,34,368,24,392,1.0,480
71,11,3,39,799,33,832,1.0,480
71,12,1,36,556,37,593,0.8,480
71,12,2,12,335,24,359,1.5,480
71,12,3,11,748,76,824,1.0,480
71,13,2,6,359,1,360,1.5,480
71,13,3,27,442,54,496,0.8,480
71,14,1,17,349,18,367,1.2,480
71,14,2,12,248,13,261,1.5,480
71,14,3,32,474,47,521,0.8,480
71,15,2,27,769,65,834,0.8,480
71,15,3,1,302,10,312,1.5,480
72,1,1,24,266,2,268,1.0,480
72,1,2,25,298,24,322,1.5,480
72,1,3,34,478,37,515,1.0,480
72,2,2,36,385,52,437,0.8,480
72,3,1,21,351,31,382,1.5,480
72,3,3,22,622,80,702,1.2,480
72,4,1,28,435,34,469,1.5,480
72,4,3,17,473,1,474,1.2,480
72,5,1,23,784,94,878,1.2,480
72,5,2,29,787,42,829,0.8,480
72,5,3,39,745,99,844,1.0,480
72,6,1,1,383,7,390,1.5,480
72,6,2,25,343,7,350,1.5,480
72,6,3,22,382,17,399,1.2,480
72,7,1,21,397,16,413,1.5,480
72,7,3,4,237,5,242,0.8,480
72,8,2,31,211,21,232,1.2,480
72,8,3,6,619,63,682,1.5,480
72,9,2,16,417,20,437,1.2,480
72,10,1,32,320,28,348,0.8,480
72,10,2,9,457,52,509,1.0,480
72,10,3,18,365,10,375,1.2,480
72,11,1,30,705,30,735,1.5,480
72,11,2,7,230,17,247,1.0,480
72,11,3,23,330,47,377,1.2,480
72,12,1,40,389,27,416,1.5,480
72,12,3,8,711,11,722,1.0,480
72,13,1,25,249,7,256,1.5,480
72,13,2,30,642,60,702,1.5,480
72,13,3,25,477,3,480,1.5,480
72,14,1,24,430,50,480,1.0,480
72,14,2,29,608,19,627,0.8,480
72,14,3,10,746,108,854,1.2,480
72,15,2,24,671,14,685,1.0,480
73,1,1,19,283,18,301,1.5,480
73,1,2,9,247,11,258,1.0,480
73,1,3,16,591,42,633,1.2,480
73,2,1,7,536,9,545,1.0,480
73,2,2,38,304,30,334,1.5,480
73,2,3,34,341,45,386,1.0,480
73,3,1,2,234,6,240,0.8,480
73,3,2,23,457,52,509,1.2,480
73,4,1,17,720,60,780,1.2,480
73,4,2,30,290,31,321,1.5,480
73,5,1,16,566,57,623,1.2,480
73,5,2,24,511,51,562,1.0,480
73,5,3,23,641,77,718,1.2,480
73,6,1,8,325,5,330,1.0,480
73,7,1,9,709,28,737,1.0,480
73,7,2,9,231,0,231,1.0,480
73,7,3,35,676,4,680,0.8,480
73,8,1,26,473,41,514,1.0,480
73,8,2,1,674,99,773,1.5,480
73,8,3,9,235,25,260,1.0,480
73,9,1,36,735,108,843,0.8,480
73,9,2,3,385,16,401,1.5,480
73,9,3,28,229,9,238,1.5,480
73,10,1,23,582,86,668,1.2,480
73,10,2,13,786,87,873,1.0,480
73,10,3,36,596,78,674,0.8,480
73,11,1,10,425,11,436,1.2,480
73,11,2,26,502,28,530,1.0,480
73,11,3,7,592,52,644,1.0,480
73,12,2,1,466,9,475,1.5,480
73,12,3,4,488,41,529,0.8,480
73,13,1,23,223,30,253,1.2,480
73,13,2,29,210,17,227,0.8,480
73,13,3,5,743,83,826,1.0,480
73,14,2,18,347,23,370,1.2,480
73,14,3,39,423,37,460,1.0,480
73,15,2,37,254,10,264,1.2,480
73,15,3,38,740,59,799,1.5,480
74,1,1,18,748,93,841,1.2,480
74,1,2,40,456,41,497,1.5,480
74,1,3,37,519,1,520,1.2,480
74,2,2,14,307,30,337,1.0,480
74,2,3,37,652,66,718,1.2,480
74,3,1,40,316,4,320,1.5,480
74,3,2,40,712,6,718,1.5,480
74,3,3,25,211,20,231,1.5,480
74,4,1,40,272,15,287,1.5,480
74,4,2,26,676,37,713,1.0,480
74,4,3,29,428,5,433,0.8,480
74,5,3,7,431,31,462,1.0,480
74,6,1,17,543,76,619,1.2,480
74,6,2,36,625,63,688,0.8,480
74,6,3,25,401,4,405,1.5,480
74,7,1,24,498,73,571,1.0,480
74,8,1,26,433,24,457,1.0,480
74,8,2,11,618,39,657,1.0,480
74,8,3,14,493,53,546,1.0,480
74,9,1,7,682,68,750,1.0,480
74,9,2,4,544,78,622,0.8,480
74,9,3,14,713,100,813,1.0,480
74,10,1,38,227,27,254,1.5,480
74,10,2,31,238,1,239,1.2,480
74,10,3,5,580,54,634,1.0,480
74,11,1,22,708,78,786,1.2,480
74,11,2,12,447,17,464,1.5,480
74,11,3,3,593,37,630,1.5,480
74,12,2,16,296,10,306,1.2,480
74,13,2,9,402,5,407,1.0,480
74,13,3,21,599,33,632,1.5,480
74,14,1,12,661,62,723,1.5,480
74,14,2,6,235,9,244,1.5,480
74,14,3,17,279,18,297,1.2,480
74,15,1,40,332,25,357,1.5,480
74,15,2,13,768,36,804,1.0,480
75,1,1,25,702,23,725,1.5,480
75,1,2,10,564,1,565,1.2,480
75,1,3,22,591,47,638,1.2,480
75,2,1,8,509,43,552,1.0,480
75,2,2,21,356,17,373,1.5,480
75,2,3,37,627,35,662,1.2,480
75,3,1,18,227,17,244,1.2,480
75,3,2,35,345,23,368,0.8,480
75,4,1,32,440,14,454,0.8,480
75,4,2,31,503,5,508,1.2,480
75,4,3,37,312,35,347,1.2,480
75,5,1,17,713,67,780,1.2,480
75,5,2,25,665,68,733,1.5,480
75,5,3,28,343,23,366,1.5,480
75,6,1,5,251,20,271,1.0,480
75,6,2,29,210,13,223,0.8,480
75,6,3,6,485,39,524,1.5,480
75,7,1,4,448,34,482,0.8,480
75,7,2,11,624,20,644,1.0,480
75,7,3,8,421,33,454,1.0,480
75,8,1,19,397,56,453,1.5,480
75,8,2,26,273,2,275,1.0,480
75,8,3,27,372,15,387,0.8,480
75,9,1,25,364,11,375,1.5,480
75,9,2,27,495,47,542,0.8,480
75,9,3,36,548,48,596,0.8,480
75,10,1,40,266,36,302,1.5,480
75,10,2,23,295,13,308,1.2,480
75,10,3,15,720,14,734,1.2,480
75,11,1,3,393,52,445,1.5,480
75,11,2,37,343,16,359,1.2,480
75,11,3,17,523,55,578,1.2,480
75,12,1,39,546,60,606,1.0,480
75,12,2,5,249,9,258,1.0,480
75,12,3,24,476,42,518,1.0,480
75,13,1,8,360,49,409,1.0,480
75,13,2,14,692,16,708,1.0,480
75,13,3,5,507,53,560,1.0,480
75,14,1,37,606,46,652,1.2,480
75,14,2,7,466,46,512,1.0,480
75,14,3,2,474,50,524,0.8,480
75,15,1,40,711,32,743,1.5,480
75,15,2,32,612,4,616,0.8,480
76,1,1,13,555,25,580,1.0,480
76,1,2,25,633,28,661,1.5,480
76,2,1,34,776,29,805,1.0,480
76,2,2,9,266,23,289,1.0,480
76,2,3,1,575,38,613,1.5,480
76,3,1,16,554,15,569,1.2,480
76,3,2,7,604,35,639,1.0,480
76,3,3,36,633,92,725,0.8,480
76,4,2,35,368,35,403,0.8,480
76,4,3,22,512,43,555,1.2,480
76,5,1,30,521,65,586,1.5,480
76,5,2,31,625,81,706,1.2,480
76,5,3,1,493,59,552,1.5,480
76,6,1,9,467,33,500,1.0,480
76,6,2,28,248,29,277,1.5,480
76,6,3,33,512,71,583,0.8,480
76,7,1,3,413,31,444,1.5,480
76,7,3,3,660,76,736,1.5,480
76,8,1,14,473,24,497,1.0,480
76,8,2,4,428,1,429,0.8,480
76,8,3,1,624,31,655,1.5,480
76,9,1,6,656,17,673,1.5,480
76,9,2,27,313,9,322,0.8,480
76,9,3,7,650,94,744,1.0,480
76,10,1,25,441,21,462,1.5,480
76,10,2,32,448,12,460,0.8,480
76,11,1,6,675,41,716,1.5,480
76,11,2,39,503,64,567,1.0,480
76,11,3,12,225,21,246,1.5,480
76,12,1,18,645,36,681,1.2,480
76,12,2,3,436,10,446,1.5,480
76,12,3,1,792,34,826,1.5,480
76,13,1,6,617,0,617,1.5,480
76,13,2,31,247,33,280,1.2,480
76,13,3,3,388,54,442,1.5,480
76,14,1,2,437,36,473,0.8,480
76,14,2,25,506,26,532,1.5,480
76,14,3,38,244,11,255,1.5,480
76,15,1,30,436,54,490,1.5,480
76,15,2,1,396,56,452,1.5,480
76,15,3,4,670,46,716,0.8,480
77,1,1,2,261,10,271,0.8,480
77,1,2,23,254,15,269,1.2,480
77,1,3,17,609,47,656,1.2,480
77,2,1,30,683,77,760,1.5,480
77,2,2,35,740,39,779,0.8,480
77,2,3,2,242,3,245,0.8,480
77,3,1,16,557,80,637,1.2,480
77,3,2,33,387,23,410,0.8,480
77,3,3,24,686,93,779,1.0,480
77,4,1,35,619,62,681,0.8,480
77,4,2,8,310,32,342,1.0,480
77,4,3,21,239,18,257,1.5,480
77,5,1,19,508,35,543,1.5,480
77,5,3,28,729,39,768,1.5,480
77,6,1,2,287,21,308,0.8,480
77,6,2,5,741,70,811,1.0,480
77,6,3,4,711,32,743,0.8,480
77,7,2,14,320,5,325,1.0,480
77,7,3,6,514,13,527,1.5,480
77,8,3,20,440,30,470,1.5,480
77,9,1,20,253,29,282,1.5,480
77,9,2,36,308,2,310,0.8,480
77,9,3,24,454,63,517,1.0,480
77,10,1,14,784,17,801,1.0,480
77,10,2,9,277,17,294,1.0,480
77,10,3,40,787,73,860,1.5,480
77,12,1,20,424,29,453,1.5,480
77,12,2,22,430,61,491,1.2,480
77,12,3,15,262,32,294,1.2,480
77,13,1,36,278,28,306,0.8,480
77,13,2,5,556,62,618,1.0,480
77,13,3,31,514,10,524,1.2,480
77,14,2,17,268,18,286,1.2,480
77,14,3,10,757,12,769,1.2,480
77,15,2,35,771,108,879,0.8,480
77,15,3,4,397,1,398,0.8,480
78,1,2,33,412,45,457,0.8,480
78,1,3,1,727,57,784,1.5,480
78,2,1,32,517,16,533,0.8,480
78,2,2,24,479,2,481,1.0,480
78,2,3,3,578,79,657,1.5,480
78,3,2,9,609,13,622,1.0,480
78,4,1,6,646,9,655,1.5,480
78,4,2,40,203,1,204,1.5,480
78,4,3,27,781,84,865,0.8,480
78,5,2,5,482,18,500,1.0,480
78,5,3,40,575,76,651,1.5,480
78,6,1,14,205,10,215,1.0,480
78,6,2,12,658,4,662,1.5,480
78,7,2,2,686,75,761,0.8,480
78,7,3,24,427,29,456,1.0,480
78,8,1,7,621,16,637,1.0,480
78,8,2,19,445,17,462,1.5,480
78,8,3,26,429,51,480,1.0,480
78,9,1,31,510,60,570,1.2,480
78,9,2,37,417,0,417,1.2,480
78,9,3,15,602,16,618,1.2,480
78,10,1,33,514,12,526,0.8,480
78,10,2,27,203,20,223,0.8,480
78,10,3,36,214,0,214,0.8,480
78,11,2,39,237,23,260,1.0,480
78,11,3,17,475,46,521,1.2,480
78,12,1,24,725,23,748,1.0,480
78,12,2,5,776,5,781,1.0,480
78,12,3,34,288,35,323,1.0,480
78,13,1,13,308,4,312,1.0,480
78,13,2,33,585,29,614,0.8,480
78,13,3,27,554,56,610,0.8,480
78,14,1,25,317,4,321,1.5,480
78,14,2,17,390,28,418,1.2,480
78,14,3,11,574,15,589,1.0,480
78,15,2,34,673,98,771,1.0,480
78,15,3,14,433,16,449,1.0,480
79,1,1,33,449,15,464,0.8,480
79,1,2,32,278,34,312,0.8,480
79,1,3,37,373,33,406,1.2,480
79,2,2,2,306,24,330,0.8,480
79,2,3,35,322,7,329,0.8,480
79,3,2,40,695,14,709,1.5,480
79,3,3,5,508,11,519,1.0,480
79,4,1,25,714,102,816,1.5,480
79,4,2,40,387,22,409,1.5,480
79,4,3,30,244,35,279,1.5,480
79,5,1,15,206,26,232,1.2,480
79,5,2,37,327,40,367,1.2,480
79,5,3,6,646,70,716,1.5,480
79,6,2,30,472,45,517,1.5,480
79,6,3,40,496,17,513,1.5,480
79,7,1,12,754,52,806,1.5,480
79,7,2,6,373,8,381,1.5,480
79,7,3,13,266,7,273,1.0,480
79,8,1,19,255,36,291,1.5,480
79,8,2,10,644,67,711,1.2,480
79,8,3,15,259,25,284,1.2,480
79,9,1,33,552,65,617,0.8,480
79,9,2,26,407,34,441,1.0,480
79,9,3,23,267,39,306,1.2,480
79,10,1,4,747,91,838,0.8,480
79,10,2,27,654,20,674,0.8,480
79,11,1,1,448,38,486,1.5,480
79,11,2,8,459,58,517,1.0,480
79,12,1,35,634,74,708,0.8,480
79,12,2,28,244,17,261,1.5,480
79,12,3,3,407,1,408,1.5,480
79,13,1,30,250,18,268,1.5,480
79,13,2,3,785,102,887,1.5,480
79,13,3,4,472,46,518,0.8,480
79,14,1,32,785,43,828,0.8,480
79,14,2,2,690,34,724,0.8,480
79,14,3,29,554,6,560,0.8,480
79,15,2,29,420,35,455,0.8,480
79,15,3,32,613,31,644,0.8,480
80,1,1,22,574,0,574,1.2,480
80,1,2,22,467,0,467,1.2,480
80,1,3,14,239,22,261,1.0,480
80,2,1,2,710,1,711,0.8,480
80,2,2,15,345,22,367,1.2,480
80,3,1,36,778,101,879,0.8,480
80,3,3,1,517,69,586,1.5,480
80,4,1,1,713,20,733,1.5,480
80,4,2,26,550,32,582,1.0,480
80,4,3,27,294,14,308,0.8,480
80,5,1,6,712,36,748,1.5,480
80,5,2,20,301,37,338,1.5,480
80,5,3,7,588,39,627,1.0,480
80,6,2,20,644,62,706,1.5,480
80,6,3,5,214,27,241,1.0,480
80,7,2,26,564,21,585,1.0,480
80,7,3,39,433,50,483,1.0,480
80,8,1,3,635,58,693,1.5,480
80,8,2,15,281,5,286,1.2,480
80,8,3,28,387,26,413,1.5,480
80,9,1,38,418,50,468,1.5,480
80,9,2,6,376,10,386,1.5,480
80,9,3,11,503,27,530,1.0,480
80,10,1,32,331,27,358,0.8,480
80,10,2,39,517,47,564,1.0,480
80,10,3,28,399,12,411,1.5,480
80,11,1,38,648,18,666,1.5,480
80,11,2,26,357,1,358,1.0,480
80,11,3,3,498,42,540,1.5,480
80,12,1,23,769,24,793,1.2,480
80,12,2,30,238,33,271,1.5,480
80,12,3,10,305,9,314,1.2,480
80,13,2,32,370,27,397,0.8,480
80,13,3,29,742,39,781,0.8,480
80,14,1,4,740,22,762,0.8,480
80,14,2,9,615,80,695,1.0,480
80,14,3,31,518,37,555,1.2,480
80,15,1,20,275,15,290,1.5,480
80,15,2,7,423,58,481,1.0,480
80,15,3,37,352,15,367,1.2,480
81,1,1,20,383,12,395,1.5,480
81,1,2,8,616,25,641,1.0,480
81,2,2,25,270,18,288,1.5,480
81,2,3,9,349,25,374,1.0,480
81,3,1,35,584,86,670,0.8,480
81,3,2,27,677,19,696,0.8,480
81,3,3,21,574,44,618,1.5,480
81,4,1,30,625,42,667,1.5,480
81,4,3,26,536,74,610,1.0,480
81,5,1,21,624,88,712,1.5,480
81,5,2,27,773,60,833,0.8,480
81,6,1,34,749,105,854,1.0,480
81,6,2,1,700,72,772,1.5,480
81,6,3,36,248,9,257,0.8,480
81,7,1,32,695,39,734,0.8,480
81,7,2,27,703,62,765,0.8,480
81,7,3,32,623,76,699,0.8,480
81,8,1,22,574,39,613,1.2,480
81,8,2,19,557,34,591,1.5,480
81,8,3,1,798,73,871,1.5,480
81,9,1,19,794,74,868,1.5,480
81,9,2,31,444,63,507,1.2,480
81,9,3,26,799,88,887,1.0,480
81,10,1,3,591,84,675,1.5,480
81,10,3,17,789,95,884,1.2,480
81,11,1,28,327,43,370,1.5,480
81,11,2,4,738,6,744,0.8,480
81,12,1,38,454,2,456,1.5,480
81,12,2,27,448,42,490,0.8,480
81,13,1,2,762,57,819,0.8,480
81,13,2,13,267,37,304,1.0,480
81,13,3,5,430,12,442,1.0,480
81,14,1,40,347,34,381,1.5,480
81,14,2,5,732,43,775,1.0,480
81,14,3,1,255,18,273,1.5,480
81,15,1,34,587,62,649,1.0,480
81,15,3,34,354,26,380,1.0,480
82,1,2,34,622,58,680,1.0,480
82,2,1,12,376,50,426,1.5,480
82,2,2,14,563,56,619,1.0,480
82,2,3,17,633,38,671,1.2,480
82,3,1,20,549,15,564,1.5,480
82,3,2,24,200,15,215,1.0,480
82,3,3,31,746,86,832,1.2,480
82,4,1,36,441,33,474,0.8,480
82,4,2,19,540,12,552,1.5,480
82,5,1,6,673,0,673,1.5,480
82,5,2,17,769,60,829,1.2,480
82,5,3,13,708,103,811,1.0,480
82,6,1,39,416,60,476,1.0,480
82,6,2,7,548,30,578,1.0,480
82,7,1,25,754,19,773,1.5,480
82,7,3,40,683,39,722,1.5,480
82,8,1,37,607,89,696,1.2,480
82,8,2,34,427,20,447,1.0,480
82,8,3,11,425,3,428,1.0,480
82,9,1,32,371,46,417,0.8,480
82,9,2,38,287,18,305,1.5,480
82,9,3,11,591,45,636,1.0,480
82,10,3,20,265,20,285,1.5,480
82,11,2,40,503,49,552,1.5,480
82,11,3,20,596,16,612,1.5,480
82,12,1,30,702,32,734,1.5,480
82,12,2,39,589,23,612,1.0,480
82,12,3,4,548,14,562,0.8,480
82,13,1,18,484,57,541,1.2,480
82,13,2,9,290,8,298,1.0,480
82,13,3,8,266,20,286,1.0,480
82,14,1,31,734,17,751,1.2,480
82,14,2,23,429,0,429,1.2,480
82,14,3,19,589,1,590,1.5,480
82,15,1,1,619,76,695,1.5,480
82,15,2,4,547,30,577,0.8,480
82,15,3,40,661,34,695,1.5,480
83,2,2,10,668,2,670,1.2,480
83,2,3,13,452,58,510,1.0,480
83,3,1,17,576,67,643,1.2,480
83,3,2,24,758,76,834,1.0,480
83,4,1,28,290,1,291,1.5,480
83,4,2,31,729,100,829,1.2,480
83,4,3,16,236,4,240,1.2,480
83,5,1,31,718,48,766,1.2,480
83,6,1,14,697,96,793,1.0,480
83,6,2,26,316,33,349,1.0,480
83,6,3,10,373,51,424,1.2,480
83,7,1,36,578,41,619,0.8,480
83,7,2,12,760,49,809,1.5,480
83,7,3,9,320,26,346,1.0,480
83,8,1,12,693,33,726,1.5,480
83,8,2,5,778,77,855,1.0,480
83,8,3,1,260,28,288,1.5,480
83,9,1,23,296,18,314,1.2,480
83,9,2,35,566,76,642,0.8,480
83,9,3,18,790,81,871,1.2,480
83,10,1,21,726,65,791,1.5,480
83,10,2,3,242,6,248,1.5,480
83,11,2,33,305,26,331,0.8,480
83,11,3,31,778,6,784,1.2,480
83,12,1,30,415,43,458,1.5,480
83,12,2,37,405,23,428,1.2,480
83,13,1,5,292,11,303,1.0,480
83,13,2,1,224,5,229,1.5,480
83,14,1,13,796,69,865,1.0,480
83,14,2,7,456,17,473,1.0,480
83,14,3,5,412,23,435,1.0,480
83,15,1,8,389,57,446,1.0,480
83,15,2,32,504,68,572,0.8,480
83,15,3,20,286,3,289,1.5,480
84,1,2,15,782,96,878,1.2,480
84,1,3,17,355,4,359,1.2,480
84,2,1,8,231,15,246,1.0,480
84,2,2,14,376,4,380,1.0,480
84,2,3,39,769,90,859,1.0,480
84,3,1,40,798,56,854,1.5,480
84,3,3,4,375,16,391,0.8,480
84,4,1,25,331,23,354,1.5,480
84,5,1,16,723,60,783,1.2,480
84,5,2,35,262,2,264,0.8,480
84,5,3,25,755,101,856,1.5,480
84,6,2,2,580,64,644,0.8,480
84,6,3,33,365,30,395,0.8,480
84,7,1,31,542,74,616,1.2,480
84,7,2,17,325,42,367,1.2,480
84,7,3,34,464,64,528,1.0,480
84,8,2,18,498,32,530,1.2,480
84,8,3,19,435,35,470,1.5,480
84,9,1,35,235,3,238,0.8,480
84,9,2,9,287,28,315,1.0,480
84,9,3,18,694,35,729,1.2,480
84,10,1,14,738,89,827,1.0,480
84,10,2,31,730,97,827,1.2,480
84,11,1,9,738,16,754,1.0,480
84,11,2,7,604,71,675,1.0,480
84,11,3,31,778,6,784,1.2,480
84,12,1,38,761,72,833,1.5,480
84,12,3,12,522,38,560,1.5,480
84,13,1,24,291,25,316,1.0,480
84,13,2,19,773,1,774,1.5,480
84,13,3,4,573,0,573,0.8,480
84,14,1,10,321,44,365,1.2,480
84,14,2,37,632,56,688,1.2,480
84,14,3,32,792,39,831,0.8,480
84,15,1,8,792,43,835,1.0,480
84,15,2,6,244,4,248,1.5,480
84,15,3,16,542,1,543,1.2,480
85,1,2,33,206,12,218,0.8,480
85,1,3,25,232,23,255,1.5,480
85,2,1,18,284,23,307,1.2,480
85,2,2,26,669,87,756,1.0,480
85,2,3,18,333,44,377,1.2,480
85,3,1,8,226,7,233,1.0,480
85,3,2,8,423,23,446,1.0,480
85,3,3,39,257,35,292,1.0,480
85,4,1,6,489,41,530,1.5,480
85,4,2,39,484,68,552,1.0,480
85,4,3,4,390,32,422,0.8,480
85,5,1,28,794,4,798,1.5,480
85,5,2,36,767,35,802,0.8,480
85,5,3,29,419,11,430,0.8,480
85,6,2,6,284,38,322,1.5,480
85,6,3,15,648,5,653,1.2,480
85,7,1,15,722,8,730,1.2,480
85,7,2,8,620,80,700,1.0,480
85,7,3,8,505,20,525,1.0,480
85,8,1,10,690,32,722,1.2,480
85,8,2,30,295,10,305,1.5,480
85,9,1,2,489,40,529,0.8,480
85,9,2,11,396,41,437,1.0,480
85,9,3,38,316,9,325,1.5,480
85,10,1,39,739,41,780,1.0,480
85,10,3,9,713,98,811,1.0,480
85,11,1,16,713,18,731,1.2,480
85,11,2,40,613,12,625,1.5,480
85,12,1,25,326,14,340,1.5,480
85,12,2,39,276,5,281,1.0,480
85,12,3,40,555,58,613,1.5,480
85,13,1,17,404,29,433,1.2,480
85,13,3,13,583,59,642,1.0,480
85,14,1,7,692,35,727,1.0,480
85,14,2,23,207,17,224,1.2,480
85,14,3,24,291,29,320,1.0,480
85,15,1,35,790,49,839,0.8,480
85,15,2,1,258,24,282,1.5,480
85,15,3,5,356,14,370,1.0,480
86,1,1,21,630,81,711,1.5,480
86,1,2,24,594,59,653,1.0,480
86,2,1,1,313,41,354,1.5,480
86,2,2,13,497,36,533,1.0,480
86,2,3,30,410,51,461,1.5,480
86,3,1,14,672,60,732,1.0,480
86,3,2,7,298,24,322,1.0,480
86,3,3,17,279,26,305,1.2,480
86,4,1,35,237,9,246,0.8,480
86,4,2,2,610,19,629,0.8,480
86,4,3,6,766,74,840,1.5,480
86,5,2,1,767,51,818,1.5,480
86,5,3,12,418,23,441,1.5,480
86,6,1,16,361,41,402,1.2,480
86,6,2,32,479,29,508,0.8,480
86,6,3,10,797,80,877,1.2,480
86,7,1,14,602,29,631,1.0,480
86,7,2,5,432,46,478,1.0,480
86,7,3,1,383,19,402,1.5,480
86,8,1,30,375,28,403,1.5,480
86,8,2,1,430,35,465,1.5,480
86,8,3,36,541,40,581,0.8,480
86,9,1,16,256,18,274,1.2,480
86,9,3,40,291,19,310,1.5,480
86,10,1,4,596,50,646,0.8,480
86,10,2,22,636,49,685,1.2,480
86,10,3,27,673,38,711,0.8,480
86,11,1,32,267,9,276,0.8,480
86,11,2,24,511,3,514,1.0,480
86,11,3,5,271,14,285,1.0,480
86,12,1,32,449,4,453,0.8,480
86,12,2,32,344,1,345,0.8,480
86,12,3,9,433,25,458,1.0,480
86,14,1,34,742,58,800,1.0,480
86,14,2,3,458,24,482,1.5,480
86,15,1,3,545,66,611,1.5,480
86,15,2,3,255,21,276,1.5,480
86,15,3,4,616,45,661,0.8,480
87,1,1,21,400,32,432,1.5,480
87,1,2,6,220,27,247,1.5,480
87,1,3,29,692,93,785,0.8,480
87,2,2,27,585,58,643,0.8,480
87,2,3,25,225,23,248,1.5,480
87,3,1,21,454,46,500,1.5,480
87,3,2,25,354,14,368,1.5,480
87,4,1,24,561,64,625,1.0,480
87,5,1,8,388,51,439,1.0,480
87,5,2,20,592,73,665,1.5,480
87,6,1,30,406,43,449,1.5,480
87,6,2,17,476,21,497,1.2,480
87,6,3,14,696,66,762,1.0,480
87,7,2,18,239,6,245,1.2,480
87,7,3,7,372,39,411,1.0,480
87,8,1,3,785,113,898,1.5,480
87,8,3,9,648,73,721,1.0,480
87,9,1,34,730,58,788,1.0,480
87,10,1,10,219,21,240,1.2,480
87,10,2,8,494,6,500,1.0,480
87,10,3,24,626,3,629,1.0,480
87,11,2,16,419,42,461,1.2,480
87,11,3,22,573,81,654,1.2,480
87,12,1,16,634,56,690,1.2,480
87,12,2,33,644,55,699,0.8,480
87,13,1,16,753,90,843,1.2,480
87,13,2,7,724,30,754,1.0,480
87,14,1,18,425,45,470,1.2,480
87,14,2,24,526,73,599,1.0,480
87,14,3,35,246,28,274,0.8,480
87,15,1,22,794,16,810,1.2,480
87,15,2,11,476,15,491,1.0,480
87,15,3,3,653,27,680,1.5,480
88,1,1,7,465,19,484,1.0,480
88,1,2,2,486,16,502,0.8,480
88,1,3,11,762,33,795,1.0,480
88,2,1,31,739,90,829,1.2,480
88,2,2,8,706,55,761,1.0,480
88,2,3,30,631,46,677,1.5,480
88,3,1,37,220,16,236,1.2,480
88,3,2,22,724,102,826,1.2,480
88,3,3,39,685,17,702,1.0,480
88,4,1,2,201,24,225,0.8,480
88,4,2,14,351,32,383,1.0,480
88,4,3,20,684,44,728,1.5,480
88,5,1,20,601,43,644,1.5,480
88,5,2,36,422,55,477,0.8,480
88,5,3,16,612,15,627,1.2,480
88,6,1,14,482,25,507,1.0,480
88,6,2,19,299,42,341,1.5,480
88,6,3,40,380,54,434,1.5,480
88,7,1,36,739,44,783,0.8,480
88,7,3,18,265,10,275,1.2,480
88,8,1,26,243,29,272,1.0,480
88,8,2,5,322,17,339,1.0,480
88,9,1,15,760,75,835,1.2,480
88,9,2,8,452,22,474,1.0,480
88,9,3,39,449,14,463,1.0,480
88,10,1,33,607,22,629,0.8,480
88,10,2,8,665,45,710,1.0,480
88,10,3,5,623,80,703,1.0,480
88,11,1,12,269,31,300,1.5,480
88,11,3,11,613,78,691,1.0,480
88,12,1,25,298,25,323,1.5,480
88,12,2,31,203,9,212,1.2,480
88,12,3,37,288,15,303,1.2,480
88,13,1,36,385,53,438,0.8,480
88,13,2,15,543,57,600,1.2,480
88,13,3,35,367,4,371,0.8,480
88,14,1,9,376,22,398,1.0,480
88,14,3,26,657,81,738,1.0,480
88,15,1,31,207,20,227,1.2,480
88,15,2,2,726,23,749,0.8,480
88,15,3,22,392,30,422,1.2,480
89,1,1,27,464,53,517,0.8,480
89,1,2,7,712,38,750,1.0,480
89,1,3,29,225,13,238,0.8,480
89,2,1,8,208,25,233,1.0,480
89,2,2,35,675,87,762,0.8,480
89,2,3,33,235,25,260,0.8,480
89,3,1,34,614,91,705,1.0,480
89,3,2,18,758,49,807,1.2,480
89,3,3,21,658,39,697,1.5,480
89,4,1,16,733,75,808,1.2,480
89,4,3,33,624,42,666,0.8,480
89,5,1,40,759,25,784,1.5,480
89,5,2,15,293,16,309,1.2,480
89,5,3,21,699,47,746,1.5,480
89,6,1,38,792,95,887,1.5,480
89,6,2,32,685,99,784,0.8,480
89,7,2,24,655,11,666,1.0,480
89,8,1,29,284,25,309,0.8,480
89,8,2,37,603,48,651,1.2,480
89,8,3,19,373,28,401,1.5,480
89,9,1,10,265,14,279,1.2,480
89,9,2,23,574,30,604,1.2,480
89,9,3,13,568,79,647,1.0,480
89,10,2,32,668,88,756,0.8,480
89,11,1,4,282,22,304,0.8,480
89,11,2,5,312,36,348,1.0,480
89,11,3,19,391,53,444,1.5,480
89,12,1,20,279,8,287,1.5,480
89,12,2,39,384,43,427,1.0,480
89,12,3,1,617,47,664,1.5,480
89,13,1,18,570,4,574,1.2,480
89,13,2,34,266,22,288,1.0,480
89,14,2,15,541,15,556,1.2,480
89,15,1,30,751,3,754,1.5,480
90,1,1,30,696,32,728,1.5,480
90,1,3,33,399,53,452,0.8,480
90,2,1,23,288,19,307,1.2,480
90,2,2,12,471,47,518,1.5,480
90,3,2,37,531,58,589,1.2,480
90,3,3,14,736,73,809,1.0,480
90,4,1,6,765,13,778,1.5,480
90,4,2,18,235,17,252,1.2,480
90,4,3,29,662,68,730,0.8,480
90,5,1,5,615,73,688,1.0,480
90,5,2,29,730,52,782,0.8,480
90,5,3,27,350,5,355,0.8,480
90,6,1,21,315,44,359,1.5,480
90,6,3,6,206,25,231,1.5,480
90,7,1,16,599,42,641,1.2,480
90,7,2,16,573,57,630,1.2,480
90,7,3,17,284,1,285,1.2,480
90,8,1,24,249,27,276,1.0,480
90,8,2,35,427,22,449,0.8,480
90,8,3,28,731,52,783,1.5,480
90,9,1,7,771,111,882,1.0,480
90,9,3,27,417,51,468,0.8,480
90,10,1,33,628,11,639,0.8,480
90,10,2,20,541,74,615,1.5,480
90,10,3,23,786,103,889,1.2,480
90,11,1,16,395,31,426,1.2,480
90,11,2,34,384,49,433,1.0,480
90,11,3,8,707,97,804,1.0,480
90,12,1,26,694,74,768,1.0,480
90,12,2,20,310,45,355,1.5,480
90,12,3,5,695,13,708,1.0,480
90,13,1,11,706,85,791,1.0,480
90,13,3,39,514,43,557,1.0,480
90,14,1,38,271,4,275,1.5,480
90,14,2,31,442,37,479,1.2,480
90,14,3,29,687,78,765,0.8,480
90,15,1,29,746,60,806,0.8,480
90,15,2,14,691,33,724,1.0,480
90,15,3,38,719,55,774,1.5,480
91,1,1,15,507,9,516,1.2,480
91,2,1,23,641,13,654,1.2,480
91,2,2,6,667,72,739,1.5,480
91,2,3,7,636,56,692,1.0,480
91,3,2,19,441,10,451,1.5,480
91,3,3,3,792,91,883,1.5,480
91,4,1,20,512,58,570,1.5,480
91,4,2,37,706,33,739,1.2,480
91,5,1,3,380,4,384,1.5,480
91,5,2,9,277,20,297,1.0,480
91,5,3,26,277,6,283,1.0,480
91,6,2,31,634,28,662,1.2,480
91,7,2,35,524,67,591,0.8,480
91,7,3,18,657,50,707,1.2,480
91,8,1,5,419,23,442,1.0,480
91,8,3,13,296,13,309,1.0,480
91,9,1,1,430,43,473,1.5,480
91,9,2,38,483,15,498,1.5,480
91,9,3,12,203,18,221,1.5,480
91,10,2,37,605,30,635,1.2,480
91,10,3,2,311,3,314,0.8,480
91,11,1,28,427,0,427,1.5,480
91,11,2,6,596,2,598,1.5,480
91,11,3,29,792,64,856,0.8,480
91,12,1,18,582,71,653,1.2,480
91,12,2,27,672,33,705,0.8,480
91,13,1,24,236,34,270,1.0,480
91,13,2,27,541,51,592,0.8,480
91,13,3,18,498,49,547,1.2,480
91,14,1,23,712,31,743,1.2,480
91,14,2,24,339,34,373,1.0,480
91,14,3,32,426,4,430,0.8,480
91,15,1,11,559,13,572,1.0,480
91,15,2,13,288,13,301,1.0,480
91,15,3,25,722,72,794,1.5,480
92,1,1,37,416,58,474,1.2,480
92,1,2,17,643,27,670,1.2,480
92,1,3,38,370,21,391,1.5,480
92,2,2,16,738,9,747,1.2,480
92,3,1,34,213,2,215,1.0,480
92,3,3,9,294,0,294,1.0,480
92,4,1,15,394,8,402,1.2,480
92,4,2,30,746,33,779,1.5,480
92,4,3,11,312,29,341,1.0,480
92,5,1,26,495,18,513,1.0,480
92,5,2,37,439,34,473,1.2,480
92,5,3,29,663,5,668,0.8,480
92,6,1,9,741,44,785,1.0,480
92,6,3,22,495,16,511,1.2,480
92,7,1,5,764,47,811,1.0,480
92,7,3,4,685,36,721,0.8,480
92,8,1,35,581,27,608,0.8,480
92,8,2,33,653,16,669,0.8,480
92,8,3,23,553,40,593,1.2,480
92,9,1,37,277,18,295,1.2,480
92,9,2,15,539,18,557,1.2,480
92,9,3,1,660,87,747,1.5,480
92,10,1,30,407,56,463,1.5,480
92,10,2,28,572,72,644,1.5,480
92,11,1,17,299,10,309,1.2,480
92,11,2,25,686,6,692,1.5,480
92,11,3,29,567,16,583,0.8,480
92,12,1,35,522,71,593,0.8,480
92,12,2,37,729,26,755,1.2,480
92,12,3,13,507,14,521,1.0,480
92,13,1,40,734,79,813,1.5,480
92,13,2,27,437,50,487,0.8,480
92,13,3,38,600,11,611,1.5,480
92,14,1,9,321,21,342,1.0,480
92,14,2,16,656,81,737,1.2,480
92,14,3,34,591,54,645,1.0,480
92,15,1,6,315,28,343,1.5,480
92,15,2,35,455,8,463,0.8,480
93,1,1,22,308,21,329,1.2,480
93,1,2,6,433,41,474,1.5,480
93,2,1,3,358,49,407,1.5,480
93,2,2,14,596,78,674,1.0,480
93,2,3,25,311,36,347,1.5,480
93,3,1,24,643,37,680,1.0,480
93,3,2,2,255,32,287,0.8,480
93,3,3,25,758,102,860,1.5,480
93,4,1,35,533,22,555,0.8,480
93,4,2,14,225,6,231,1.0,480
93,4,3,29,321,2,323,0.8,480
93,5,1,28,698,73,771,1.5,480
93,5,2,26,668,94,762,1.0,480
93,5,3,2,387,44,431,0.8,480
93,6,1,20,588,34,622,1.5,480
93,6,2,27,246,0,246,0.8,480
93,6,3,25,484,51,535,1.5,480
93,7,1,12,224,18,242,1.5,480
93,7,2,29,665,59,724,0.8,480
93,7,3,10,409,23,432,1.2,480
93,8,1,11,576,55,631,1.0,480
93,8,2,10,389,48,437,1.2,480
93,8,3,19,430,23,453,1.5,480
93,9,1,3,511,17,528,1.5,480
93,9,3,19,479,3,482,1.5,480
93,10,1,37,249,7,256,1.2,480
93,10,2,15,771,69,840,1.2,480
93,10,3,19,766,83,849,1.5,480
93,11,3,8,345,23,368,1.0,480
93,12,1,37,649,20,669,1.2,480
93,12,2,8,734,6,740,1.0,480
93,12,3,34,314,15,329,1.0,480
93,13,1,37,776,25,801,1.2,480
93,13,2,26,306,18,324,1.0,480
93,13,3,4,257,27,284,0.8,480
93,14,1,24,704,45,749,1.0,480
93,14,3,39,696,82,778,1.0,480
93,15,1,39,767,12,779,1.0,480
93,15,2,12,288,26,314,1.5,480
93,15,3,37,560,26,586,1.2,480
94,1,1,30,585,74,659,1.5,480
94,1,2,14,655,1,656,1.0,480
94,1,3,13,584,13,597,1.0,480
94,2,1,14,443,45,488,1.0,480
94,2,2,28,387,47,434,1.5,480
94,2,3,9,370,12,382,1.0,480
94,3,1,30,594,75,669,1.5,480
94,3,2,29,600,49,649,0.8,480
94,4,1,3,454,27,481,1.5,480
94,4,2,27,382,48,430,0.8,480
94,4,3,22,512,60,572,1.2,480
94,5,2,3,634,47,681,1.5,480
94,5,3,8,786,1,787,1.0,480
94,6,1,28,669,44,713,1.5,480
94,6,2,3,367,21,388,1.5,480
94,6,3,22,403,32,435,1.2,480
94,7,1,11,310,8,318,1.0,480
94,7,2,34,745,80,825,1.0,480
94,7,3,30,666,25,691,1.5,480
94,8,2,39,445,14,459,1.0,480
94,8,3,12,637,1,638,1.5,480
94,9,1,2,720,37,757,0.8,480
94,9,3,37,575,1,576,1.2,480
94,10,1,17,362,41,403,1.2,480
94,10,2,24,476,69,545,1.0,480
94,10,3,30,417,52,469,1.5,480
94,11,1,4,375,27,402,0.8,480
94,11,2,7,501,73,574,1.0,480
94,11,3,20,613,20,633,1.5,480
94,12,1,37,466,14,480,1.2,480
94,12,2,5,772,27,799,1.0,480
94,12,3,8,533,49,582,1.0,480
94,13,2,30,775,112,887,1.5,480
94,13,3,28,668,66,734,1.5,480
94,14,1,14,463,47,510,1.0,480
94,14,2,36,722,17,739,0.8,480
94,14,3,2,630,20,650,0.8,480
94,15,1,17,309,18,327,1.2,480
94,15,2,25,253,21,274,1.5,480
94,15,3,18,428,56,484,1.2,480
95,1,1,27,733,99,832,0.8,480
95,1,2,36,721,8,729,0.8,480
95,2,1,1,755,78,833,1.5,480
95,2,2,37,668,87,755,1.2,480
95,2,3,9,459,59,518,1.0,480
95,3,1,21,708,57,765,1.5,480
95,3,2,32,461,6,467,0.8,480
95,3,3,24,707,84,791,1.0,480
95,4,2,8,639,73,712,1.0,480
95,4,3,28,431,4,435,1.5,480
95,5,1,16,493,34,527,1.2,480
95,5,2,22,299,24,323,1.2,480
95,5,3,1,207,5,212,1.5,480
95,6,1,12,351,28,379,1.5,480
95,6,3,6,609,58,667,1.5,480
95,7,1,24,596,8,604,1.0,480
95,7,2,39,322,36,358,1.0,480
95,7,3,22,486,47,533,1.2,480
95,8,1,37,708,53,761,1.2,480
95,8,2,15,402,28,430,1.2,480
95,8,3,19,485,49,534,1.5,480
95,9,1,15,355,3,358,1.2,480
95,9,2,9,760,45,805,1.0,480
95,10,1,10,754,19,773,1.2,480
95,10,2,28,699,33,732,1.5,480
95,10,3,4,321,12,333,0.8,480
95,11,1,19,465,36,501,1.5,480
95,11,2,28,639,61,700,1.5,480
95,11,3,39,709,15,724,1.0,480
95,12,1,4,523,51,574,0.8,480
95,12,2,33,643,83,726,0.8,480
95,12,3,10,590,63,653,1.2,480
95,13,1,25,202,6,208,1.5,480
95,13,2,2,360,4,364,0.8,480
95,13,3,31,619,14,633,1.2,480
95,14,2,30,351,19,370,1.5,480
95,14,3,13,352,12,364,1.0,480
95,15,1,17,781,63,844,1.2,480
95,15,2,9,613,65,678,1.0,480
95,15,3,12,381,52,433,1.5,480
96,1,1,9,264,38,302,1.0,480
96,1,2,8,331,25,356,1.0,480
96,1,3,21,765,39,804,1.5,480
96,2,1,38,345,17,362,1.5,480
96,2,2,18,733,17,750,1.2,480
96,2,3,10,778,68,846,1.2,480
96,3,2,35,235,17,252,0.8,480
96,3,3,20,344,1,345,1.5,480
96,4,1,5,641,41,682,1.0,480
96,4,2,22,259,8,267,1.2,480
96,4,3,23,656,1,657,1.2,480
96,5,1,21,681,70,751,1.5,480
96,5,2,27,479,16,495,0.8,480
96,5,3,12,205,21,226,1.5,480
96,6,1,14,293,3,296,1.0,480
96,6,2,36,465,34,499,0.8,480
96,6,3,3,270,19,289,1.5,480
96,7,2,39,537,5,542,1.0,480
96,7,3,12,650,89,739,1.5,480
96,8,1,7,370,36,406,1.0,480
96,9,1,19,452,35,487,1.5,480
96,9,2,13,290,21,311,1.0,480
96,9,3,39,727,23,750,1.0,480
96,10,1,15,765,91,856,1.2,480
96,10,2,37,723,57,780,1.2,480
96,10,3,1,422,33,455,1.5,480
96,11,1,36,332,41,373,0.8,480
96,11,2,39,607,72,679,1.0,480
96,11,3,27,709,86,795,0.8,480
96,12,1,30,392,46,438,1.5,480
96,12,2,11,418,53,471,1.0,480
96,12,3,37,200,18,218,1.2,480
96,14,2,24,729,56,785,1.0,480
96,14,3,12,585,4,589,1.5,480
96,15,1,15,778,103,881,1.2,480
96,15,2,5,719,6,725,1.0,480
96,15,3,16,516,65,581,1.2,480
97,1,1,10,600,35,635,1.2,480
97,1,2,2,651,74,725,0.8,480
97,2,1,29,723,15,738,0.8,480
97,2,2,8,356,18,374,1.0,480
97,2,3,18,318,26,344,1.2,480
97,3,1,16,796,68,864,1.2,480
97,3,2,26,563,75,638,1.0,480
97,4,1,9,542,8,550,1.0,480
97,4,2,27,540,9,549,0.8,480
97,4,3,18,293,4,297,1.2,480
97,5,1,5,533,7,540,1.0,480
97,5,3,39,392,17,409,1.0,480
97,6,1,15,579,64,643,1.2,480
97,6,2,23,545,58,603,1.2,480
97,6,3,14,667,13,680,1.0,480
97,7,1,12,503,68,571,1.5,480
97,7,2,16,772,114,886,1.2,480
97,8,1,3,436,48,484,1.5,480
97,8,2,14,272,24,296,1.0,480
97,8,3,13,221,18,239,1.0,480
97,9,1,25,216,0,216,1.5,480
97,9,2,40,414,44,458,1.5,480
97,10,2,22,735,12,747,1.2,480
97,10,3,21,447,16,463,1.5,480
97,11,1,33,547,63,610,0.8,480
97,11,2,37,614,87,701,1.2,480
97,11,3,16,211,3,214,1.2,480
97,12,1,38,304,9,313,1.5,480
97,12,2,17,763,66,829,1.2,480
97,12,3,6,476,3,479,1.5,480
97,13,1,4,458,61,519,0.8,480
97,13,2,24,398,2,400,1.0,480
97,13,3,4,466,50,516,0.8,480
97,14,1,38,323,30,353,1.5,480
97,14,2,15,666,49,715,1.2,480
97,15,1,25,558,28,586,1.5,480
97,15,2,25,713,36,749,1.5,480
98,1,1,15,208,29,237,1.2,480
98,1,2,4,670,4,674,0.8,480
98,1,3,18,481,42,523,1.2,480
98,2,1,6,319,35,354,1.5,480
98,2,2,34,747,37,784,1.0,480
98,2,3,13,296,21,317,1.0,480
98,3,1,10,243,0,243,1.2,480
98,3,2,26,456,21,477,1.0,480
98,4,2,36,508,9,517,0.8,480
98,4,3,9,619,66,685,1.0,480
98,5,1,10,305,41,346,1.2,480
98,5,2,7,761,108,869,1.0,480
98,5,3,20,429,34,463,1.5,480
98,6,1,1,270,3,273,1.5,480
98,6,2,4,404,9,413,0.8,480
98,6,3,29,617,37,654,0.8,480
98,7,1,27,586,74,660,0.8,480
98,7,2,33,766,81,847,0.8,480
98,7,3,9,445,36,481,1.0,480
98,8,1,16,742,1,743,1.2,480
98,8,2,4,348,44,392,0.8,480
98,8,3,17,440,39,479,1.2,480
98,9,1,22,287,32,319,1.2,480
98,9,2,38,545,20,565,1.5,480
98,9,3,29,705,4,709,0.8,480
98,10,1,33,248,19,267,0.8,480
98,10,2,33,310,17,327,0.8,480
98,10,3,2,354,1,355,0.8,480
98,11,2,37,218,18,236,1.2,480
98,11,3,40,789,42,831,1.5,480
98,12,1,28,384,2,386,1.5,480
98,12,2,9,595,15,610,1.0,480
98,12,3,28,275,35,310,1.5,480
98,13,1,38,428,4,432,1.5,480
98,13,2,10,369,39,408,1.2,480
98,13,3,27,712,31,743,0.8,480
98,14,1,13,769,90,859,1.0,480
98,14,2,30,791,32,823,1.5,480
98,15,1,23,666,4,670,1.2,480
98,15,2,26,725,106,831,1.0,480
98,15,3,20,681,53,734,1.5,480
99,1,2,26,487,36,523,1.0,480
99,1,3,8,292,16,308,1.0,480
99,2,1,21,628,52,680,1.5,480
99,2,2,34,463,13,476,1.0,480
99,2,3,2,602,28,630,0.8,480
99,3,1,30,434,58,492,1.5,480
99,3,2,6,240,29,269,1.5,480
99,3,3,15,667,11,678,1.2,480
99,4,1,2,506,68,574,0.8,480
99,4,3,25,304,39,343,1.5,480
99,5,1,10,516,75,591,1.2,480
99,5,2,25,235,13,248,1.5,480
99,5,3,25,560,73,633,1.5,480
99,6,1,15,440,35,475,1.2,480
99,6,2,38,646,44,690,1.5,480
99,7,2,20,790,31,821,1.5,480
99,7,3,8,320,32,352,1.0,480
99,8,1,33,348,49,397,0.8,480
99,8,2,36,612,61,673,0.8,480
99,8,3,25,529,74,603,1.5,480
99,9,1,4,338,15,353,0.8,480
99,9,2,33,233,18,251,0.8,480
99,10,1,13,614,90,704,1.0,480
99,10,3,1,795,34,829,1.5,480
99,11,1,32,286,26,312,0.8,480
99,11,2,2,517,29,546,0.8,480
99,11,3,38,690,8,698,1.5,480
99,12,1,4,411,48,459,0.8,480
99,12,2,5,625,49,674,1.0,480
99,12,3,21,205,11,216,1.5,480
99,13,1,17,668,51,719,1.2,480
99,13,3,25,297,37,334,1.5,480
99,14,2,4,287,8,295,0.8,480
99,14,3,40,619,41,660,1.5,480
99,15,1,26,708,95,803,1.0,480
99,15,2,1,433,29,462,1.5,480
99,15,3,25,467,0,467,1.5,480
100,1,1,35,632,23,655,0.8,480
100,1,2,19,525,49,574,1.5,480
100,1,3,31,499,9,508,1.2,480
100,2,1,1,698,34,732,1.5,480
100,2,2,18,244,28,272,1.2,480
100,2,3,37,282,3,285,1.2,480
100,3,2,16,269,30,299,1.2,480
100,3,3,33,649,63,712,0.8,480
100,4,1,7,452,57,509,1.0,480
100,4,2,27,774,107,881,0.8,480
100,4,3,5,373,45,418,1.0,480
100,5,1,21,221,17,238,1.5,480
100,5,2,27,270,39,309,0.8,480
100,6,2,20,691,4,695,1.5,480
100,6,3,30,641,71,712,1.5,480
100,7,1,30,452,54,506,1.5,480
100,7,2,4,728,54,782,0.8,480
100,7,3,16,676,51,727,1.2,480
100,8,1,7,576,26,602,1.0,480
100,8,2,16,419,56,475,1.2,480
100,9,1,28,237,10,247,1.5,480
100,9,2,6,498,59,557,1.5,480
100,9,3,16,634,1,635,1.2,480
100,10,2,16,708,87,795,1.2,480
100,10,3,34,404,37,441,1.0,480
100,11,1,8,228,8,236,1.0,480
100,11,2,18,764,31,795,1.2,480
100,11,3,20,531,29,560,1.5,480
100,12,2,27,209,19,228,0.8,480
100,12,3,13,678,82,760,1.0,480
100,13,1,33,259,26,285,0.8,480
100,13,2,36,395,15,410,0.8,480
100,13,3,32,318,27,345,0.8,480
100,14,1,13,647,61,708,1.0,480
100,14,2,21,565,14,579,1.5,480
100,14,3,11,596,73,669,1.0,480
100,15,1,18,300,3,303,1.2,480
100,15,2,2,264,6,270,0.8,480
100,15,3,30,318,35,353,1.5,480
101,1,1,17,222,24,246,1.2,480
101,1,2,25,529,72,601,1.5,480
101,1,3,17,255,23,278,1.2,480
101,2,1,18,651,10,661,1.2,480
101,2,3,33,208,8,216,0.8,480
101,3,1,30,440,11,451,1.5,480
101,3,2,6,629,70,699,1.5,480
101,3,3,25,525,14,539,1.5,480
101,4,1,1,300,35,335,1.5,480
101,4,2,15,578,6,584,1.2,480
101,4,3,9,312,16,328,1.0,480
101,5,1,4,340,22,362,0.8,480
101,5,2,35,248,8,256,0.8,480
101,5,3,7,200,11,211,1.0,480
101,6,2,15,711,102,813,1.2,480
101,6,3,37,279,26,305,1.2,480
101,7,1,37,417,33,450,1.2,480
101,7,2,31,405,37,442,1.2,480
101,7,3,37,763,3,766,1.2,480
101,8,1,27,422,47,469,0.8,480
101,8,3,29,358,44,402,0.8,480
101,9,1,39,221,29,250,1.0,480
101,9,2,29,791,67,858,0.8,480
101,9,3,18,636,86,722,1.2,480
101,10,1,1,450,31,481,1.5,480
101,10,2,20,254,2,256,1.5,480
101,11,1,35,250,24,274,0.8,480
101,11,2,24,506,62,568,1.0,480
101,11,3,2,210,1,211,0.8,480
101,12,2,27,536,76,612,0.8,480
101,12,3,13,374,35,409,1.0,480
101,13,1,32,730,19,749,0.8,480
101,13,2,19,371,49,420,1.5,480
101,13,3,29,537,58,595,0.8,480
101,14,1,2,648,18,666,0.8,480
101,14,2,37,763,31,794,1.2,480
101,15,2,36,676,2,678,0.8,480
101,15,3,26,775,65,840,1.0,480
102,1,1,19,259,23,282,1.5,480
102,1,2,14,645,13,658,1.0,480
102,1,3,22,341,22,363,1.2,480
102,2,2,32,640,92,732,0.8,480
102,2,3,5,612,2,614,1.0,480
102,3,1,27,605,75,680,0.8,480
102,3,3,3,380,48,428,1.5,480
102,4,1,38,281,15,296,1.5,480
102,4,2,24,436,5,441,1.0,480
102,4,3,18,574,60,634,1.2,480
102,5,1,29,744,42,786,0.8,480
102,5,3,24,292,3,295,1.0,480
102,6,2,3,355,8,363,1.5,480
102,6,3,5,415,19,434,1.0,480
102,7,2,25,349,10,359,1.5,480
102,7,3,34,249,8,257,1.0,480
102,8,1,28,713,60,773,1.5,480
102,8,2,38,277,13,290,1.5,480
102,8,3,18,399,39,438,1.2,480
102,9,1,30,357,32,389,1.5,480
102,9,2,16,290,9,299,1.2,480
102,9,3,32,438,36,474,0.8,480
102,10,1,5,604,83,687,1.0,480
102,10,2,39,412,2,414,1.0,480
102,10,3,23,668,1,669,1.2,480
102,11,1,12,373,11,384,1.5,480
102,11,2,10,419,36,455,1.2,480
102,11,3,22,771,68,839,1.2,480
102,12,1,16,620,26,646,1.2,480
102,12,2,18,505,62,567,1.2,480
102,12,3,17,427,35,462,1.2,480
102,13,2,32,650,11,661,0.8,480
102,14,1,21,222,9,231,1.5,480
102,14,3,30,435,56,491,1.5,480
102,15,1,32,250,3,253,0.8,480
102,15,2,25,608,44,652,1.5,480
102,15,3,11,480,51,531,1.0,480
103,1,2,5,557,16,573,1.0,480
103,1,3,11,407,22,429,1.0,480
103,2,1,17,736,17,753,1.2,480
103,2,2,37,207,18,225,1.2,480
103,2,3,20,639,12,651,1.5,480
103,3,1,30,707,1,708,1.5,480
103,3,3,33,217,16,233,0.8,480
103,4,1,12,550,71,621,1.5,480
103,4,3,26,380,51,431,1.0,480
103,5,3,23,569,1,570,1.2,480
103,6,1,40,573,65,638,1.5,480
103,6,2,7,343,9,352,1.0,480
103,6,3,21,477,12,489,1.5,480
103,7,1,19,544,41,585,1.5,480
103,7,2,6,327,19,346,1.5,480
103,7,3,7,786,106,892,1.0,480
103,8,1,31,573,76,649,1.2,480
103,8,2,6,438,50,488,1.5,480
103,8,3,27,395,19,414,0.8,480
103,9,1,34,742,43,785,1.0,480
103,9,2,19,239,12,251,1.5,480
103,9,3,4,524,27,551,0.8,480
103,10,1,39,693,81,774,1.0,480
103,10,2,1,479,68,547,1.5,480
103,10,3,17,296,5,301,1.2,480
103,11,1,25,268,37,305,1.5,480
103,11,2,6,519,30,549,1.5,480
103,11,3,11,786,116,902,1.0,480
103,12,1,17,208,20,228,1.2,480
103,12,2,19,768,74,842,1.5,480
103,12,3,10,663,74,737,1.2,480
103,13,1,3,574,5,579,1.5,480
103,13,3,38,304,17,321,1.5,480
103,14,2,15,403,16,419,1.2,480
103,14,3,31,292,25,317,1.2,480
103,15,2,1,202,25,227,1.5,480
103,15,3,5,546,0,546,1.0,480
104,1,1,1,361,50,411,1.5,480
104,1,2,14,574,63,637,1.0,480
104,1,3,37,313,32,345,1.2,480
104,2,1,14,562,42,604,1.0,480
104,2,2,7,447,40,487,1.0,480
104,2,3,37,654,64,718,1.2,480
104,3,1,27,793,115,908,0.8,480
104,3,3,16,799,76,875,1.2,480
104,4,1,27,727,20,747,0.8,480
104,4,3,3,264,22,286,1.5,480
104,5,1,18,605,81,686,1.2,480
104,5,2,7,335,37,372,1.0,480
104,5,3,5,673,33,706,1.0,480
104,6,1,26,477,47,524,1.0,480
104,6,2,38,499,15,514,1.5,480
104,6,3,28,394,52,446,1.5,480
104,7,1,17,264,7,271,1.2,480
104,7,3,35,606,81,687,0.8,480
104,8,1,7,224,25,249,1.0,480
104,8,2,18,723,14,737,1.2,480
104,8,3,4,784,88,872,0.8,480
104,9,2,21,701,48,749,1.5,480
104,9,3,15,250,35,285,1.2,480
104,10,1,35,306,25,331,0.8,480
104,10,3,36,369,21,390,0.8,480
104,11,1,35,425,5,430,0.8,480
104,11,2,25,418,12,430,1.5,480
104,11,3,34,226,29,255,1.0,480
104,12,1,26,641,33,674,1.0,480
104,12,3,13,664,86,750,1.0,480
104,13,2,20,529,19,548,1.5,480
104,14,1,25,633,80,713,1.5,480
104,14,2,26,443,47,490,1.0,480
104,14,3,35,556,11,567,0.8,480
104,15,1,25,637,60,697,1.5,480
104,15,2,10,545,28,573,1.2,480
104,15,3,30,357,48,405,1.5,480
105,1,1,7,288,19,307,1.0,480
105,1,2,18,745,16,761,1.2,480
105,1,3,16,571,80,651,1.2,480
105,2,1,27,771,68,839,0.8,480
105,2,2,19,707,34,741,1.5,480
105,3,1,4,758,2,760,0.8,480
105,3,2,14,794,77,871,1.0,480
105,3,3,2,322,5,327,0.8,480
105,4,1,40,329,3,332,1.5,480
105,4,2,10,246,19,265,1.2,480
105,4,3,26,252,7,259,1.0,480
105,5,1,33,280,21,301,0.8,480
105,5,2,27,796,109,905,0.8,480
105,5,3,7,258,4,262,1.0,480
105,6,1,26,742,80,822,1.0,480
105,6,2,7,361,8,369,1.0,480
105,7,1,30,465,49,514,1.5,480
105,7,2,21,798,101,899,1.5,480
105,7,3,16,563,3,566,1.2,480
105,8,1,19,646,1,647,1.5,480
105,8,3,11,612,72,684,1.0,480
105,9,1,9,653,81,734,1.0,480
105,9,2,18,483,14,497,1.2,480
105,9,3,24,271,8,279,1.0,480
105,10,2,35,772,0,772,0.8,480
105,11,1,24,705,40,745,1.0,480
105,11,2,26,224,9,233,1.0,480
105,11,3,38,310,33,343,1.5,480
105,12,2,2,689,62,751,0.8,480
105,12,3,29,714,20,734,0.8,480
105,13,1,31,237,7,244,1.2,480
105,13,2,40,234,26,260,1.5,480
105,13,3,1,306,6,312,1.5,480
105,14,1,7,669,88,757,1.0,480
105,14,2,23,415,48,463,1.2,480
105,14,3,39,236,28,264,1.0,480
105,15,1,8,228,19,247,1.0,480
105,15,2,40,518,34,552,1.5,480
105,15,3,10,588,12,600,1.2,480
106,1,2,18,498,51,549,1.2,480
106,1,3,40,602,52,654,1.5,480
106,2,1,2,621,9,630,0.8,480
106,2,2,40,781,27,808,1.5,480
106,2,3,23,752,47,799,1.2,480
106,3,1,30,350,25,375,1.5,480
106,3,3,20,293,35,328,1.5,480
106,4,2,13,505,45,550,1.0,480
106,4,3,1,294,15,309,1.5,480
106,5,1,1,687,17,704,1.5,480
106,5,2,34,419,51,470,1.0,480
106,6,1,40,671,16,687,1.5,480
106,6,2,5,216,8,224,1.0,480
106,6,3,27,538,74,612,0.8,480
106,7,1,6,710,103,813,1.5,480
106,7,2,16,688,36,724,1.2,480
106,7,3,1,334,6,340,1.5,480
106,8,1,7,227,12,239,1.0,480
106,8,2,32,477,36,513,0.8,480
106,8,3,34,466,36,502,1.0,480
106,9,1,30,224,3,227,1.5,480
106,9,2,24,222,2,224,1.0,480
106,9,3,21,299,19,318,1.5,480
106,10,1,25,222,9,231,1.5,480
106,10,2,15,773,43,816,1.2,480
106,10,3,11,682,25,707,1.0,480
106,11,1,21,378,8,386,1.5,480
106,11,3,34,250,32,282,1.0,480
106,12,1,16,489,47,536,1.2,480
106,12,2,33,742,110,852,0.8,480
106,12,3,28,499,36,535,1.5,480
106,13,2,38,797,54,851,1.5,480
106,13,3,6,476,2,478,1.5,480
106,14,1,38,471,68,539,1.5,480
106,14,2,21,568,61,629,1.5,480
106,14,3,28,447,29,476,1.5,480
106,15,1,19,683,19,702,1.5,480
106,15,2,14,697,92,789,1.0,480
106,15,3,16,770,113,883,1.2,480
107,1,1,18,441,51,492,1.2,480
107,1,2,22,766,55,821,1.2,480
107,2,1,33,566,10,576,0.8,480
107,2,2,39,287,13,300,1.0,480
107,3,1,22,682,43,725,1.2,480
107,3,2,13,425,51,476,1.0,480
107,3,3,8,444,30,474,1.0,480
107,4,2,15,730,101,831,1.2,480
107,4,3,2,638,68,706,0.8,480
107,5,1,38,247,34,281,1.5,480
107,5,2,15,259,36,295,1.2,480
107,5,3,4,253,34,287,0.8,480
107,6,1,31,303,15,318,1.2,480
107,6,2,11,396,35,431,1.0,480
107,7,1,27,432,58,490,0.8,480
107,7,2,37,494,3,497,1.2,480
107,7,3,11,617,18,635,1.0,480
107,8,1,15,462,59,521,1.2,480
107,8,2,20,651,34,685,1.5,480
107,8,3,25,352,41,393,1.5,480
107,9,1,20,387,51,438,1.5,480
107,9,2,14,584,80,664,1.0,480
107,9,3,23,732,26,758,1.2,480
107,10,1,12,483,37,520,1.5,480
107,10,2,6,792,59,851,1.5,480
107,10,3,4,365,25,390,0.8,480
107,11,1,10,277,28,305,1.2,480
107,11,2,14,684,76,760,1.0,480
107,11,3,3,587,73,660,1.5,480
107,12,1,30,794,37,831,1.5,480
107,12,2,37,551,53,604,1.2,480
107,12,3,37,286,29,315,1.2,480
107,13,1,9,646,64,710,1.0,480
107,13,2,38,782,73,855,1.5,480
107,13,3,13,567,31,598,1.0,480
107,14,1,7,550,52,602,1.0,480
107,14,2,32,285,4,289,0.8,480
107,14,3,11,575,20,595,1.0,480
107,15,2,31,747,51,798,1.2,480
107,15,3,35,511,56,567,0.8,480
108,1,1,13,263,23,286,1.0,480
108,1,2,25,245,14,259,1.5,480
108,1,3,29,791,116,907,0.8,480
108,2,1,36,240,19,259,0.8,480
108,2,3,4,531,13,544,0.8,480
108,3,1,15,317,39,356,1.2,480
108,3,2,32,667,92,759,0.8,480
108,3,3,31,442,18,460,1.2,480
108,4,1,37,244,26,270,1.2,480
108,4,2,3,366,22,388,1.5,480
108,4,3,25,459,58,517,1.5,480
108,5,1,26,757,25,782,1.0,480
108,5,2,25,793,59,852,1.5,480
108,5,3,6,410,30,440,1.5,480
108,6,1,36,383,43,426,0.8,480
108,6,2,22,321,40,361,1.2,480
108,6,3,32,649,75,724,0.8,480
108,7,1,4,411,4,415,0.8,480
108,7,3,27,311,45,356,0.8,480
108,8,1,24,319,22,341,1.0,480
108,8,3,1,591,63,654,1.5,480
108,9,1,31,252,16,268,1.2,480
108,9,2,20,484,19,503,1.5,480
108,10,1,5,211,9,220,1.0,480
108,10,3,12,503,60,563,1.5,480
108,11,1,3,728,84,812,1.5,480
108,11,2,27,756,77,833,0.8,480
108,11,3,7,738,102,840,1.0,480
108,12,1,4,705,75,780,0.8,480
108,12,2,35,729,36,765,0.8,480
108,12,3,34,400,21,421,1.0,480
108,13,1,19,398,43,441,1.5,480
108,13,2,13,503,19,522,1.0,480
108,13,3,19,525,74,599,1.5,480
108,14,1,14,504,13,517,1.0,480
108,14,2,13,292,40,332,1.0,480
108,15,1,25,486,24,510,1.5,480
108,15,2,27,280,6,286,0.8,480
108,15,3,4,531,44,575,0.8,480
109,1,1,20,293,31,324,1.5,480
109,1,2,38,599,45,644,1.5,480
109,1,3,9,218,10,228,1.0,480
109,2,1,11,746,75,821,1.0,480
109,2,2,8,596,58,654,1.0,480
109,2,3,3,604,77,681,1.5,480
109,3,1,11,417,44,461,1.0,480
109,3,2,34,494,63,557,1.0,480
109,3,3,12,432,3,435,1.5,480
109,4,1,10,242,29,271,1.2,480
109,4,2,10,348,51,399,1.2,480
109,4,3,20,530,32,562,1.5,480
109,5,1,6,777,82,859,1.5,480
109,5,2,22,463,46,509,1.2,480
109,5,3,24,460,19,479,1.0,480
109,6,1,27,462,9,471,0.8,480
109,6,2,19,326,13,339,1.5,480
109,6,3,33,217,14,231,0.8,480
109,7,1,17,774,72,846,1.2,480
109,7,2,1,425,54,479,1.5,480
109,7,3,30,420,43,463,1.5,480
109,8,1,38,659,1,660,1.5,480
109,8,3,19,522,48,570,1.5,480
109,9,1,11,619,14,633,1.0,480
109,9,2,15,302,33,335,1.2,480
109,9,3,17,279,18,297,1.2,480
109,10,1,19,789,0,789,1.5,480
109,10,2,16,733,16,749,1.2,480
109,10,3,26,337,41,378,1.0,480
109,11,1,39,597,57,654,1.0,480
109,11,2,12,765,110,875,1.5,480
109,11,3,29,672,92,764,0.8,480
109,12,1,13,516,17,533,1.0,480
109,12,2,36,353,37,390,0.8,480
109,12,3,5,602,8,610,1.0,480
109,13,2,8,723,35,758,1.0,480
109,13,3,26,752,84,836,1.0,480
109,14,1,11,562,71,633,1.0,480
109,14,2,17,336,16,352,1.2,480
109,14,3,15,200,21,221,1.2,480
109,15,1,38,313,44,357,1.5,480
109,15,2,32,420,15,435,0.8,480
109,15,3,1,338,22,360,1.5,480
110,1,1,6,469,13,482,1.5,480
110,1,2,35,262,24,286,0.8,480
110,2,1,15,491,65,556,1.2,480
110,2,2,38,671,22,693,1.5,480
110,3,2,4,573,17,590,0.8,480
110,3,3,17,682,38,720,1.2,480
110,4,1,27,739,27,766,0.8,480
110,4,2,3,335,19,354,1.5,480
110,4,3,21,340,10,350,1.5,480
110,5,1,19,730,85,815,1.5,480
110,5,2,3,239,16,255,1.5,480
110,5,3,11,250,13,263,1.0,480
110,6,1,18,522,20,542,1.2,480
110,6,2,11,337,32,369,1.0,480
110,7,1,26,710,42,752,1.0,480
110,7,2,22,384,45,429,1.2,480
110,7,3,6,656,34,690,1.5,480
110,8,1,39,397,27,424,1.0,480
110,8,2,36,289,38,327,0.8,480
110,8,3,35,699,77,776,0.8,480
110,9,1,23,251,32,283,1.2,480
110,9,2,31,266,1,267,1.2,480
110,9,3,23,406,31,437,1.2,480
110,10,1,19,787,92,879,1.5,480
110,10,2,25,746,3,749,1.5,480
110,10,3,33,369,26,395,0.8,480
110,11,1,40,328,24,352,1.5,480
110,11,2,12,572,20,592,1.5,480
110,11,3,31,634,15,649,1.2,480
110,12,1,11,529,54,583,1.0,480
110,12,2,21,715,98,813,1.5,480
110,12,3,10,327,26,353,1.2,480
110,13,1,25,552,64,616,1.5,480
110,13,2,31,204,28,232,1.2,480
110,13,3,20,701,24,725,1.5,480
110,14,1,30,777,54,831,1.5,480
110,14,2,35,615,39,654,0.8,480
110,15,1,17,234,13,247,1.2,480
110,15,2,12,616,17,633,1.5,480
110,15,3,17,332,37,369,1.2,480
111,1,1,22,737,81,818,1.2,480
111,1,2,7,559,65,624,1.0,480
111,1,3,21,582,56,638,1.5,480
111,2,1,2,741,42,783,0.8,480
111,2,2,5,785,62,847,1.0,480
111,2,3,6,744,30,774,1.5,480
111,3,1,13,485,50,535,1.0,480
111,3,2,7,205,9,214,1.0,480
111,3,3,17,455,12,467,1.2,480
111,4,1,12,307,27,334,1.5,480
111,4,2,23,209,14,223,1.2,480
111,4,3,32,318,15,333,0.8,480
111,5,2,24,422,6,428,1.0,480
111,5,3,8,630,60,690,1.0,480
111,6,1,24,306,37,343,1.0,480
111,6,3,4,349,42,391,0.8,480
111,7,1,39,629,32,661,1.0,480
111,7,2,6,765,106,871,1.5,480
111,7,3,28,313,8,321,1.5,480
111,8,2,35,605,45,650,0.8,480
111,8,3,23,388,40,428,1.2,480
111,9,1,28,575,29,604,1.5,480
111,9,2,36,670,52,722,0.8,480
111,9,3,8,311,37,348,1.0,480
111,10,1,14,752,63,815,1.0,480
111,10,2,25,720,94,814,1.5,480
111,10,3,17,550,12,562,1.2,480
111,11,2,27,385,32,417,0.8,480
111,12,1,8,227,17,244,1.0,480
111,12,2,26,762,72,834,1.0,480
111,12,3,28,232,17,249,1.5,480
111,13,2,23,252,24,276,1.2,480
111,13,3,3,677,94,771,1.5,480
111,14,1,14,383,21,404,1.0,480
111,14,2,16,242,15,257,1.2,480
111,14,3,20,520,9,529,1.5,480
111,15,2,5,696,59,755,1.0,480
111,15,3,38,229,32,261,1.5,480
112,1,1,24,414,39,453,1.0,480
112,1,3,4,303,8,311,0.8,480
112,2,1,15,505,62,567,1.2,480
112,2,2,36,529,16,545,0.8,480
112,2,3,8,685,44,729,1.0,480
112,3,1,13,748,20,768,1.0,480
112,3,2,34,641,23,664,1.0,480
112,3,3,30,393,13,406,1.5,480
112,4,1,26,457,41,498,1.0,480
112,4,2,11,755,63,818,1.0,480
112,4,3,23,589,19,608,1.2,480
112,5,1,20,394,20,414,1.5,480
112,5,3,40,547,51,598,1.5,480
112,6,1,9,528,69,597,1.0,480
112,6,2,40,335,36,371,1.5,480
112,6,3,21,796,39,835,1.5,480
112,7,1,17,693,61,754,1.2,480
112,7,2,8,711,83,794,1.0,480
112,7,3,26,538,47,585,1.0,480
112,8,1,34,692,91,783,1.0,480
112,8,2,26,509,6,515,1.0,480
112,8,3,18,587,46,633,1.2,480
112,9,1,16,472,36,508,1.2,480
112,9,2,13,322,12,334,1.0,480
112,9,3,34,746,70,816,1.0,480
112,10,1,1,778,79,857,1.5,480
112,10,2,7,242,29,271,1.0,480
112,10,3,15,587,14,601,1.2,480
112,11,2,17,254,7,261,1.2,480
112,11,3,22,608,69,677,1.2,480
112,12,1,24,723,52,775,1.0,480
112,12,2,39,603,30,633,1.0,480
112,13,1,14,743,5,748,1.0,480
112,13,2,38,397,51,448,1.5,480
112,14,1,11,526,28,554,1.0,480
112,14,2,11,240,2,242,1.0,480
112,14,3,5,604,5,609,1.0,480
112,15,1,39,436,49,485,1.0,480
112,15,2,28,458,7,465,1.5,480
112,15,3,37,726,0,726,1.2,480
113,1,2,5,780,70,850,1.0,480
113,1,3,17,227,15,242,1.2,480
113,2,3,10,484,39,523,1.2,480
113,3,1,11,312,10,322,1.0,480
113,3,2,32,749,7,756,0.8,480
113,3,3,19,207,18,225,1.5,480
113,4,1,4,443,2,445,0.8,480
113,4,2,10,609,85,694,1.2,480
113,4,3,11,786,8,794,1.0,480
113,5,1,11,498,31,529,1.0,480
113,5,2,2,533,70,603,0.8,480
113,5,3,10,679,49,728,1.2,480
113,6,2,23,491,65,556,1.2,480
113,7,2,17,743,92,835,1.2,480
113,7,3,4,281,28,309,0.8,480
113,8,1,30,462,27,489,1.5,480
113,8,2,5,382,40,422,1.0,480
113,8,3,38,756,53,809,1.5,480
113,9,1,11,292,31,323,1.0,480
113,9,3,22,436,0,436,1.2,480
113,10,1,3,421,57,478,1.5,480
113,10,3,6,712,84,796,1.5,480
113,11,1,9,795,108,903,1.0,480
113,11,2,22,582,18,600,1.2,480
113,11,3,30,768,29,797,1.5,480
113,12,1,14,355,35,390,1.0,480
113,12,2,7,619,72,691,1.0,480
113,12,3,8,533,76,609,1.0,480
113,13,1,26,418,40,458,1.0,480
113,13,2,38,255,22,277,1.5,480
113,13,3,21,234,24,258,1.5,480
113,14,2,21,569,76,645,1.5,480
113,14,3,29,431,27,458,0.8,480
113,15,1,24,524,42,566,1.0,480
113,15,2,17,325,29,354,1.2,480
113,15,3,14,415,45,460,1.0,480
114,1,1,36,639,49,688,0.8,480
114,1,2,17,272,36,308,1.2,480
114,1,3,9,439,38,477,1.0,480
114,2,1,9,660,25,685,1.0,480
114,2,2,28,574,20,594,1.5,480
114,2,3,8,715,65,780,1.0,480
114,3,1,18,454,27,481,1.2,480
114,3,2,25,576,61,637,1.5,480
114,4,1,31,677,57,734,1.2,480
114,4,2,5,507,49,556,1.0,480
114,5,1,38,574,57,631,1.5,480
114,5,2,21,264,37,301,1.5,480
114,5,3,15,270,26,296,1.2,480
114,6,1,4,431,59,490,0.8,480
114,6,2,35,531,19,550,0.8,480
114,6,3,28,213,17,230,1.5,480
114,7,1,29,239,14,253,0.8,480
114,7,2,28,398,43,441,1.5,480
114,7,3,9,794,21,815,1.0,480
114,8,1,7,398,40,438,1.0,480
114,8,2,18,242,0,242,1.2,480
114,8,3,16,449,23,472,1.2,480
114,9,1,32,348,18,366,0.8,480
114,9,2,25,658,66,724,1.5,480
114,9,3,6,345,18,363,1.5,480
114,10,1,2,481,11,492,0.8,480
114,10,2,26,311,37,348,1.0,480
114,10,3,7,298,38,336,1.0,480
114,11,1,14,700,46,746,1.0,480
114,11,2,28,514,61,575,1.5,480
114,11,3,14,640,56,696,1.0,480
114,12,1,37,223,0,223,1.2,480
114,12,2,30,665,15,680,1.5,480
114,12,3,2,544,25,569,0.8,480
114,13,1,10,467,44,511,1.2,480
114,13,2,33,756,62,818,0.8,480
114,13,3,31,653,22,675,1.2,480
114,14,1,40,627,84,711,1.5,480
114,14,2,8,224,3,227,1.0,480
114,15,1,31,598,81,679,1.2,480
114,15,2,28,420,11,431,1.5,480
114,15,3,31,445,2,447,1.2,480
115,1,1,37,666,19,685,1.2,480
115,1,2,12,244,18,262,1.5,480
115,1,3,12,298,9,307,1.5,480
115,2,1,24,369,14,383,1.0,480
115,2,2,9,397,56,453,1.0,480
115,2,3,37,352,5,357,1.2,480
115,3,1,10,376,40,416,1.2,480
115,3,2,8,281,34,315,1.0,480
115,3,3,8,475,30,505,1.0,480
115,4,1,6,252,27,279,1.5,480
115,4,2,12,249,29,278,1.5,480
115,4,3,39,684,64,748,1.0,480
115,5,1,13,689,91,780,1.0,480
115,5,2,1,680,91,771,1.5,480
115,5,3,31,617,71,688,1.2,480
115,6,1,36,307,38,345,0.8,480
115,6,3,39,692,98,790,1.0,480
115,7,1,4,506,13,519,0.8,480
115,7,3,31,432,7,439,1.2,480
115,8,1,22,465,68,533,1.2,480
115,8,2,23,249,32,281,1.2,480
115,8,3,23,622,90,712,1.2,480
115,9,1,31,784,65,849,1.2,480
115,9,2,7,262,33,295,1.0,480
115,9,3,7,454,28,482,1.0,480
115,10,1,22,347,46,393,1.2,480
115,10,2,35,237,12,249,0.8,480
115,10,3,28,774,92,866,1.5,480
115,11,2,7,266,10,276,1.0,480
115,11,3,12,278,25,303,1.5,480
115,12,1,25,618,40,658,1.5,480
115,12,2,37,659,75,734,1.2,480
115,12,3,27,558,35,593,0.8,480
115,13,1,11,517,76,593,1.0,480
115,13,2,19,467,48,515,1.5,480
115,13,3,31,605,34,639,1.2,480
115,14,1,8,472,6,478,1.0,480
115,14,3,31,385,23,408,1.2,480
115,15,1,3,228,26,254,1.5,480
115,15,3,4,754,75,829,0.8,480
116,1,1,9,538,10,548,1.0,480
116,1,2,13,344,39,383,1.0,480
116,1,3,31,236,27,263,1.2,480
116,2,1,22,649,90,739,1.2,480
116,2,2,6,562,78,640,1.5,480
116,2,3,40,638,77,715,1.5,480
116,3,1,26,651,60,711,1.0,480
116,3,2,32,674,88,762,0.8,480
116,4,1,27,219,26,245,0.8,480
116,4,2,18,212,21,233,1.2,480
116,5,1,16,514,44,558,1.2,480
116,5,2,9,580,62,642,1.0,480
116,5,3,5,224,28,252,1.0,480
116,6,1,4,236,33,269,0.8,480
116,6,2,40,761,32,793,1.5,480
116,6,3,25,765,14,779,1.5,480
116,7,1,36,722,68,790,0.8,480
116,7,2,8,675,99,774,1.0,480
116,7,3,4,755,35,790,0.8,480
116,8,1,6,286,3,289,1.5,480
116,8,2,39,740,52,792,1.0,480
116,8,3,27,494,64,558,0.8,480
116,9,1,33,526,55,581,0.8,480
116,9,2,11,274,37,311,1.0,480
116,9,3,33,376,35,411,0.8,480
116,10,2,5,398,2,400,1.0,480
116,10,3,25,596,19,615,1.5,480
116,11,2,29,222,3,225,0.8,480
116,11,3,22,501,11,512,1.2,480
116,12,1,5,363,15,378,1.0,480
116,12,2,33,741,58,799,0.8,480
116,12,3,5,767,92,859,1.0,480
116,13,1,11,351,40,391,1.0,480
116,13,2,28,392,51,443,1.5,480
116,13,3,26,396,8,404,1.0,480
116,14,1,5,309,26,335,1.0,480
116,14,2,1,344,50,394,1.5,480
116,14,3,16,762,30,792,1.2,480
116,15,2,16,228,10,238,1.2,480
116,15,3,17,745,61,806,1.2,480
117,1,1,33,651,30,681,0.8,480
117,1,3,2,691,58,749,0.8,480
117,2,2,16,331,34,365,1.2,480
117,2,3,9,448,17,465,1.0,480
117,3,1,4,206,17,223,0.8,480
117,3,2,12,203,15,218,1.5,480
117,3,3,18,638,36,674,1.2,480
117,4,1,31,432,60,492,1.2,480
117,4,2,22,648,8,656,1.2,480
117,4,3,37,507,7,514,1.2,480
117,5,1,32,658,76,734,0.8,480
117,5,2,8,376,0,376,1.0,480
117,5,3,10,327,29,356,1.2,480
117,6,3,26,540,35,575,1.0,480
117,7,1,12,638,26,664,1.5,480
117,7,3,19,445,36,481,1.5,480
117,8,1,9,382,43,425,1.0,480
117,8,2,4,392,49,441,0.8,480
117,9,2,2,638,87,725,0.8,480
117,9,3,18,351,21,372,1.2,480
117,10,1,23,773,104,877,1.2,480
117,10,3,21,468,50,518,1.5,480
117,11,3,17,445,63,508,1.2,480
117,12,1,9,482,17,499,1.0,480
117,12,3,18,258,15,273,1.2,480
117,13,1,31,438,23,461,1.2,480
117,13,2,33,238,4,242,0.8,480
117,13,3,21,620,90,710,1.5,480
117,14,1,7,758,98,856,1.0,480
117,14,2,39,734,72,806,1.0,480
117,14,3,24,661,29,690,1.0,480
117,15,1,30,738,78,816,1.5,480
117,15,2,24,591,49,640,1.0,480
117,15,3,40,741,13,754,1.5,480
118,1,1,7,496,1,497,1.0,480
118,1,2,15,625,16,641,1.2,480
118,2,1,25,203,13,216,1.5,480
118,2,2,11,617,18,635,1.0,480
118,3,1,5,538,43,581,1.0,480
118,3,2,13,439,62,501,1.0,480
118,3,3,35,522,30,552,0.8,480
118,4,1,14,427,20,447,1.0,480
118,4,2,4,407,25,432,0.8,480
118,4,3,39,305,7,312,1.0,480
118,5,1,29,714,69,783,0.8,480
118,5,2,31,588,22,610,1.2,480
118,5,3,36,550,50,600,0.8,480
118,6,1,13,510,50,560,1.0,480
118,6,2,40,223,5,228,1.5,480
118,6,3,6,461,43,504,1.5,480
118,7,1,37,690,24,714,1.2,480
118,7,3,11,526,70,596,1.0,480
118,8,1,7,640,31,671,1.0,480
118,8,2,33,730,105,835,0.8,480
118,8,3,21,400,36,436,1.5,480
118,9,1,6,342,23,365,1.5,480
118,9,2,30,567,77,644,1.5,480
118,9,3,5,278,11,289,1.0,480
118,10,1,39,680,15,695,1.0,480
118,10,2,28,717,84,801,1.5,480
118,10,3,38,696,28,724,1.5,480
118,11,1,18,640,69,709,1.2,480
118,11,2,26,390,43,433,1.0,480
118,12,1,26,561,48,609,1.0,480
118,12,2,17,389,6,395,1.2,480
118,13,1,5,584,1,585,1.0,480
118,13,2,10,743,106,849,1.2,480
118,13,3,23,772,75,847,1.2,480
118,14,1,35,735,61,796,0.8,480
118,14,2,19,662,62,724,1.5,480
118,14,3,28,259,30,289,1.5,480
118,15,1,17,429,13,442,1.2,480
118,15,2,30,263,23,286,1.5,480
118,15,3,8,320,24,344,1.0,480
119,1,1,8,714,106,820,1.0,480
119,1,3,3,670,17,687,1.5,480
119,2,1,5,596,83,679,1.0,480
119,2,2,35,295,9,304,0.8,480
119,2,3,18,661,97,758,1.2,480
119,3,1,36,582,55,637,0.8,480
119,3,2,34,640,88,728,1.0,480
119,3,3,25,709,79,788,1.5,480
119,4,1,17,679,55,734,1.2,480
119,4,2,21,469,31,500,1.5,480
119,4,3,29,790,98,888,0.8,480
119,5,1,21,321,14,335,1.5,480
119,5,2,14,580,36,616,1.0,480
119,5,3,23,439,27,466,1.2,480
119,6,1,40,427,62,489,1.5,480
119,6,2,1,452,54,506,1.5,480
119,6,3,7,373,4,377,1.0,480
119,7,1,10,498,61,559,1.2,480
119,7,2,35,660,93,753,0.8,480
119,7,3,9,335,3,338,1.0,480
119,8,2,37,513,45,558,1.2,480
119,8,3,1,210,11,221,1.5,480
119,9,1,33,395,25,420,0.8,480
119,9,2,7,673,43,716,1.0,480
119,9,3,10,487,6,493,1.2,480
119,10,2,35,786,20,806,0.8,480
119,10,3,2,598,46,644,0.8,480
119,11,1,14,200,8,208,1.0,480
119,11,2,23,329,40,369,1.2,480
119,11,3,36,686,74,760,0.8,480
119,12,2,3,705,91,796,1.5,480
119,13,1,7,446,31,477,1.0,480
119,13,2,21,380,53,433,1.5,480
119,13,3,13,561,15,576,1.0,480
119,14,1,20,649,66,715,1.5,480
119,14,2,40,268,20,288,1.5,480
119,14,3,5,275,39,314,1.0,480
119,15,1,29,598,88,686,0.8,480
119,15,3,16,684,14,698,1.2,480
120,1,1,37,255,2,257,1.2,480
120,1,2,35,668,73,741,0.8,480
120,2,1,21,674,81,755,1.5,480
120,2,2,32,662,2,664,0.8,480
120,2,3,24,590,68,658,1.0,480
120,3,2,13,239,24,263,1.0,480
120,3,3,2,473,32,505,0.8,480
120,4,2,33,567,68,635,0.8,480
120,5,1,32,688,40,728,0.8,480
120,5,2,2,426,62,488,0.8,480
120,5,3,36,647,88,735,0.8,480
120,6,1,5,794,41,835,1.0,480
120,6,2,4,654,48,702,0.8,480
120,6,3,8,407,7,414,1.0,480
120,7,1,20,248,36,284,1.5,480
120,7,2,2,634,66,700,0.8,480
120,7,3,12,592,70,662,1.5,480
120,8,1,27,550,24,574,0.8,480
120,8,2,5,561,18,579,1.0,480
120,8,3,6,534,32,566,1.5,480
120,9,1,28,655,38,693,1.5,480
120,9,2,10,462,33,495,1.2,480
120,9,3,9,609,74,683,1.0,480
120,10,3,6,790,57,847,1.5,480
120,11,1,15,406,12,418,1.2,480
120,11,2,9,719,85,804,1.0,480
120,11,3,3,670,13,683,1.5,480
120,12,1,30,668,88,756,1.5,480
120,12,2,1,679,4,683,1.5,480
120,13,1,39,472,20,492,1.0,480
120,13,2,14,632,86,718,1.0,480
120,13,3,29,620,69,689,0.8,480
120,14,1,30,276,34,310,1.5,480
120,14,3,39,327,26,353,1.0,480
120,15,1,16,771,68,839,1.2,480
120,15,2,15,246,4,250,1.2,480
120,15,3,31,552,36,588,1.2,480
121,1,2,27,482,43,525,0.8,480
121,1,3,13,364,25,389,1.0,480
121,2,1,15,442,8,450,1.2,480
121,2,2,4,300,25,325,0.8,480
121,2,3,2,373,20,393,0.8,480
121,3,1,40,438,24,462,1.5,480
121,3,3,3,745,2,747,1.5,480
121,4,1,28,673,27,700,1.5,480
121,4,3,15,380,23,403,1.2,480
121,5,1,31,768,61,829,1.2,480
121,5,2,37,564,57,621,1.2,480
121,5,3,15,543,5,548,1.2,480
121,6,1,26,634,62,696,1.0,480
121,6,2,23,659,19,678,1.2,480
121,6,3,3,222,31,253,1.5,480
121,7,1,29,764,111,875,0.8,480
121,7,2,38,616,73,689,1.5,480
121,7,3,33,506,64,570,0.8,480
121,8,1,32,375,48,423,0.8,480
121,8,2,31,222,16,238,1.2,480
121,8,3,19,530,33,563,1.5,480
121,9,1,18,212,15,227,1.2,480
121,9,3,25,684,25,709,1.5,480
121,10,1,5,422,18,440,1.0,480
121,10,2,15,500,53,553,1.2,480
121,10,3,6,704,64,768,1.5,480
121,11,1,1,722,37,759,1.5,480
121,11,2,26,494,61,555,1.0,480
121,11,3,8,406,42,448,1.0,480
121,12,2,10,365,1,366,1.2,480
121,12,3,40,214,29,243,1.5,480
121,13,1,14,660,5,665,1.0,480
121,13,2,29,425,30,455,0.8,480
121,13,3,38,418,59,477,1.5,480
121,14,1,6,668,38,706,1.5,480
121,14,3,16,536,45,581,1.2,480
121,15,1,33,676,37,713,0.8,480
121,15,2,26,627,10,637,1.0,480
121,15,3,37,518,41,559,1.2,480
122,1,1,18,380,28,408,1.2,480
122,1,2,17,634,39,673,1.2,480
122,1,3,37,499,15,514,1.2,480
122,2,1,11,476,15,491,1.0,480
122,2,2,17,624,23,647,1.2,480
122,3,1,2,241,28,269,0.8,480
122,3,2,12,242,23,265,1.5,480
122,3,3,32,520,20,540,0.8,480
122,4,1,21,718,92,810,1.5,480
122,4,2,29,420,14,434,0.8,480
122,4,3,21,272,3,275,1.5,480
122,5,1,10,676,73,749,1.2,480
122,5,2,39,468,19,487,1.0,480
122,5,3,16,495,31,526,1.2,480
122,6,1,39,704,81,785,1.0,480
122,6,2,8,390,16,406,1.0,480
122,6,3,22,303,18,321,1.2,480
122,7,1,36,705,71,776,0.8,480
122,7,2,15,480,56,536,1.2,480
122,7,3,22,508,41,549,1.2,480
122,8,1,35,737,3,740,0.8,480
122,8,2,15,703,42,745,1.2,480
122,8,3,22,206,24,230,1.2,480
122,9,2,2,361,38,399,0.8,480
122,9,3,29,317,2,319,0.8,480
122,10,1,27,648,43,691,0.8,480
122,10,2,5,744,95,839,1.0,480
122,10,3,16,244,6,250,1.2,480
122,11,1,37,377,10,387,1.2,480
122,11,2,5,496,4,500,1.0,480
122,11,3,27,533,29,562,0.8,480
122,12,1,35,550,33,583,0.8,480
122,12,3,14,235,28,263,1.0,480
122,13,1,32,780,83,863,0.8,480
122,13,2,31,726,1,727,1.2,480
122,13,3,21,407,15,422,1.5,480
122,14,2,18,701,98,799,1.2,480
122,14,3,28,513,28,541,1.5,480
122,15,1,12,675,33,708,1.5,480
123,1,1,10,682,29,711,1.2,480
123,1,2,38,658,36,694,1.5,480
123,1,3,2,522,63,585,0.8,480
123,2,1,20,734,102,836,1.5,480
123,2,2,40,354,49,403,1.5,480
123,3,1,5,266,4,270,1.0,480
123,3,2,39,621,34,655,1.0,480
123,3,3,6,770,80,850,1.5,480
123,4,1,10,597,39,636,1.2,480
123,4,2,23,692,65,757,1.2,480
123,4,3,4,733,12,745,0.8,480
123,5,1,27,285,7,292,0.8,480
123,5,2,37,769,66,835,1.2,480
123,5,3,34,326,44,370,1.0,480
123,7,1,24,633,65,698,1.0,480
123,7,2,11,533,17,550,1.0,480
123,7,3,28,692,27,719,1.5,480
123,8,1,39,339,37,376,1.0,480
123,8,2,35,572,3,575,0.8,480
123,8,3,23,791,21,812,1.2,480
123,9,1,22,443,59,502,1.2,480
123,9,2,30,571,13,584,1.5,480
123,9,3,19,312,30,342,1.5,480
123,10,1,40,400,21,421,1.5,480
123,10,3,32,794,3,797,0.8,480
123,11,1,23,723,63,786,1.2,480
123,11,2,25,572,82,654,1.5,480
123,12,1,37,421,36,457,1.2,480
123,12,2,22,596,74,670,1.2,480
123,13,1,36,712,64,776,0.8,480
123,13,2,4,202,12,214,0.8,480
123,13,3,22,408,20,428,1.2,480
123,14,1,2,717,72,789,0.8,480
123,14,2,8,513,61,574,1.0,480
123,14,3,16,338,14,352,1.2,480
123,15,1,26,665,41,706,1.0,480
123,15,2,31,222,2,224,1.2,480
123,15,3,28,758,21,779,1.5,480
124,1,1,39,532,38,570,1.0,480
124,1,2,16,370,16,386,1.2,480
124,1,3,4,735,105,840,0.8,480
124,2,1,6,323,3,326,1.5,480
124,2,2,4,560,70,630,0.8,480
124,2,3,14,652,60,712,1.0,480
124,3,1,1,790,75,865,1.5,480
124,3,2,12,478,2,480,1.5,480
124,3,3,20,690,84,774,1.5,480
124,4,1,23,674,39,713,1.2,480
124,4,2,27,276,28,304,0.8,480
124,4,3,39,574,59,633,1.0,480
124,5,1,31,442,60,502,1.2,480
124,5,2,29,389,38,427,0.8,480
124,6,1,22,762,10,772,1.2,480
124,6,2,37,604,31,635,1.2,480
124,6,3,39,737,59,796,1.0,480
124,7,1,5,291,20,311,1.0,480
124,7,2,33,454,36,490,0.8,480
124,7,3,3,557,52,609,1.5,480
124,8,1,31,372,17,389,1.2,480
124,8,2,32,617,53,670,0.8,480
124,9,1,3,321,46,367,1.5,480
124,9,3,30,249,36,285,1.5,480
124,10,1,35,308,41,349,0.8,480
124,10,3,2,574,18,592,0.8,480
124,11,2,18,551,7,558,1.2,480
124,11,3,18,398,40,438,1.2,480
124,12,1,6,600,77,677,1.5,480
124,12,2,21,428,45,473,1.5,480
124,12,3,33,262,13,275,0.8,480
124,13,1,4,609,82,691,0.8,480
124,13,2,10,677,24,701,1.2,480
124,13,3,13,235,18,253,1.0,480
124,14,1,12,573,71,644,1.5,480
124,14,2,35,372,20,392,0.8,480
124,14,3,16,616,87,703,1.2,480
124,15,1,15,673,69,742,1.2,480
124,15,2,5,560,9,569,1.0,480
124,15,3,29,421,23,444,0.8,480
125,1,1,27,443,53,496,0.8,480
125,1,3,31,212,14,226,1.2,480
125,2,1,4,736,44,780,0.8,480
125,2,2,29,707,37,744,0.8,480
125,2,3,29,708,31,739,0.8,480
125,3,1,34,267,29,296,1.0,480
125,3,2,3,549,77,626,1.5,480
125,3,3,22,509,34,543,1.2,480
125,4,3,25,230,19,249,1.5,480
125,5,1,32,461,12,473,0.8,480
125,5,2,32,278,8,286,0.8,480
125,5,3,40,387,21,408,1.5,480
125,6,1,6,337,30,367,1.5,480
125,6,2,8,430,7,437,1.0,480
125,6,3,23,219,0,219,1.2,480
125,7,1,22,673,79,752,1.2,480
125,7,2,19,729,26,755,1.5,480
125,7,3,14,473,48,521,1.0,480
125,8,1,26,676,43,719,1.0,480
125,8,2,12,762,76,838,1.5,480
125,8,3,34,627,35,662,1.0,480
125,9,1,5,651,86,737,1.0,480
125,9,2,12,768,38,806,1.5,480
125,9,3,4,266,35,301,0.8,480
125,10,1,38,379,51,430,1.5,480
125,10,2,39,423,1,424,1.0,480
125,10,3,11,611,23,634,1.0,480
125,11,1,26,607,10,617,1.0,480
125,11,2,31,734,47,781,1.2,480
125,11,3,29,491,21,512,0.8,480
125,12,1,22,649,54,703,1.2,480
125,12,2,34,451,42,493,1.0,480
125,12,3,13,575,66,641,1.0,480
125,13,1,9,463,49,512,1.0,480
125,13,2,5,533,58,591,1.0,480
125,13,3,13,629,3,632,1.0,480
125,14,1,33,500,27,527,0.8,480
125,14,2,29,396,41,437,0.8,480
125,14,3,25,482,51,533,1.5,480
125,15,1,32,230,17,247,0.8,480
125,15,2,26,484,62,546,1.0,480
125,15,3,16,426,45,471,1.2,480
126,1,1,20,291,34,325,1.5,480
126,1,2,6,740,87,827,1.5,480
126,2,1,18,270,15,285,1.2,480
126,2,3,33,265,13,278,0.8,480
126,3,1,9,366,40,406,1.0,480
126,3,2,20,762,55,817,1.5,480
126,4,1,11,493,53,546,1.0,480
126,4,2,14,519,66,585,1.0,480
126,4,3,15,267,33,300,1.2,480
126,5,1,26,694,49,743,1.0,480
126,5,2,17,677,59,736,1.2,480
126,6,1,32,339,10,349,0.8,480
126,6,3,32,446,47,493,0.8,480
126,7,1,37,539,78,617,1.2,480
126,7,2,16,461,29,490,1.2,480
126,7,3,12,737,89,826,1.5,480
126,8,1,37,358,42,400,1.2,480
126,8,2,33,398,8,406,0.8,480
126,8,3,14,536,35,571,1.0,480
126,9,1,24,603,86,689,1.0,480
126,9,2,38,624,24,648,1.5,480
126,9,3,33,269,33,302,0.8,480
126,10,1,6,264,32,296,1.5,480
126,10,2,39,672,22,694,1.0,480
126,10,3,34,410,10,420,1.0,480
126,11,1,2,640,23,663,0.8,480
126,11,3,22,491,12,503,1.2,480
126,12,1,8,443,12,455,1.0,480
126,12,2,5,407,43,450,1.0,480
126,12,3,22,452,23,475,1.2,480
126,13,1,5,725,47,772,1.0,480
126,13,2,11,448,17,465,1.0,480
126,13,3,31,431,38,469,1.2,480
126,14,1,14,451,20,471,1.0,480
126,14,2,19,525,8,533,1.5,480
126,14,3,12,257,19,276,1.5,480
126,15,1,8,559,77,636,1.0,480
126,15,3,29,416,53,469,0.8,480
127,1,1,8,679,6,685,1.0,480
127,1,2,2,624,4,628,0.8,480
127,2,1,25,515,32,547,1.5,480
127,2,2,8,351,2,353,1.0,480
127,3,1,10,508,66,574,1.2,480
127,3,2,35,739,67,806,0.8,480
127,3,3,34,276,2,278,1.0,480
127,4,1,40,404,14,418,1.5,480
127,4,2,14,252,15,267,1.0,480
127,4,3,5,716,84,800,1.0,480
127,5,1,32,339,16,355,0.8,480
127,5,3,8,389,38,427,1.0,480
127,6,1,6,661,69,730,1.5,480
127,6,3,40,232,16,248,1.5,480
127,7,1,36,501,24,525,0.8,480
127,7,2,13,500,70,570,1.0,480
127,7,3,9,491,69,560,1.0,480
127,8,1,22,420,17,437,1.2,480
127,8,2,9,796,92,888,1.0,480
127,9,1,29,672,25,697,0.8,480
127,9,2,33,245,5,250,0.8,480
127,9,3,26,593,55,648,1.0,480
127,10,1,13,377,35,412,1.0,480
127,10,2,14,646,76,722,1.0,480
127,10,3,18,291,10,301,1.2,480
127,11,1,4,771,25,796,0.8,480
127,11,2,9,419,15,434,1.0,480
127,11,3,33,740,5,745,0.8,480
127,12,1,18,620,28,648,1.2,480
127,12,2,1,601,75,676,1.5,480
127,12,3,26,566,63,629,1.0,480
127,13,1,14,477,34,511,1.0,480
127,13,2,12,254,29,283,1.5,480
127,13,3,30,536,29,565,1.5,480
127,14,2,30,580,59,639,1.5,480
127,14,3,7,361,7,368,1.0,480
127,15,1,28,789,78,867,1.5,480
127,15,2,15,608,57,665,1.2,480
127,15,3,33,693,51,744,0.8,480
128,1,2,38,303,5,308,1.5,480
128,1,3,20,646,34,680,1.5,480
128,2,2,2,311,41,352,0.8,480
128,2,3,22,260,24,284,1.2,480
128,3,1,34,419,43,462,1.0,480
128,3,2,28,648,4,652,1.5,480
128,3,3,8,539,62,601,1.0,480
128,4,1,15,419,37,456,1.2,480
128,4,2,30,668,37,705,1.5,480
128,4,3,34,366,13,379,1.0,480
128,5,1,34,298,36,334,1.0,480
128,5,2,1,390,3,393,1.5,480
128,5,3,13,437,64,501,1.0,480
128,6,2,39,237,25,262,1.0,480
128,6,3,22,293,30,323,1.2,480
128,7,1,33,400,2,402,0.8,480
128,7,2,7,362,51,413,1.0,480
128,7,3,23,322,22,344,1.2,480
128,8,1,15,664,69,733,1.2,480
128,8,2,36,679,38,717,0.8,480
128,9,1,40,661,95,756,1.5,480
128,9,2,3,647,89,736,1.5,480
128,9,3,33,229,17,246,0.8,480
128,10,2,6,416,22,438,1.5,480
128,11,1,28,348,13,361,1.5,480
128,11,3,5,312,21,333,1.0,480
128,12,1,13,446,43,489,1.0,480
128,12,3,36,258,24,282,0.8,480
128,13,1,15,503,29,532,1.2,480
128,13,2,32,289,25,314,0.8,480
128,13,3,3,367,37,404,1.5,480
128,14,1,26,564,18,582,1.0,480
128,14,2,12,657,94,751,1.5,480
128,14,3,17,665,25,690,1.2,480
128,15,1,1,225,31,256,1.5,480
128,15,2,3,667,78,745,1.5,480
128,15,3,28,451,44,495,1.5,480
129,1,1,40,405,8,413,1.5,480
129,1,2,4,519,45,564,0.8,480
129,1,3,36,712,56,768,0.8,480
129,2,1,39,795,60,855,1.0,480
129,2,2,19,318,12,330,1.5,480
129,2,3,3,694,19,713,1.5,480
129,3,1,5,418,18,436,1.0,480
129,3,2,20,739,104,843,1.5,480
129,3,3,30,391,18,409,1.5,480
129,4,1,13,466,64,530,1.0,480
129,4,3,14,601,70,671,1.0,480
129,5,1,9,747,62,809,1.0,480
129,5,3,12,300,39,339,1.5,480
129,6,1,5,261,1,262,1.0,480
129,6,3,16,344,27,371,1.2,480
129,7,1,23,461,50,511,1.2,480
129,7,2,12,713,21,734,1.5,480
129,7,3,26,222,21,243,1.0,480
129,8,2,30,482,4,486,1.5,480
129,8,3,40,264,35,299,1.5,480
129,9,1,18,475,40,515,1.2,480
129,9,2,7,725,3,728,1.0,480
129,9,3,29,631,93,724,0.8,480
129,10,1,28,293,9,302,1.5,480
129,10,2,7,614,63,677,1.0,480
129,10,3,9,299,23,322,1.0,480
129,11,1,21,201,17,218,1.5,480
129,11,3,34,606,13,619,1.0,480
129,12,1,26,231,6,237,1.0,480
129,12,2,17,232,10,242,1.2,480
129,12,3,17,221,31,252,1.2,480
129,13,1,16,348,12,360,1.2,480
129,13,2,37,240,18,258,1.2,480
129,14,1,25,435,10,445,1.5,480
129,14,2,30,742,16,758,1.5,480
129,14,3,36,498,35,533,0.8,480
129,15,1,40,446,59,505,1.5,480
129,15,2,10,213,9,222,1.2,480
129,15,3,15,660,47,707,1.2,480
130,1,1,16,417,36,453,1.2,480
130,1,2,14,325,13,338,1.0,480
130,1,3,34,605,57,662,1.0,480
130,2,2,13,219,4,223,1.0,480
130,2,3,1,309,22,331,1.5,480
130,3,1,31,301,25,326,1.2,480
130,3,2,24,420,36,456,1.0,480
130,3,3,35,493,22,515,0.8,480
130,4,1,8,378,5,383,1.0,480
130,4,2,8,759,84,843,1.0,480
130,4,3,34,626,23,649,1.0,480
130,5,1,30,388,10,398,1.5,480
130,5,2,3,214,26,240,1.5,480
130,5,3,20,353,36,389,1.5,480
130,6,1,11,398,22,420,1.0,480
130,6,2,24,710,54,764,1.0,480
130,6,3,21,267,38,305,1.5,480
130,7,1,35,276,8,284,0.8,480
130,7,2,30,229,24,253,1.5,480
130,7,3,6,614,13,627,1.5,480
130,8,1,20,665,25,690,1.5,480
130,8,3,7,631,25,656,1.0,480
130,9,1,4,259,28,287,0.8,480
130,9,2,20,626,55,681,1.5,480
130,10,1,34,745,33,778,1.0,480
130,10,2,9,543,34,577,1.0,480
130,10,3,14,512,59,571,1.0,480
130,11,1,35,371,14,385,0.8,480
130,11,2,32,580,54,634,0.8,480
130,11,3,16,216,12,228,1.2,480
130,12,3,4,584,52,636,0.8,480
130,13,1,35,614,67,681,0.8,480
130,13,2,23,510,3,513,1.2,480
130,13,3,11,615,20,635,1.0,480
130,14,1,18,409,45,454,1.2,480
130,14,2,40,581,12,593,1.5,480
130,14,3,8,659,0,659,1.0,480
130,15,1,25,623,76,699,1.5,480
130,15,2,28,408,45,453,1.5,480
130,15,3,35,525,39,564,0.8,480
131,1,1,38,577,29,606,1.5,480
131,1,2,37,480,44,524,1.2,480
131,1,3,25,446,51,497,1.5,480
131,2,1,12,735,89,824,1.5,480
131,2,2,4,331,28,359,0.8,480
131,2,3,28,535,32,567,1.5,480
131,3,1,9,646,88,734,1.0,480
131,3,2,28,431,0,431,1.5,480
131,3,3,20,780,43,823,1.5,480
131,4,1,23,774,5,779,1.2,480
131,4,2,31,394,27,421,1.2,480
131,4,3,7,675,18,693,1.0,480
131,5,2,33,733,4,737,0.8,480
131,5,3,15,481,54,535,1.2,480
131,6,1,21,284,6,290,1.5,480
131,6,2,34,543,46,589,1.0,480
131,6,3,36,695,84,779,0.8,480
131,7,1,25,424,55,479,1.5,480
131,7,2,40,363,46,409,1.5,480
131,7,3,2,566,10,576,0.8,480
131,8,1,33,516,76,592,0.8,480
131,8,2,10,743,58,801,1.2,480
131,8,3,25,457,63,520,1.5,480
131,9,1,10,227,7,234,1.2,480
131,9,2,24,506,3,509,1.0,480
131,9,3,26,262,28,290,1.0,480
131,10,1,37,749,102,851,1.2,480
131,10,2,6,660,35,695,1.5,480
131,10,3,25,269,15,284,1.5,480
131,11,1,14,597,60,657,1.0,480
131,11,2,38,671,21,692,1.5,480
131,11,3,37,643,61,704,1.2,480
131,12,2,36,511,24,535,0.8,480
131,12,3,27,214,27,241,0.8,480
131,13,1,12,653,60,713,1.5,480
131,13,2,6,218,18,236,1.5,480
131,13,3,10,558,33,591,1.2,480
131,14,2,25,774,52,826,1.5,480
131,15,1,39,555,26,581,1.0,480
131,15,3,21,630,72,702,1.5,480
132,1,1,17,436,48,484,1.2,480
132,1,2,30,588,68,656,1.5,480
132,2,1,22,633,10,643,1.2,480
132,2,2,12,691,96,787,1.5,480
132,2,3,23,740,93,833,1.2,480
132,3,2,27,519,61,580,0.8,480
132,3,3,39,537,52,589,1.0,480
132,4,1,7,300,41,341,1.0,480
132,4,2,9,651,90,741,1.0,480
132,4,3,40,748,7,755,1.5,480
132,5,1,29,458,9,467,0.8,480
132,5,2,33,768,67,835,0.8,480
132,5,3,3,347,3,350,1.5,480
132,6,1,6,253,4,257,1.5,480
132,6,2,4,502,53,555,0.8,480
132,6,3,14,314,12,326,1.0,480
132,7,1,7,374,45,419,1.0,480
132,7,2,7,638,23,661,1.0,480
132,7,3,19,427,10,437,1.5,480
132,8,1,10,317,7,324,1.2,480
132,9,1,7,638,75,713,1.0,480
132,9,2,9,651,88,739,1.0,480
132,9,3,28,644,20,664,1.5,480
132,10,1,33,387,26,413,0.8,480
132,10,2,38,236,31,267,1.5,480
132,10,3,35,765,7,772,0.8,480
132,11,1,38,370,50,420,1.5,480
132,11,2,35,676,2,678,0.8,480
132,12,2,22,747,18,765,1.2,480
132,12,3,4,543,78,621,0.8,480
132,13,2,35,400,43,443,0.8,480
132,13,3,29,220,11,231,0.8,480
132,14,2,27,277,35,312,0.8,480
132,14,3,20,570,26,596,1.5,480
132,15,1,37,744,57,801,1.2,480
132,15,2,9,629,78,707,1.0,480
132,15,3,5,648,44,692,1.0,480
133,1,1,13,699,86,785,1.0,480
133,1,2,13,727,51,778,1.0,480
133,1,3,16,487,58,545,1.2,480
133,2,1,31,521,58,579,1.2,480
133,2,2,2,262,17,279,0.8,480
133,2,3,20,742,23,765,1.5,480
133,3,1,40,229,32,261,1.5,480
133,3,2,22,309,41,350,1.2,480
133,3,3,38,575,40,615,1.5,480
133,4,1,36,576,52,628,0.8,480
133,4,2,35,535,35,570,0.8,480
133,4,3,32,574,68,642,0.8,480
133,5,1,23,679,68,747,1.2,480
133,5,2,13,616,16,632,1.0,480
133,5,3,20,698,21,719,1.5,480
133,6,1,14,383,9,392,1.0,480
133,6,2,36,612,85,697,0.8,480
133,6,3,35,761,79,840,0.8,480
133,7,2,30,425,62,487,1.5,480
133,7,3,27,649,34,683,0.8,480
133,8,1,25,697,10,707,1.5,480
133,8,2,7,206,13,219,1.0,480
133,8,3,23,650,10,660,1.2,480
133,9,1,35,211,1,212,0.8,480
133,9,2,24,609,81,690,1.0,480
133,9,3,32,645,10,655,0.8,480
133,10,1,10,652,55,707,1.2,480
133,10,2,8,440,35,475,1.0,480
133,10,3,5,571,75,646,1.0,480
133,11,1,35,281,10,291,0.8,480
133,11,2,11,575,85,660,1.0,480
133,11,3,7,288,42,330,1.0,480
133,12,1,33,743,8,751,0.8,480
133,12,2,21,222,18,240,1.5,480
133,12,3,19,791,36,827,1.5,480
133,13,1,36,672,7,679,0.8,480
133,13,2,14,474,45,519,1.0,480
133,13,3,31,355,29,384,1.2,480
133,14,1,38,712,42,754,1.5,480
133,14,2,13,685,16,701,1.0,480
133,15,1,27,361,44,405,0.8,480
133,15,2,18,267,8,275,1.2,480
133,15,3,11,623,40,663,1.0,480
134,1,1,6,278,28,306,1.5,480
134,1,2,12,349,7,356,1.5,480
134,1,3,1,712,81,793,1.5,480
134,2,1,11,712,88,800,1.0,480
134,2,2,33,576,28,604,0.8,480
134,2,3,18,214,11,225,1.2,480
134,3,1,27,618,82,700,0.8,480
134,3,2,5,276,27,303,1.0,480
134,3,3,40,564,64,628,1.5,480
134,4,1,27,395,7,402,0.8,480
134,4,2,15,373,50,423,1.2,480
134,4,3,21,624,89,713,1.5,480
134,5,1,7,795,70,865,1.0,480
134,5,2,32,401,33,434,0.8,480
134,5,3,13,207,13,220,1.0,480
134,6,1,20,593,15,608,1.5,480
134,6,2,6,531,59,590,1.5,480
134,7,1,27,642,80,722,0.8,480
134,7,2,33,207,3,210,0.8,480
134,8,1,15,755,75,830,1.2,480
134,8,2,6,774,73,847,1.5,480
134,8,3,22,498,3,501,1.2,480
134,9,1,21,306,24,330,1.5,480
134,9,3,38,394,36,430,1.5,480
134,10,1,38,686,72,758,1.5,480
134,10,2,18,514,32,546,1.2,480
134,10,3,18,272,37,309,1.2,480
134,11,1,39,342,17,359,1.0,480
134,11,2,13,328,23,351,1.0,480
134,12,1,21,673,33,706,1.5,480
134,12,2,21,449,40,489,1.5,480
134,12,3,17,730,78,808,1.2,480
134,13,1,22,216,9,225,1.2,480
134,13,2,38,424,27,451,1.5,480
134,13,3,7,744,43,787,1.0,480
134,14,1,2,588,59,647,0.8,480
134,14,2,38,441,4,445,1.5,480
134,14,3,22,754,50,804,1.2,480
134,15,2,15,474,22,496,1.2,480
134,15,3,37,584,78,662,1.2,480
135,1,1,30,283,8,291,1.5,480
135,1,2,28,492,34,526,1.5,480
135,1,3,20,781,42,823,1.5,480
135,2,1,28,426,40,466,1.5,480
135,2,2,18,289,18,307,1.2,480
135,2,3,16,302,5,307,1.2,480
135,3,1,7,222,21,243,1.0,480
135,3,2,8,503,40,543,1.0,480
135,3,3,14,265,5,270,1.0,480
135,4,1,40,578,58,636,1.5,480
135,4,2,22,637,5,642,1.2,480
135,4,3,8,300,16,316,1.0,480
135,5,1,34,375,36,411,1.0,480
135,5,2,34,431,56,487,1.0,480
135,6,2,6,539,1,540,1.5,480
135,6,3,25,544,61,605,1.5,480
135,7,1,23,321,8,329,1.2,480
135,7,2,14,753,107,860,1.0,480
135,7,3,26,728,6,734,1.0,480
135,8,1,3,691,30,721,1.5,480
135,8,3,11,257,26,283,1.0,480
135,9,1,16,580,64,644,1.2,480
135,9,2,39,637,33,670,1.0,480
135,9,3,7,250,32,282,1.0,480
135,10,1,35,346,14,360,0.8,480
135,10,2,15,222,17,239,1.2,480
135,10,3,22,557,50,607,1.2,480
135,11,1,1,495,29,524,1.5,480
135,11,2,39,572,64,636,1.0,480
135,11,3,8,674,76,750,1.0,480
135,12,1,17,768,101,869,1.2,480
135,12,2,10,360,6,366,1.2,480
135,13,2,33,360,35,395,0.8,480
135,13,3,15,305,12,317,1.2,480
135,14,1,9,744,35,779,1.0,480
135,14,2,6,241,34,275,1.5,480
135,15,1,20,259,23,282,1.5,480
135,15,2,26,277,40,317,1.0,480
135,15,3,16,485,27,512,1.2,480
136,1,2,21,714,4,718,1.5,480
136,1,3,27,500,73,573,0.8,480
136,2,1,6,441,38,479,1.5,480
136,2,2,8,547,28,575,1.0,480
136,2,3,1,611,3,614,1.5,480
136,3,1,8,290,38,328,1.0,480
136,3,2,17,464,58,522,1.2,480
136,4,1,25,520,39,559,1.5,480
136,4,2,33,205,0,205,0.8,480
136,5,1,24,457,35,492,1.0,480
136,5,3,11,225,8,233,1.0,480
136,6,2,30,710,48,758,1.5,480
136,7,1,38,602,22,624,1.5,480
136,7,2,37,429,36,465,1.2,480
136,7,3,14,491,65,556,1.0,480
136,8,1,21,403,56,459,1.5,480
136,8,2,8,657,62,719,1.0,480
136,8,3,28,687,20,707,1.5,480
136,9,1,4,270,11,281,0.8,480
136,9,2,26,515,48,563,1.0,480
136,10,2,28,281,18,299,1.5,480
136,10,3,20,200,23,223,1.5,480
136,11,1,4,714,34,748,0.8,480
136,11,2,22,203,25,228,1.2,480
136,11,3,38,468,11,479,1.5,480
136,12,1,36,546,29,575,0.8,480
136,12,3,29,254,0,254,0.8,480
136,13,1,37,444,25,469,1.2,480
136,13,2,11,504,47,551,1.0,480
136,13,3,28,232,1,233,1.5,480
136,14,1,2,616,63,679,0.8,480
136,14,2,6,530,42,572,1.5,480
136,14,3,16,552,81,633,1.2,480
136,15,1,2,323,17,340,0.8,480
136,15,2,30,781,80,861,1.5,480
136,15,3,15,206,4,210,1.2,480
137,1,1,8,713,40,753,1.0,480
137,1,3,26,487,19,506,1.0,480
137,2,1,17,475,15,490,1.2,480
137,2,3,10,364,31,395,1.2,480
137,3,1,38,356,42,398,1.5,480
137,3,2,2,419,50,469,0.8,480
137,3,3,14,390,15,405,1.0,480
137,4,1,2,478,65,543,0.8,480
137,4,2,18,428,25,453,1.2,480
137,4,3,34,651,13,664,1.0,480
137,5,1,6,591,55,646,1.5,480
137,5,2,5,230,15,245,1.0,480
137,5,3,13,341,34,375,1.0,480
137,6,1,14,585,20,605,1.0,480
137,6,3,36,305,39,344,0.8,480
137,7,1,28,202,4,206,1.5,480
137,7,3,32,293,32,325,0.8,480
137,8,1,40,749,108,857,1.5,480
137,8,2,19,452,60,512,1.5,480
137,8,3,32,524,18,542,0.8,480
137,9,1,5,460,36,496,1.0,480
137,9,3,26,203,18,221,1.0,480
137,10,1,10,466,4,470,1.2,480
137,10,2,11,334,23,357,1.0,480
137,10,3,34,503,10,513,1.0,480
137,11,1,13,545,69,614,1.0,480
137,11,2,25,778,65,843,1.5,480
137,11,3,24,556,44,600,1.0,480
137,12,1,25,481,10,491,1.5,480
137,12,2,16,576,9,585,1.2,480
137,12,3,31,738,83,821,1.2,480
137,13,1,38,577,68,645,1.5,480
137,13,2,32,445,48,493,0.8,480
137,13,3,2,480,61,541,0.8,480
137,14,1,11,448,39,487,1.0,480
137,14,2,18,515,25,540,1.2,480
137,14,3,30,547,77,624,1.5,480
137,15,2,40,742,91,833,1.5,480
138,1,1,36,417,58,475,0.8,480
138,1,3,34,272,31,303,1.0,480
138,2,2,23,361,27,388,1.2,480
138,3,1,37,694,20,714,1.2,480
138,3,2,25,223,16,239,1.5,480
138,3,3,2,273,38,311,0.8,480
138,4,1,14,661,65,726,1.0,480
138,4,2,35,736,50,786,0.8,480
138,5,1,14,278,38,316,1.0,480
138,5,3,16,519,22,541,1.2,480
138,6,1,3,276,27,303,1.5,480
138,6,2,37,458,12,470,1.2,480
138,6,3,20,448,13,461,1.5,480
138,7,1,23,630,56,686,1.2,480
138,7,3,16,338,25,363,1.2,480
138,8,1,32,405,12,417,0.8,480
138,8,2,22,354,32,386,1.2,480
138,8,3,8,596,21,617,1.0,480
138,9,2,25,690,0,690,1.5,480
138,9,3,20,497,49,546,1.5,480
138,10,1,22,446,48,494,1.2,480
138,10,3,37,576,67,643,1.2,480
138,11,1,12,684,97,781,1.5,480
138,11,2,2,323,34,357,0.8,480
138,11,3,21,525,74,599,1.5,480
138,12,3,13,470,45,515,1.0,480
138,13,2,12,566,59,625,1.5,480
138,13,3,7,749,52,801,1.0,480
138,14,1,22,458,0,458,1.2,480
138,14,2,32,593,65,658,0.8,480
138,14,3,15,628,12,640,1.2,480
138,15,1,30,542,7,549,1.5,480
138,15,3,27,712,16,728,0.8,480
139,1,1,37,779,83,862,1.2,480
139,1,2,12,363,43,406,1.5,480
139,1,3,7,223,19,242,1.0,480
139,2,1,19,715,57,772,1.5,480
139,2,2,29,778,58,836,0.8,480
139,2,3,21,638,72,710,1.5,480
139,3,1,17,215,28,243,1.2,480
139,4,2,25,512,67,579,1.5,480
139,4,3,31,370,1,371,1.2,480
139,5,1,34,708,82,790,1.0,480
139,5,2,28,744,6,750,1.5,480
139,5,3,35,715,17,732,0.8,480
139,6,1,19,247,16,263,1.5,480
139,6,2,13,309,45,354,1.0,480
139,7,1,5,482,37,519,1.0,480
139,7,2,33,568,44,612,0.8,480
139,8,2,2,692,43,735,0.8,480
139,8,3,18,668,30,698,1.2,480
139,9,2,7,299,32,331,1.0,480
139,9,3,39,365,49,414,1.0,480
139,10,1,22,236,6,242,1.2,480
139,10,2,37,302,42,344,1.2,480
139,10,3,25,700,66,766,1.5,480
139,11,1,13,543,66,609,1.0,480
139,11,2,27,754,61,815,0.8,480
139,11,3,37,702,98,800,1.2,480
139,12,1,35,746,36,782,0.8,480
139,12,2,6,612,13,625,1.5,480
139,12,3,30,593,3,596,1.5,480
139,13,1,39,675,98,773,1.0,480
139,13,2,8,571,57,628,1.0,480
139,13,3,16,602,86,688,1.2,480
139,14,3,9,649,29,678,1.0,480
139,15,1,22,444,37,481,1.2,480
139,15,2,40,366,1,367,1.5,480
139,15,3,11,337,17,354,1.0,480
140,1,1,11,506,19,525,1.0,480
140,1,2,38,728,23,751,1.5,480
140,2,3,37,622,44,666,1.2,480
140,3,1,14,683,38,721,1.0,480
140,3,2,20,781,50,831,1.5,480
140,3,3,35,349,25,374,0.8,480
140,4,1,32,595,50,645,0.8,480
140,4,2,18,678,26,704,1.2,480
140,4,3,33,371,53,424,0.8,480
140,5,1,17,474,64,538,1.2,480
140,5,2,38,290,5,295,1.5,480
140,5,3,5,467,65,532,1.0,480
140,6,1,18,542,78,620,1.2,480
140,6,2,20,528,55,583,1.5,480
140,6,3,5,691,90,781,1.0,480
140,7,1,9,470,10,480,1.0,480
140,7,2,4,407,41,448,0.8,480
140,7,3,23,697,4,701,1.2,480
140,8,1,26,301,20,321,1.0,480
140,8,3,7,363,13,376,1.0,480
140,9,1,36,789,113,902,0.8,480
140,9,2,35,272,26,298,0.8,480
140,9,3,3,464,60,524,1.5,480
140,10,1,8,268,38,306,1.0,480
140,10,2,13,298,41,339,1.0,480
140,10,3,19,302,7,309,1.5,480
140,11,1,32,575,56,631,0.8,480
140,11,2,29,262,34,296,0.8,480
140,12,1,18,788,99,887,1.2,480
140,12,2,40,352,20,372,1.5,480
140,12,3,17,480,70,550,1.2,480
140,13,1,4,636,75,711,0.8,480
140,13,2,32,599,81,680,0.8,480
140,13,3,28,445,0,445,1.5,480
140,14,1,21,648,96,744,1.5,480
140,15,1,15,779,113,892,1.2,480
140,15,2,40,488,5,493,1.5,480
140,15,3,38,212,15,227,1.5,480
141,1,1,36,433,57,490,0.8,480
141,1,2,18,546,74,620,1.2,480
141,1,3,6,287,16,303,1.5,480
141,2,1,28,744,80,824,1.5,480
141,2,2,33,692,47,739,0.8,480
141,2,3,13,574,53,627,1.0,480
141,3,1,18,556,39,595,1.2,480
141,3,2,25,710,90,800,1.5,480
141,3,3,38,211,10,221,1.5,480
141,4,1,38,414,2,416,1.5,480
141,4,2,6,552,19,571,1.5,480
141,4,3,6,235,20,255,1.5,480
141,5,1,16,320,23,343,1.2,480
141,5,2,1,558,20,578,1.5,480
141,5,3,29,323,14,337,0.8,480
141,6,1,14,394,23,417,1.0,480
141,6,2,2,379,2,381,0.8,480
141,7,1,16,314,6,320,1.2,480
141,7,2,10,537,3,540,1.2,480
141,7,3,4,353,19,372,0.8,480
141,8,2,19,524,67,591,1.5,480
141,8,3,3,521,14,535,1.5,480
141,9,3,33,576,68,644,0.8,480
141,10,1,31,392,54,446,1.2,480
141,10,2,1,747,5,752,1.5,480
141,10,3,1,668,61,729,1.5,480
141,11,1,13,308,3,311,1.0,480
141,11,3,14,431,18,449,1.0,480
141,12,1,7,792,5,797,1.0,480
141,12,2,14,220,4,224,1.0,480
141,13,1,9,645,5,650,1.0,480
141,13,2,3,366,31,397,1.5,480
141,13,3,22,580,66,646,1.2,480
141,14,1,17,731,45,776,1.2,480
141,14,2,14,389,2,391,1.0,480
141,15,1,6,254,14,268,1.5,480
141,15,2,38,299,26,325,1.5,480
141,15,3,32,463,57,520,0.8,480
142,1,1,25,214,10,224,1.5,480
142,1,2,21,675,46,721,1.5,480
142,2,1,12,694,34,728,1.5,480
142,2,2,32,452,54,506,0.8,480
142,3,1,22,309,37,346,1.2,480
142,3,2,21,208,15,223,1.5,480
142,3,3,34,392,16,408,1.0,480
142,4,2,7,406,1,407,1.0,480
142,4,3,11,799,81,880,1.0,480
142,5,2,1,595,3,598,1.5,480
142,6,1,1,783,3,786,1.5,480
142,6,2,11,333,48,381,1.0,480
142,6,3,40,692,64,756,1.5,480
142,7,1,34,572,10,582,1.0,480
142,7,2,40,294,7,301,1.5,480
142,7,3,15,469,62,531,1.2,480
142,8,1,18,529,30,559,1.2,480
142,8,2,27,699,59,758,0.8,480
142,8,3,27,790,75,865,0.8,480
142,9,1,18,384,19,403,1.2,480
142,9,2,37,389,43,432,1.2,480
142,9,3,17,560,61,621,1.2,480
142,10,1,37,594,30,624,1.2,480
142,10,2,6,793,25,818,1.5,480
142,10,3,34,738,36,774,1.0,480
142,11,2,12,386,41,427,1.5,480
142,11,3,10,599,6,605,1.2,480
142,12,1,6,411,59,470,1.5,480
142,12,2,34,470,49,519,1.0,480
142,13,1,40,445,56,501,1.5,480
142,13,2,33,287,7,294,0.8,480
142,13,3,21,496,51,547,1.5,480
142,14,1,32,495,47,542,0.8,480
142,14,2,31,751,106,857,1.2,480
142,14,3,17,642,26,668,1.2,480
142,15,1,27,346,48,394,0.8,480
142,15,2,27,583,16,599,0.8,480
142,15,3,40,736,73,809,1.5,480
143,1,1,37,703,58,761,1.2,480
143,1,2,27,670,5,675,0.8,480
143,2,1,25,275,36,311,1.5,480
143,2,2,35,541,49,590,0.8,480
143,2,3,8,756,16,772,1.0,480
143,3,1,13,340,34,374,1.0,480
143,3,2,7,631,41,672,1.0,480
143,3,3,28,753,91,844,1.5,480
143,4,1,16,308,24,332,1.2,480
143,4,2,21,791,59,850,1.5,480
143,4,3,32,791,12,803,0.8,480
143,5,1,34,660,85,745,1.0,480
143,5,2,4,518,16,534,0.8,480
143,5,3,25,578,21,599,1.5,480
143,6,1,40,354,15,369,1.5,480
143,6,2,37,247,18,265,1.2,480
143,6,3,16,711,64,775,1.2,480
143,7,1,17,365,9,374,1.2,480
143,7,2,28,665,60,725,1.5,480
143,7,3,15,286,14,300,1.2,480
143,8,2,5,478,14,492,1.0,480
143,8,3,38,754,110,864,1.5,480
143,9,1,28,337,36,373,1.5,480
143,9,2,19,563,19,582,1.5,480
143,9,3,28,277,20,297,1.5,480
143,10,1,18,417,10,427,1.2,480
143,10,2,29,288,25,313,0.8,480
143,10,3,20,305,32,337,1.5,480
143,11,1,23,303,22,325,1.2,480
143,11,2,40,318,22,340,1.5,480
143,11,3,7,655,75,730,1.0,480
143,12,1,32,211,14,225,0.8,480
143,12,2,14,693,49,742,1.0,480
143,12,3,38,548,52,600,1.5,480
143,13,1,14,403,11,414,1.0,480
143,13,2,8,465,42,507,1.0,480
143,13,3,17,704,61,765,1.2,480
143,14,1,31,374,28,402,1.2,480
143,14,2,3,743,105,848,1.5,480
143,14,3,29,416,9,425,0.8,480
143,15,3,17,447,21,468,1.2,480
144,1,1,31,585,22,607,1.2,480
144,1,2,13,786,78,864,1.0,480
144,1,3,18,239,3,242,1.2,480
144,2,1,39,591,56,647,1.0,480
144,2,2,15,550,23,573,1.2,480
144,2,3,34,498,2,500,1.0,480
144,3,1,38,288,20,308,1.5,480
144,3,3,31,481,26,507,1.2,480
144,4,1,15,340,15,355,1.2,480
144,4,2,26,269,19,288,1.0,480
144,4,3,5,528,43,571,1.0,480
144,5,1,21,581,73,654,1.5,480
144,5,2,8,344,6,350,1.0,480
144,6,1,39,579,74,653,1.0,480
144,6,2,20,723,89,812,1.5,480
144,6,3,1,536,51,587,1.5,480
144,7,1,31,440,25,465,1.2,480
144,7,2,40,726,98,824,1.5,480
144,7,3,16,377,47,424,1.2,480
144,8,1,29,557,22,579,0.8,480
144,8,2,10,795,37,832,1.2,480
144,9,1,36,738,32,770,0.8,480
144,9,2,10,239,0,239,1.2,480
144,9,3,28,376,47,423,1.5,480
144,10,1,11,406,34,440,1.0,480
144,10,2,33,731,68,799,0.8,480
144,10,3,8,426,57,483,1.0,480
144,11,1,24,532,22,554,1.0,480
144,11,2,18,686,74,760,1.2,480
144,11,3,5,359,0,359,1.0,480
144,12,2,26,419,30,449,1.0,480
144,12,3,34,732,4,736,1.0,480
144,13,1,3,401,5,406,1.5,480
144,13,2,8,559,15,574,1.0,480
144,13,3,5,300,11,311,1.0,480
144,14,1,21,402,40,442,1.5,480
144,14,3,38,323,1,324,1.5,480
144,15,1,35,471,41,512,0.8,480
144,15,2,2,407,36,443,0.8,480
144,15,3,27,289,35,324,0.8,480
145,1,1,39,402,14,416,1.0,480
145,1,3,6,525,35,560,1.5,480
145,2,1,15,204,21,225,1.2,480
145,3,1,22,696,18,714,1.2,480
145,3,2,37,384,35,419,1.2,480
145,3,3,2,679,26,705,0.8,480
145,4,1,30,492,63,555,1.5,480
145,4,2,36,376,23,399,0.8,480
145,4,3,18,389,4,393,1.2,480
145,5,1,33,237,24,261,0.8,480
145,5,2,6,713,14,727,1.5,480
145,5,3,3,361,14,375,1.5,480
145,6,1,25,275,19,294,1.5,480
145,6,3,24,727,24,751,1.0,480
145,7,1,2,552,16,568,0.8,480
145,7,2,2,648,81,729,0.8,480
145,7,3,33,353,8,361,0.8,480
145,8,1,11,612,9,621,1.0,480
145,8,2,19,418,31,449,1.5,480
145,9,1,35,557,49,606,0.8,480
145,9,2,35,773,85,858,0.8,480
145,9,3,40,349,11,360,1.5,480
145,10,1,14,388,57,445,1.0,480
145,11,1,12,730,38,768,1.5,480
145,11,2,20,733,71,804,1.5,480
145,11,3,9,400,25,425,1.0,480
145,12,1,15,296,38,334,1.2,480
145,12,2,32,776,44,820,0.8,480
145,12,3,11,673,99,772,1.0,480
145,13,1,12,737,44,781,1.5,480
145,13,2,38,657,17,674,1.5,480
145,13,3,22,591,27,618,1.2,480
145,14,1,13,573,29,602,1.0,480
145,14,2,27,390,43,433,0.8,480
145,14,3,32,443,52,495,0.8,480
145,15,1,36,764,108,872,0.8,480
145,15,2,10,576,38,614,1.2,480
145,15,3,28,299,40,339,1.5,480
146,1,1,10,474,60,534,1.2,480
146,1,2,20,403,6,409,1.5,480
146,1,3,5,528,8,536,1.0,480
146,2,1,30,743,97,840,1.5,480
146,2,2,21,718,80,798,1.5,480
146,2,3,24,643,24,667,1.0,480
146,3,1,33,445,14,459,0.8,480
146,3,2,29,740,12,752,0.8,480
146,4,1,29,225,13,238,0.8,480
146,4,2,1,551,50,601,1.5,480
146,4,3,20,567,80,647,1.5,480
146,5,1,18,631,58,689,1.2,480
146,5,2,25,365,41,406,1.5,480
146,5,3,7,522,71,593,1.0,480
146,6,1,4,238,9,247,0.8,480
146,6,2,19,226,27,253,1.5,480
146,6,3,12,642,16,658,1.5,480
146,7,1,25,407,47,454,1.5,480
146,7,2,11,509,46,555,1.0,480
146,7,3,14,434,52,486,1.0,480
146,8,1,8,753,11,764,1.0,480
146,8,2,10,323,30,353,1.2,480
146,8,3,30,564,76,640,1.5,480
146,9,1,13,586,25,611,1.0,480
146,9,2,4,763,73,836,0.8,480
146,9,3,36,717,82,799,0.8,480
146,10,2,40,723,74,797,1.5,480
146,10,3,3,786,19,805,1.5,480
146,11,1,39,693,23,716,1.0,480
146,11,2,22,610,44,654,1.2,480
146,11,3,33,373,43,416,0.8,480
146,12,1,40,591,22,613,1.5,480
146,12,2,5,603,42,645,1.0,480
146,12,3,30,265,30,295,1.5,480
146,13,1,20,607,43,650,1.5,480
146,13,3,20,728,20,748,1.5,480
146,14,1,34,479,51,530,1.0,480
146,14,2,23,654,71,725,1.2,480
146,14,3,11,278,26,304,1.0,480
146,15,1,36,503,50,553,0.8,480
146,15,2,17,587,6,593,1.2,480
146,15,3,4,472,50,522,0.8,480
147,1,1,37,441,20,461,1.2,480
147,1,2,9,685,15,700,1.0,480
147,1,3,38,507,46,553,1.5,480
147,2,1,31,244,5,249,1.2,480
147,2,2,24,562,53,615,1.0,480
147,2,3,21,426,40,466,1.5,480
147,3,1,7,527,12,539,1.0,480
147,3,2,19,623,4,627,1.5,480
147,4,2,2,435,53,488,0.8,480
147,4,3,19,625,14,639,1.5,480
147,5,1,17,577,17,594,1.2,480
147,5,2,37,603,68,671,1.2,480
147,5,3,39,407,0,407,1.0,480
147,6,1,27,226,28,254,0.8,480
147,6,2,12,722,59,781,1.5,480
147,6,3,9,420,50,470,1.0,480
147,7,1,37,653,22,675,1.2,480
147,7,2,39,431,44,475,1.0,480
147,7,3,8,373,29,402,1.0,480
147,8,1,6,379,9,388,1.5,480
147,8,2,5,673,16,689,1.0,480
147,8,3,20,423,6,429,1.5,480
147,9,1,2,377,40,417,0.8,480
147,9,2,9,659,31,690,1.0,480
147,9,3,17,249,30,279,1.2,480
147,10,1,13,214,31,245,1.0,480
147,10,3,15,404,24,428,1.2,480
147,11,1,4,200,18,218,0.8,480
147,11,2,24,471,63,534,1.0,480
147,11,3,15,599,0,599,1.2,480
147,12,1,4,779,24,803,0.8,480
147,12,2,12,244,21,265,1.5,480
147,12,3,16,384,17,401,1.2,480
147,13,1,6,784,3,787,1.5,480
147,13,2,17,570,58,628,1.2,480
147,13,3,35,607,67,674,0.8,480
147,14,1,13,711,45,756,1.0,480
147,14,2,1,435,43,478,1.5,480
147,14,3,37,588,19,607,1.2,480
147,15,2,29,796,26,822,0.8,480
147,15,3,40,221,10,231,1.5,480
148,1,1,23,469,34,503,1.2,480
148,1,2,29,507,52,559,0.8,480
148,1,3,31,525,38,563,1.2,480
148,2,1,32,378,36,414,0.8,480
148,2,2,32,549,75,624,0.8,480
148,3,2,33,679,10,689,0.8,480
148,3,3,24,292,1,293,1.0,480
148,4,1,29,460,52,512,0.8,480
148,4,2,10,670,56,726,1.2,480
148,4,3,17,297,26,323,1.2,480
148,5,1,23,234,7,241,1.2,480
148,5,2,17,343,48,391,1.2,480
148,5,3,9,481,37,518,1.0,480
148,6,1,24,488,68,556,1.0,480
148,6,2,12,452,57,509,1.5,480
148,6,3,34,744,75,819,1.0,480
148,7,1,21,758,50,808,1.5,480
148,7,2,3,380,15,395,1.5,480
148,8,1,40,439,28,467,1.5,480
148,8,2,19,558,27,585,1.5,480
148,8,3,39,261,6,267,1.0,480
148,9,1,31,339,23,362,1.2,480
148,9,2,15,747,31,778,1.2,480
148,9,3,11,260,11,271,1.0,480
148,10,3,14,255,6,261,1.0,480
148,11,1,35,586,68,654,0.8,480
148,11,2,9,777,51,828,1.0,480
148,11,3,15,723,10,733,1.2,480
148,12,2,22,283,31,314,1.2,480
148,12,3,17,552,47,599,1.2,480
148,13,1,33,343,24,367,0.8,480
148,13,2,4,768,78,846,0.8,480
148,13,3,33,776,15,791,0.8,480
148,14,1,5,708,5,713,1.0,480
148,14,3,23,437,10,447,1.2,480
148,15,1,24,735,71,806,1.0,480
148,15,2,31,359,0,359,1.2,480
148,15,3,30,204,14,218,1.5,480
149,1,1,38,444,38,482,1.5,480
149,1,3,25,460,52,512,1.5,480
149,2,1,19,460,24,484,1.5,480
149,2,2,9,578,65,643,1.0,480
149,2,3,8,538,0,538,1.0,480
149,3,1,30,677,83,760,1.5,480
149,3,2,6,245,11,256,1.5,480
149,3,3,34,504,61,565,1.0,480
149,4,1,2,203,2,205,0.8,480
149,4,2,7,673,64,737,1.0,480
149,4,3,13,418,6,424,1.0,480
149,5,1,26,317,40,357,1.0,480
149,5,2,32,276,28,304,0.8,480
149,5,3,17,442,16,458,1.2,480
149,6,1,38,253,22,275,1.5,480
149,6,2,35,571,70,641,0.8,480
149,6,3,36,516,42,558,0.8,480
149,7,1,28,716,2,718,1.5,480
149,7,2,10,280,37,317,1.2,480
149,7,3,10,744,13,757,1.2,480
149,8,1,21,572,13,585,1.5,480
149,8,3,15,632,85,717,1.2,480
149,9,1,8,481,45,526,1.0,480
149,9,2,38,726,15,741,1.5,480
149,9,3,2,638,38,676,0.8,480
149,10,1,12,608,73,681,1.5,480
149,10,3,15,406,43,449,1.2,480
149,11,1,21,594,78,672,1.5,480
149,11,2,13,359,18,377,1.0,480
149,12,1,1,372,51,423,1.5,480
149,12,3,38,337,36,373,1.5,480
149,13,1,29,408,3,411,0.8,480
149,13,2,15,540,61,601,1.2,480
149,13,3,32,270,37,307,0.8,480
149,14,1,33,639,85,724,0.8,480
149,14,2,29,645,49,694,0.8,480
149,14,3,11,407,1,408,1.0,480
149,15,2,10,208,28,236,1.2,480
149,15,3,28,234,4,238,1.5,480
150,1,1,30,486,46,532,1.5,480
150,1,2,1,540,6,546,1.5,480
150,2,1,7,261,33,294,1.0,480
150,2,3,26,296,6,302,1.0,480
150,3,1,17,435,18,453,1.2,480
150,3,2,26,770,84,854,1.0,480
150,3,3,25,322,4,326,1.5,480
150,4,1,32,684,97,781,0.8,480
150,4,3,8,679,13,692,1.0,480
150,5,1,10,311,28,339,1.2,480
150,5,2,36,414,5,419,0.8,480
150,5,3,9,211,16,227,1.0,480
150,6,1,5,742,82,824,1.0,480
150,6,2,3,699,93,792,1.5,480
150,6,3,7,323,21,344,1.0,480
150,7,2,37,523,46,569,1.2,480
150,7,3,4,743,39,782,0.8,480
150,8,1,1,537,24,561,1.5,480
150,8,2,10,439,62,501,1.2,480
150,8,3,4,439,32,471,0.8,480
150,9,1,34,517,44,561,1.0,480
150,9,2,36,352,24,376,0.8,480
150,9,3,40,255,10,265,1.5,480
150,10,2,26,653,52,705,1.0,480
150,10,3,10,559,70,629,1.2,480
150,11,1,23,778,16,794,1.2,480
150,11,2,17,782,89,871,1.2,480
150,11,3,35,573,38,611,0.8,480
150,12,1,25,258,6,264,1.5,480
150,12,2,15,421,60,481,1.2,480
150,12,3,26,497,38,535,1.0,480
150,13,1,40,692,52,744,1.5,480
150,13,2,3,563,55,618,1.5,480
150,13,3,27,746,93,839,0.8,480
150,14,1,16,347,24,371,1.2,480
150,14,2,15,433,60,493,1.2,480
150,14,3,28,292,34,326,1.5,480
150,15,1,32,639,76,715,0.8,480
150,15,2,5,559,42,601,1.0,480
150,15,3,30,515,5,520,1.5,480
151,1,1,36,448,38,486,0.8,480
151,1,3,9,407,8,415,1.0,480
151,2,1,35,285,32,317,0.8,480
151,2,2,31,789,65,854,1.2,480
151,2,3,2,710,97,807,0.8,480
151,3,1,4,326,10,336,0.8,480
151,3,2,29,745,63,808,0.8,480
151,3,3,6,218,30,248,1.5,480
151,4,1,37,532,76,608,1.2,480
151,4,2,25,362,15,377,1.5,480
151,4,3,3,297,34,331,1.5,480
151,5,2,6,362,17,379,1.5,480
151,6,1,10,319,25,344,1.2,480
151,6,3,31,520,14,534,1.2,480
151,7,1,31,263,29,292,1.2,480
151,7,2,20,622,7,629,1.5,480
151,7,3,7,403,30,433,1.0,480
151,8,1,27,333,39,372,0.8,480
151,8,2,36,400,39,439,0.8,480
151,9,1,18,591,25,616,1.2,480
151,9,2,12,200,17,217,1.5,480
151,9,3,21,559,55,614,1.5,480
151,10,1,16,516,71,587,1.2,480
151,10,2,16,614,21,635,1.2,480
151,10,3,1,508,40,548,1.5,480
151,11,1,19,330,33,363,1.5,480
151,11,2,7,676,88,764,1.0,480
151,11,3,7,395,0,395,1.0,480
151,12,1,34,697,85,782,1.0,480
151,12,2,15,295,31,326,1.2,480
151,12,3,18,589,27,616,1.2,480
151,13,1,17,662,36,698,1.2,480
151,13,2,23,617,65,682,1.2,480
151,13,3,24,243,23,266,1.0,480
151,14,1,33,557,45,602,0.8,480
151,14,2,39,536,49,585,1.0,480
151,14,3,12,652,62,714,1.5,480
151,15,1,4,645,11,656,0.8,480
151,15,2,13,630,84,714,1.0,480
151,15,3,23,359,25,384,1.2,480
152,1,1,28,237,30,267,1.5,480
152,1,2,7,210,6,216,1.0,480
152,1,3,32,235,9,244,0.8,480
152,2,1,3,460,65,525,1.5,480
152,2,2,37,466,49,515,1.2,480
152,2,3,8,521,12,533,1.0,480
152,3,1,9,447,20,467,1.0,480
152,3,2,25,630,73,703,1.5,480
152,3,3,5,292,41,333,1.0,480
152,4,1,11,212,14,226,1.0,480
152,4,2,35,550,31,581,0.8,480
152,4,3,31,764,49,813,1.2,480
152,5,2,36,767,111,878,0.8,480
152,5,3,32,392,53,445,0.8,480
152,6,1,27,426,51,477,0.8,480
152,6,2,27,423,29,452,0.8,480
152,6,3,26,682,51,733,1.0,480
152,7,2,12,701,18,719,1.5,480
152,7,3,29,790,25,815,0.8,480
152,8,1,18,413,43,456,1.2,480
152,8,2,26,591,67,658,1.0,480
152,9,3,26,686,35,721,1.0,480
152,10,1,10,648,77,725,1.2,480
152,10,3,34,324,7,331,1.0,480
152,11,2,19,469,3,472,1.5,480
152,11,3,25,772,65,837,1.5,480
152,12,1,7,328,46,374,1.0,480
152,12,2,19,700,60,760,1.5,480
152,13,1,26,471,20,491,1.0,480
152,13,2,10,400,28,428,1.2,480
152,13,3,15,279,3,282,1.2,480
152,14,1,3,601,27,628,1.5,480
152,14,2,21,616,56,672,1.5,480
152,14,3,33,397,40,437,0.8,480
152,15,1,25,279,30,309,1.5,480
152,15,2,16,787,29,816,1.2,480
153,1,1,40,458,50,508,1.5,480
153,1,2,21,794,54,848,1.5,480
153,1,3,23,383,7,390,1.2,480
153,2,1,16,608,62,670,1.2,480
153,2,2,15,606,72,678,1.2,480
153,2,3,33,653,80,733,0.8,480
153,3,1,16,656,64,720,1.2,480
153,3,2,18,605,6,611,1.2,480
153,3,3,28,456,16,472,1.5,480
153,4,1,23,345,50,395,1.2,480
153,4,2,18,723,49,772,1.2,480
153,5,1,18,677,54,731,1.2,480
153,5,2,39,631,20,651,1.0,480
153,5,3,10,228,0,228,1.2,480
153,6,1,17,512,24,536,1.2,480
153,6,2,38,322,46,368,1.5,480
153,6,3,33,213,0,213,0.8,480
153,7,1,31,420,43,463,1.2,480
153,7,2,8,781,48,829,1.0,480
153,7,3,25,568,25,593,1.5,480
153,8,1,39,317,1,318,1.0,480
153,8,2,33,653,28,681,0.8,480
153,8,3,8,368,6,374,1.0,480
153,9,2,28,375,45,420,1.5,480
153,9,3,36,387,34,421,0.8,480
153,10,2,8,204,28,232,1.0,480
153,10,3,37,435,47,482,1.2,480
153,11,1,16,377,8,385,1.2,480
153,11,2,17,627,79,706,1.2,480
153,11,3,10,581,13,594,1.2,480
153,12,1,6,381,1,382,1.5,480
153,12,2,17,450,40,490,1.2,480
153,12,3,29,289,21,310,0.8,480
153,13,1,1,287,8,295,1.5,480
153,13,2,16,527,78,605,1.2,480
153,13,3,2,386,17,403,0.8,480
153,14,1,35,264,1,265,0.8,480
153,14,2,12,584,60,644,1.5,480
153,14,3,5,492,70,562,1.0,480
153,15,1,5,472,49,521,1.0,480
153,15,2,33,535,67,602,0.8,480
153,15,3,20,705,11,716,1.5,480
154,1,1,7,391,32,423,1.0,480
154,1,2,24,297,24,321,1.0,480
154,1,3,32,321,36,357,0.8,480
154,2,1,31,414,60,474,1.2,480
154,2,2,22,439,50,489,1.2,480
154,2,3,10,571,83,654,1.2,480
154,3,1,11,733,43,776,1.0,480
154,3,3,5,245,18,263,1.0,480
154,4,1,26,214,10,224,1.0,480
154,4,2,1,620,8,628,1.5,480
154,4,3,35,485,35,520,0.8,480
154,5,1,2,686,70,756,0.8,480
154,5,2,40,313,20,333,1.5,480
154,5,3,23,371,41,412,1.2,480
154,6,1,16,690,17,707,1.2,480
154,6,2,16,236,24,260,1.2,480
154,6,3,12,368,49,417,1.5,480
154,7,1,20,619,3,622,1.5,480
154,7,3,10,656,4,660,1.2,480
154,8,2,33,324,32,356,0.8,480
154,8,3,19,586,34,620,1.5,480
154,9,1,26,590,21,611,1.0,480
154,9,3,1,433,37,470,1.5,480
154,10,1,18,782,92,874,1.2,480
154,10,2,3,441,39,480,1.5,480
154,10,3,19,290,27,317,1.5,480
154,11,1,34,426,21,447,1.0,480
154,11,2,7,444,64,508,1.0,480
154,11,3,7,703,4,707,1.0,480
154,12,1,29,550,31,581,0.8,480
154,12,2,4,202,14,216,0.8,480
154,12,3,26,326,4,330,1.0,480
154,13,1,2,784,74,858,0.8,480
154,13,2,2,540,22,562,0.8,480
154,13,3,35,223,19,242,0.8,480
154,14,1,37,286,4,290,1.2,480
154,14,2,35,709,89,798,0.8,480
154,15,1,22,723,80,803,1.2,480
154,15,2,37,428,56,484,1.2,480
154,15,3,24,202,1,203,1.0,480
155,2,1,22,541,8,549,1.2,480
155,2,2,32,378,44,422,0.8,480
155,2,3,25,217,17,234,1.5,480
155,3,1,11,479,6,485,1.0,480
155,3,2,26,474,2,476,1.0,480
155,3,3,29,394,14,408,0.8,480
155,4,1,26,669,71,740,1.0,480
155,4,2,13,288,41,329,1.0,480
155,4,3,35,548,57,605,0.8,480
155,5,1,35,558,67,625,0.8,480
155,5,2,10,615,7,622,1.2,480
155,6,1,37,573,62,635,1.2,480
155,6,2,19,461,30,491,1.5,480
155,6,3,10,436,36,472,1.2,480
155,7,1,1,682,81,763,1.5,480
155,7,2,16,252,16,268,1.2,480
155,7,3,2,559,51,610,0.8,480
155,8,1,8,347,7,354,1.0,480
155,8,2,35,624,76,700,0.8,480
155,8,3,29,685,71,756,0.8,480
155,9,1,12,462,9,471,1.5,480
155,9,2,18,587,47,634,1.2,480
155,9,3,28,644,61,705,1.5,480
155,10,2,8,367,30,397,1.0,480
155,10,3,28,206,19,225,1.5,480
155,11,1,29,761,46,807,0.8,480
155,11,2,7,770,15,785,1.0,480
155,12,2,38,574,43,617,1.5,480
155,12,3,7,258,5,263,1.0,480
155,13,1,13,257,7,264,1.0,480
155,13,2,1,301,19,320,1.5,480
155,13,3,34,234,4,238,1.0,480
155,14,1,31,749,105,854,1.2,480
155,14,2,34,769,1,770,1.0,480
155,14,3,27,758,46,804,0.8,480
155,15,1,33,209,12,221,0.8,480
155,15,2,29,741,81,822,0.8,480
156,1,1,31,504,63,567,1.2,480
156,1,3,23,729,64,793,1.2,480
156,2,1,18,562,49,611,1.2,480
156,2,2,12,635,48,683,1.5,480
156,2,3,33,778,18,796,0.8,480
156,3,1,3,210,15,225,1.5,480
156,3,2,36,524,77,601,0.8,480
156,3,3,33,211,12,223,0.8,480
156,4,1,20,781,76,857,1.5,480
156,4,2,17,280,21,301,1.2,480
156,5,1,31,559,68,627,1.2,480
156,5,3,25,292,26,318,1.5,480
156,6,1,24,433,36,469,1.0,480
156,6,2,4,366,21,387,0.8,480
156,6,3,12,448,9,457,1.5,480
156,7,1,12,618,31,649,1.5,480
156,7,2,25,573,84,657,1.5,480
156,7,3,40,437,52,489,1.5,480
156,8,1,39,336,39,375,1.0,480
156,8,2,1,649,1,650,1.5,480
156,8,3,5,587,27,614,1.0,480
156,9,1,26,423,39,462,1.0,480
156,9,2,24,721,95,816,1.0,480
156,9,3,24,270,39,309,1.0,480
156,10,1,17,472,55,527,1.2,480
156,10,2,31,715,4,719,1.2,480
156,10,3,20,367,18,385,1.5,480
156,11,1,39,768,2,770,1.0,480
156,11,3,22,389,21,410,1.2,480
156,12,1,35,342,2,344,0.8,480
156,12,2,3,637,59,696,1.5,480
156,12,3,7,729,36,765,1.0,480
156,13,1,22,612,29,641,1.2,480
156,13,2,4,298,19,317,0.8,480
156,13,3,31,249,10,259,1.2,480
156,14,1,39,339,8,347,1.0,480
156,14,2,20,522,43,565,1.5,480
156,14,3,4,328,46,374,0.8,480
156,15,2,17,648,84,732,1.2,480
156,15,3,5,371,0,371,1.0,480
157,1,1,40,202,4,206,1.5,480
157,1,3,5,707,104,811,1.0,480
157,2,1,13,492,29,521,1.0,480
157,2,2,6,328,17,345,1.5,480
157,2,3,16,789,6,795,1.2,480
157,3,1,13,222,31,253,1.0,480
157,3,2,22,446,16,462,1.2,480
157,3,3,31,639,51,690,1.2,480
157,4,1,28,679,30,709,1.5,480
157,4,2,10,649,18,667,1.2,480
157,4,3,10,575,71,646,1.2,480
157,5,2,30,705,66,771,1.5,480
157,5,3,4,373,12,385,0.8,480
157,6,1,37,348,2,350,1.2,480
157,6,2,9,404,35,439,1.0,480
157,6,3,7,505,60,565,1.0,480
157,8,1,15,542,47,589,1.2,480
157,8,2,17,215,22,237,1.2,480
157,8,3,40,365,13,378,1.5,480
157,9,1,9,368,14,382,1.0,480
157,9,2,34,386,3,389,1.0,480
157,9,3,7,611,5,616,1.0,480
157,10,1,36,610,13,623,0.8,480
157,10,2,17,646,7,653,1.2,480
157,11,1,40,695,80,775,1.5,480
157,11,2,17,488,2,490,1.2,480
157,11,3,4,795,42,837,0.8,480
157,12,2,3,441,31,472,1.5,480
157,12,3,27,409,44,453,0.8,480
157,13,1,40,254,5,259,1.5,480
157,13,2,39,327,7,334,1.0,480
157,13,3,22,437,29,466,1.2,480
157,14,1,30,638,78,716,1.5,480
157,14,2,38,273,37,310,1.5,480
157,14,3,30,322,37,359,1.5,480
157,15,1,14,664,92,756,1.0,480
157,15,2,34,693,81,774,1.0,480
157,15,3,31,249,30,279,1.2,480
158,1,1,37,286,20,306,1.2,480
158,1,2,23,290,23,313,1.2,480
158,2,1,17,531,19,550,1.2,480
158,2,2,21,645,58,703,1.5,480
158,2,3,39,744,0,744,1.0,480
158,3,1,35,657,24,681,0.8,480
158,3,2,14,337,5,342,1.0,480
158,3,3,22,552,11,563,1.2,480
158,4,1,15,491,14,505,1.2,480
158,4,2,39,554,38,592,1.0,480
158,4,3,19,446,37,483,1.5,480
158,5,1,32,501,8,509,0.8,480
158,6,1,28,398,38,436,1.5,480
158,6,2,23,667,40,707,1.2,480
158,6,3,22,518,18,536,1.2,480
158,7,2,20,568,22,590,1.5,480
158,7,3,32,774,70,844,0.8,480
158,8,1,6,534,11,545,1.5,480
158,8,2,1,496,41,537,1.5,480
158,8,3,1,366,15,381,1.5,480
158,9,1,1,518,53,571,1.5,480
158,9,2,9,636,89,725,1.0,480
158,9,3,3,528,5,533,1.5,480
158,10,2,5,207,9,216,1.0,480
158,10,3,38,586,66,652,1.5,480
158,11,1,20,391,5,396,1.5,480
158,11,2,22,223,11,234,1.2,480
158,11,3,3,748,97,845,1.5,480
158,12,2,20,688,1,689,1.5,480
158,12,3,8,480,33,513,1.0,480
158,13,1,3,518,76,594,1.5,480
158,13,2,37,349,18,367,1.2,480
158,13,3,23,311,32,343,1.2,480
158,14,1,29,579,41,620,0.8,480
158,14,2,20,632,11,643,1.5,480
158,14,3,15,510,12,522,1.2,480
158,15,1,16,724,69,793,1.2,480
158,15,2,30,495,7,502,1.5,480
158,15,3,17,787,105,892,1.2,480
159,1,1,17,702,71,773,1.2,480
159,1,3,36,253,15,268,0.8,480
159,2,2,4,335,29,364,0.8,480
159,2,3,23,740,91,831,1.2,480
159,3,1,18,623,84,707,1.2,480
159,3,2,31,795,81,876,1.2,480
159,3,3,32,217,15,232,0.8,480
159,4,1,26,693,60,753,1.0,480
159,4,2,15,492,53,545,1.2,480
159,5,1,17,304,3,307,1.2,480
159,5,2,14,587,26,613,1.0,480
159,5,3,31,633,51,684,1.2,480
159,6,1,12,661,31,692,1.5,480
159,6,2,8,593,66,659,1.0,480
159,6,3,33,287,41,328,0.8,480
159,7,3,15,421,44,465,1.2,480
159,8,2,30,308,16,324,1.5,480
159,8,3,14,744,19,763,1.0,480
159,9,1,32,665,44,709,0.8,480
159,9,2,24,408,27,435,1.0,480
159,10,1,18,431,36,467,1.2,480
159,10,2,3,624,55,679,1.5,480
159,10,3,2,208,25,233,0.8,480
159,11,1,25,470,45,515,1.5,480
159,11,2,32,734,53,787,0.8,480
159,12,1,32,371,25,396,0.8,480
159,12,2,2,496,59,555,0.8,480
159,12,3,35,569,26,595,0.8,480
159,13,1,11,692,14,706,1.0,480
159,13,2,2,237,32,269,0.8,480
159,13,3,38,400,17,417,1.5,480
159,14,1,16,339,13,352,1.2,480
159,14,2,37,497,3,500,1.2,480
159,14,3,7,636,45,681,1.0,480
159,15,1,8,666,15,681,1.0,480
160,1,1,31,330,29,359,1.2,480
160,1,2,17,481,59,540,1.2,480
160,2,2,19,645,89,734,1.5,480
160,2,3,36,621,43,664,0.8,480
160,3,1,28,576,1,577,1.5,480
160,3,2,12,716,81,797,1.5,480
160,3,3,36,673,98,771,0.8,480
160,4,1,32,788,101,889,0.8,480
160,4,2,5,771,7,778,1.0,480
160,4,3,38,494,17,511,1.5,480
160,5,1,13,516,2,518,1.0,480
160,5,2,6,297,15,312,1.5,480
160,5,3,19,266,20,286,1.5,480
160,6,1,25,759,43,802,1.5,480
160,6,2,9,742,24,766,1.0,480
160,7,1,26,774,24,798,1.0,480
160,7,2,19,293,42,335,1.5,480
160,7,3,7,344,1,345,1.0,480
160,8,1,29,781,67,848,0.8,480
160,8,2,12,553,58,611,1.5,480
160,8,3,28,704,91,795,1.5,480
160,9,1,9,788,93,881,1.0,480
160,9,2,39,320,40,360,1.0,480
160,9,3,21,480,37,517,1.5,480
160,10,1,21,408,43,451,1.5,480
160,10,3,33,574,57,631,0.8,480
160,11,1,24,379,1,380,1.0,480
160,11,2,10,285,6,291,1.2,480
160,11,3,33,423,55,478,0.8,480
160,12,1,36,429,17,446,0.8,480
160,12,2,21,236,21,257,1.5,480
160,12,3,12,629,23,652,1.5,480
160,13,1,28,747,14,761,1.5,480
160,13,2,11,327,48,375,1.0,480
160,13,3,32,445,62,507,0.8,480
160,14,1,33,449,41,490,0.8,480
160,14,2,34,286,12,298,1.0,480
160,14,3,3,587,79,666,1.5,480
160,15,1,30,614,37,651,1.5,480
160,15,3,4,612,76,688,0.8,480
161,1,2,14,730,50,780,1.0,480
161,1,3,40,729,5,734,1.5,480
161,2,1,13,551,50,601,1.0,480
161,2,2,10,541,53,594,1.2,480
161,2,3,26,230,13,243,1.0,480
161,3,1,40,608,8,616,1.5,480
161,3,2,10,726,13,739,1.2,480
161,3,3,15,259,2,261,1.2,480
161,4,1,2,785,80,865,0.8,480
161,4,2,30,530,31,561,1.5,480
161,4,3,31,462,46,508,1.2,480
161,5,1,40,728,47,775,1.5,480
161,5,2,14,241,8,249,1.0,480
161,5,3,14,217,10,227,1.0,480
161,6,1,32,491,14,505,0.8,480
161,6,2,14,233,5,238,1.0,480
161,6,3,33,560,24,584,0.8,480
161,7,1,11,487,69,556,1.0,480
161,7,2,34,489,64,553,1.0,480
161,8,1,20,766,53,819,1.5,480
161,8,2,9,518,27,545,1.0,480
161,8,3,14,494,14,508,1.0,480
161,9,1,7,706,67,773,1.0,480
161,9,2,30,409,47,456,1.5,480
161,9,3,5,427,22,449,1.0,480
161,10,2,12,518,60,578,1.5,480
161,10,3,22,526,13,539,1.2,480
161,11,2,29,575,6,581,0.8,480
161,12,2,1,377,47,424,1.5,480
161,12,3,36,665,0,665,0.8,480
161,13,1,17,792,72,864,1.2,480
161,13,3,6,288,26,314,1.5,480
161,14,1,23,783,34,817,1.2,480
161,14,2,40,360,44,404,1.5,480
161,14,3,4,217,15,232,0.8,480
161,15,1,21,430,37,467,1.5,480
161,15,2,10,718,70,788,1.2,480
161,15,3,18,412,24,436,1.2,480
162,1,2,35,690,42,732,0.8,480
162,1,3,38,302,38,340,1.5,480
162,2,1,34,315,14,329,1.0,480
162,2,2,30,365,51,416,1.5,480
162,2,3,31,308,10,318,1.2,480
162,3,2,17,382,17,399,1.2,480
162,3,3,40,638,83,721,1.5,480
162,4,1,5,765,49,814,1.0,480
162,4,3,14,660,53,713,1.0,480
162,5,1,2,476,3,479,0.8,480
162,5,2,31,302,35,337,1.2,480
162,5,3,20,552,25,577,1.5,480
162,6,1,29,664,10,674,0.8,480
162,6,2,31,299,15,314,1.2,480
162,6,3,5,236,3,239,1.0,480
162,7,2,24,683,47,730,1.0,480
162,8,1,17,334,6,340,1.2,480
162,8,2,39,797,63,860,1.0,480
162,8,3,3,348,40,388,1.5,480
162,9,1,38,722,59,781,1.5,480
162,9,2,10,755,111,866,1.2,480
162,9,3,18,458,37,495,1.2,480
162,10,1,8,711,11,722,1.0,480
162,10,2,17,233,8,241,1.2,480
162,10,3,38,315,25,340,1.5,480
162,11,1,25,252,20,272,1.5,480
162,11,3,25,523,26,549,1.5,480
162,12,1,18,541,20,561,1.2,480
162,12,2,7,792,35,827,1.0,480
162,12,3,22,798,32,830,1.2,480
162,13,1,22,471,50,521,1.2,480
162,13,2,14,668,74,742,1.0,480
162,13,3,12,636,15,651,1.5,480
162,14,1,21,230,2,232,1.5,480
162,14,2,29,699,94,793,0.8,480
162,15,1,30,740,73,813,1.5,480
162,15,2,7,440,41,481,1.0,480
162,15,3,11,610,74,684,1.0,480
163,1,1,9,671,42,713,1.0,480
163,1,2,30,404,30,434,1.5,480
163,2,1,14,238,1,239,1.0,480
163,2,2,21,520,19,539,1.5,480
163,2,3,37,767,59,826,1.2,480
163,3,1,21,764,37,801,1.5,480
163,3,2,35,421,28,449,0.8,480
163,3,3,8,546,45,591,1.0,480
163,4,1,26,710,8,718,1.0,480
163,4,2,19,514,58,572,1.5,480
163,4,3,11,501,64,565,1.0,480
163,5,1,17,229,33,262,1.2,480
163,5,2,24,737,77,814,1.0,480
163,5,3,22,779,82,861,1.2,480
163,6,1,35,275,19,294,0.8,480
163,6,2,9,362,2,364,1.0,480
163,6,3,7,495,3,498,1.0,480
163,7,1,24,538,66,604,1.0,480
163,7,2,32,773,103,876,0.8,480
163,7,3,31,406,3,409,1.2,480
163,8,1,13,568,64,632,1.0,480
163,8,2,23,352,35,387,1.2,480
163,8,3,25,672,40,712,1.5,480
163,9,1,30,367,3,370,1.5,480
163,9,2,16,250,26,276,1.2,480
163,9,3,23,200,4,204,1.2,480
163,10,1,28,440,47,487,1.5,480
163,10,2,26,690,73,763,1.0,480
163,10,3,11,513,59,572,1.0,480
163,11,1,19,470,44,514,1.5,480
163,11,2,39,450,12,462,1.0,480
163,12,1,32,776,86,862,0.8,480
163,13,1,1,604,43,647,1.5,480
163,13,2,7,312,15,327,1.0,480
163,14,1,13,297,2,299,1.0,480
163,14,2,26,545,50,595,1.0,480
163,14,3,13,227,33,260,1.0,480
163,15,1,24,281,8,289,1.0,480
163,15,2,24,640,73,713,1.0,480
163,15,3,27,330,7,337,0.8,480
164,1,1,36,722,75,797,0.8,480
164,1,2,19,330,14,344,1.5,480
164,1,3,25,575,14,589,1.5,480
164,2,1,18,254,7,261,1.2,480
164,2,2,2,711,48,759,0.8,480
164,2,3,8,793,87,880,1.0,480
164,3,1,8,511,0,511,1.0,480
164,3,3,13,464,35,499,1.0,480
164,4,1,20,680,84,764,1.5,480
164,4,2,12,210,18,228,1.5,480
164,4,3,2,326,10,336,0.8,480
164,5,1,29,492,71,563,0.8,480
164,5,3,30,430,19,449,1.5,480
164,6,1,30,749,92,841,1.5,480
164,6,2,28,384,2,386,1.5,480
164,6,3,36,573,20,593,0.8,480
164,7,1,33,749,41,790,0.8,480
164,7,3,6,337,34,371,1.5,480
164,8,1,15,722,58,780,1.2,480
164,8,2,40,710,48,758,1.5,480
164,9,1,13,303,26,329,1.0,480
164,9,2,20,350,9,359,1.5,480
164,10,1,6,683,48,731,1.5,480
164,10,2,3,518,34,552,1.5,480
164,10,3,14,404,55,459,1.0,480
164,11,2,12,510,48,558,1.5,480
164,11,3,33,377,47,424,0.8,480
164,12,3,18,481,56,537,1.2,480
164,13,1,40,592,86,678,1.5,480
164,13,3,13,500,63,563,1.0,480
164,14,1,14,502,14,516,1.0,480
164,14,2,10,750,37,787,1.2,480
164,14,3,27,279,34,313,0.8,480
164,15,1,18,769,78,847,1.2,480
164,15,2,14,406,45,451,1.0,480
165,1,1,11,783,21,804,1.0,480
165,1,3,28,650,34,684,1.5,480
165,2,1,4,770,69,839,0.8,480
165,2,2,21,345,7,352,1.5,480
165,2,3,15,370,9,379,1.2,480
165,3,1,38,434,64,498,1.5,480
165,3,2,27,363,30,393,0.8,480
165,3,3,31,755,101,856,1.2,480
165,4,1,13,388,44,432,1.0,480
165,4,2,36,517,16,533,0.8,480
165,4,3,9,655,0,655,1.0,480
165,5,2,28,487,15,502,1.5,480
165,6,1,38,506,70,576,1.5,480
165,6,3,6,458,40,498,1.5,480
165,7,1,16,433,41,474,1.2,480
165,7,2,5,598,62,660,1.0,480
165,7,3,25,785,3,788,1.5,480
165,8,1,40,426,11,437,1.5,480
165,8,2,29,434,16,450,0.8,480
165,8,3,16,625,35,660,1.2,480
165,9,1,15,275,36,311,1.2,480
165,9,2,10,347,26,373,1.2,480
165,9,3,12,794,98,892,1.5,480
165,10,1,24,450,19,469,1.0,480
165,10,2,9,209,21,230,1.0,480
165,10,3,18,446,14,460,1.2,480
165,11,1,34,366,12,378,1.0,480
165,11,2,8,211,5,216,1.0,480
165,11,3,22,647,65,712,1.2,480
165,12,1,33,277,19,296,0.8,480
165,12,2,30,213,17,230,1.5,480
165,12,3,40,760,61,821,1.5,480
165,13,1,36,792,111,903,0.8,480
165,13,2,29,643,53,696,0.8,480
165,13,3,34,565,38,603,1.0,480
165,14,1,38,568,56,624,1.5,480
165,14,2,2,305,32,337,0.8,480
165,14,3,7,571,46,617,1.0,480
165,15,1,13,452,25,477,1.0,480
165,15,2,19,350,47,397,1.5,480
165,15,3,11,265,6,271,1.0,480
166,1,1,19,692,59,751,1.5,480
166,1,2,23,514,26,540,1.2,480
166,1,3,13,647,0,647,1.0,480
166,2,1,39,201,2,203,1.0,480
166,2,2,23,783,43,826,1.2,480
166,2,3,9,601,36,637,1.0,480
166,3,1,33,359,16,375,0.8,480
166,3,2,23,303,4,307,1.2,480
166,3,3,10,768,3,771,1.2,480
166,4,1,8,617,20,637,1.0,480
166,4,2,20,258,6,264,1.5,480
166,4,3,13,711,62,773,1.0,480
166,5,1,16,745,90,835,1.2,480
166,5,2,23,715,13,728,1.2,480
166,5,3,26,444,39,483,1.0,480
166,6,2,14,540,23,563,1.0,480
166,6,3,16,554,77,631,1.2,480
166,7,1,10,664,32,696,1.2,480
166,7,2,30,217,10,227,1.5,480
166,8,1,33,618,70,688,0.8,480
166,8,2,12,410,4,414,1.5,480
166,8,3,12,437,23,460,1.5,480
166,9,1,11,693,44,737,1.0,480
166,9,2,17,289,17,306,1.2,480
166,9,3,1,649,58,707,1.5,480
166,10,1,7,658,74,732,1.0,480
166,10,2,40,290,37,327,1.5,480
166,10,3,15,235,11,246,1.2,480
166,11,1,11,357,38,395,1.0,480
166,11,2,13,271,25,296,1.0,480
166,11,3,37,252,22,274,1.2,480
166,12,1,11,482,26,508,1.0,480
166,13,1,2,680,74,754,0.8,480
166,13,2,37,699,51,750,1.2,480
166,13,3,40,763,64,827,1.5,480
166,14,1,25,319,16,335,1.5,480
166,14,2,21,659,42,701,1.5,480
166,14,3,33,305,0,305,0.8,480
167,1,1,13,793,34,827,1.0,480
167,1,2,11,514,64,578,1.0,480
167,1,3,28,359,6,365,1.5,480
167,2,1,24,472,10,482,1.0,480
167,3,1,38,591,7,598,1.5,480
167,3,2,29,323,24,347,0.8,480
167,3,3,40,215,16,231,1.5,480
167,4,1,39,799,56,855,1.0,480
167,4,2,20,363,9,372,1.5,480
167,4,3,25,377,39,416,1.5,480
167,5,1,15,431,37,468,1.2,480
167,5,2,12,572,59,631,1.5,480
167,6,1,35,344,23,367,0.8,480
167,6,2,27,729,92,821,0.8,480
167,6,3,37,608,22,630,1.2,480
167,7,1,13,253,20,273,1.0,480
167,7,2,27,674,10,684,0.8,480
167,7,3,18,783,50,833,1.2,480
167,8,1,34,422,22,444,1.0,480
167,8,2,38,761,42,803,1.5,480
167,8,3,1,364,40,404,1.5,480
167,9,1,17,384,23,407,1.2,480
167,9,2,21,543,46,589,1.5,480
167,9,3,6,783,89,872,1.5,480
167,10,2,8,428,3,431,1.0,480
167,10,3,9,782,31,813,1.0,480
167,11,1,23,660,62,722,1.2,480
167,11,2,6,666,75,741,1.5,480
167,11,3,5,265,29,294,1.0,480
167,12,3,23,666,83,749,1.2,480
167,14,1,19,460,67,527,1.5,480
167,14,3,27,532,32,564,0.8,480
167,15,1,12,619,52,671,1.5,480
167,15,2,12,673,85,758,1.5,480
167,15,3,27,709,51,760,0.8,480
168,1,1,3,612,33,645,1.5,480
168,1,2,33,333,44,377,0.8,480
168,1,3,39,261,3,264,1.0,480
168,2,1,7,715,70,785,1.0,480
168,2,2,5,392,14,406,1.0,480
168,2,3,24,320,0,320,1.0,480
168,3,1,20,754,51,805,1.5,480
168,3,2,9,268,32,300,1.0,480
168,3,3,14,690,49,739,1.0,480
168,4,2,12,754,11,765,1.5,480
168,4,3,9,698,80,778,1.0,480
168,5,2,39,571,37,608,1.0,480
168,5,3,38,511,74,585,1.5,480
168,6,2,8,492,71,563,1.0,480
168,6,3,13,737,6,743,1.0,480
168,7,1,40,202,6,208,1.5,480
168,7,2,3,353,11,364,1.5,480
168,7,3,25,747,100,847,1.5,480
168,8,1,8,409,47,456,1.0,480
168,8,2,15,575,63,638,1.2,480
168,8,3,8,262,32,294,1.0,480
168,9,1,26,583,5,588,1.0,480
168,9,2,28,785,60,845,1.5,480
168,9,3,39,365,31,396,1.0,480
168,10,2,4,317,33,350,0.8,480
168,10,3,12,557,45,602,1.5,480
168,11,1,30,475,33,508,1.5,480
168,11,3,17,645,93,738,1.2,480
168,12,1,5,387,0,387,1.0,480
168,12,2,15,740,4,744,1.2,480
168,12,3,30,481,6,487,1.5,480
168,13,1,17,705,52,757,1.2,480
168,13,2,20,649,58,707,1.5,480
168,13,3,38,278,16,294,1.5,480
168,14,1,29,640,61,701,0.8,480
168,14,2,30,397,41,438,1.5,480
168,14,3,33,463,10,473,0.8,480
168,15,1,30,326,41,367,1.5,480
168,15,3,34,672,43,715,1.0,480
169,1,1,10,542,71,613,1.2,480
169,1,2,26,607,83,690,1.0,480
169,1,3,26,219,19,238,1.0,480
169,2,1,31,238,27,265,1.2,480
169,2,2,28,324,40,364,1.5,480
169,2,3,21,769,67,836,1.5,480
169,3,1,13,614,38,652,1.0,480
169,3,2,1,233,4,237,1.5,480
169,3,3,39,450,20,470,1.0,480
169,4,1,40,634,86,720,1.5,480
169,4,2,30,500,37,537,1.5,480
169,5,1,35,638,47,685,0.8,480
169,5,2,36,517,65,582,0.8,480
169,5,3,35,515,63,578,0.8,480
169,6,1,21,257,29,286,1.5,480
169,6,2,8,461,61,522,1.0,480
169,6,3,30,762,40,802,1.5,480
169,7,1,20,342,35,377,1.5,480
169,7,2,38,460,65,525,1.5,480
169,8,1,23,563,20,583,1.2,480
169,8,2,38,492,47,539,1.5,480
169,8,3,15,463,39,502,1.2,480
169,9,1,16,457,8,465,1.2,480
169,9,2,3,601,76,677,1.5,480
169,9,3,20,594,77,671,1.5,480
169,10,1,31,239,2,241,1.2,480
169,10,2,9,725,104,829,1.0,480
169,10,3,20,313,45,358,1.5,480
169,11,1,28,730,30,760,1.5,480
169,11,2,4,775,87,862,0.8,480
169,11,3,9,497,19,516,1.0,480
169,12,1,3,526,20,546,1.5,480
169,12,2,26,209,26,235,1.0,480
169,12,3,4,219,31,250,0.8,480
169,13,1,1,516,37,553,1.5,480
169,13,2,20,332,26,358,1.5,480
169,13,3,8,224,18,242,1.0,480
169,14,1,1,602,11,613,1.5,480
169,14,2,20,289,4,293,1.5,480
169,14,3,32,218,20,238,0.8,480
169,15,1,35,619,27,646,0.8,480
169,15,2,11,597,77,674,1.0,480
169,15,3,5,629,89,718,1.0,480
170,1,1,18,236,4,240,1.2,480
170,1,2,22,219,29,248,1.2,480
170,2,1,29,487,70,557,0.8,480
170,2,2,9,409,38,447,1.0,480
170,2,3,25,463,1,464,1.5,480
170,3,3,16,377,5,382,1.2,480
170,4,1,26,717,55,772,1.0,480
170,4,3,19,270,35,305,1.5,480
170,5,3,14,603,6,609,1.0,480
170,6,1,36,330,3,333,0.8,480
170,6,2,10,575,7,582,1.2,480
170,6,3,12,714,46,760,1.5,480
170,7,1,14,760,15,775,1.0,480
170,7,2,7,293,32,325,1.0,480
170,7,3,5,677,37,714,1.0,480
170,8,1,22,584,58,642,1.2,480
170,8,2,26,724,46,770,1.0,480
170,8,3,26,260,30,290,1.0,480
170,9,2,39,343,41,384,1.0,480
170,9,3,31,774,18,792,1.2,480
170,10,2,25,317,26,343,1.5,480
170,10,3,36,703,39,742,0.8,480
170,11,1,5,683,72,755,1.0,480
170,11,3,37,612,22,634,1.2,480
170,12,1,15,427,0,427,1.2,480
170,12,2,30,313,9,322,1.5,480
170,12,3,20,716,101,817,1.5,480
170,13,1,11,717,90,807,1.0,480
170,13,3,31,670,8,678,1.2,480
170,14,1,23,649,68,717,1.2,480
170,14,2,12,632,40,672,1.5,480
170,15,1,4,254,32,286,0.8,480
170,15,2,34,777,46,823,1.0,480
170,15,3,1,350,12,362,1.5,480
171,1,1,38,432,48,480,1.5,480
171,1,3,28,316,16,332,1.5,480
171,2,1,5,617,67,684,1.0,480
171,2,2,32,786,67,853,0.8,480
171,3,2,25,502,57,559,1.5,480
171,3,3,5,799,22,821,1.0,480
171,4,1,20,405,41,446,1.5,480
171,4,3,15,651,45,696,1.2,480
171,5,1,34,445,28,473,1.0,480
171,5,3,17,683,16,699,1.2,480
171,6,1,36,221,10,231,0.8,480
171,6,2,2,320,47,367,0.8,480
171,6,3,35,796,32,828,0.8,480
171,7,1,25,370,43,413,1.5,480
171,8,1,12,252,29,281,1.5,480
171,8,2,14,409,11,420,1.0,480
171,8,3,33,566,17,583,0.8,480
171,9,1,3,636,41,677,1.5,480
171,9,2,16,237,7,244,1.2,480
171,9,3,1,285,38,323,1.5,480
171,10,1,5,596,87,683,1.0,480
171,10,2,4,460,17,477,0.8,480
171,10,3,6,740,70,810,1.5,480
171,11,1,11,487,24,511,1.0,480
171,12,1,34,683,54,737,1.0,480
171,12,2,40,204,23,227,1.5,480
171,12,3,12,574,30,604,1.5,480
171,13,1,24,788,46,834,1.0,480
171,13,2,32,211,7,218,0.8,480
171,14,1,15,628,51,679,1.2,480
171,14,2,26,773,35,808,1.0,480
171,15,1,11,447,17,464,1.0,480
171,15,2,7,253,1,254,1.0,480
171,15,3,3,342,40,382,1.5,480
172,1,1,7,573,12,585,1.0,480
172,1,2,24,241,26,267,1.0,480
172,1,3,36,634,91,725,0.8,480
172,2,2,40,731,84,815,1.5,480
172,2,3,1,647,51,698,1.5,480
172,3,1,5,799,3,802,1.0,480
172,3,2,7,203,20,223,1.0,480
172,3,3,37,752,79,831,1.2,480
172,4,1,7,308,34,342,1.0,480
172,4,3,28,691,100,791,1.5,480
172,5,1,17,724,58,782,1.2,480
172,5,2,32,521,13,534,0.8,480
172,5,3,23,619,13,632,1.2,480
172,6,1,11,414,31,445,1.0,480
172,6,3,22,342,1,343,1.2,480
172,7,1,39,481,18,499,1.0,480
172,7,2,24,233,31,264,1.0,480
172,7,3,9,357,25,382,1.0,480
172,8,2,11,676,35,711,1.0,480
172,8,3,27,431,60,491,0.8,480
172,9,1,33,523,74,597,0.8,480
172,9,2,2,223,26,249,0.8,480
172,9,3,8,467,60,527,1.0,480
172,10,1,9,701,38,739,1.0,480
172,10,2,12,372,14,386,1.5,480
172,10,3,17,783,99,882,1.2,480
172,11,1,26,552,42,594,1.0,480
172,12,2,12,618,68,686,1.5,480
172,13,1,34,669,7,676,1.0,480
172,13,2,16,780,49,829,1.2,480
172,13,3,28,789,104,893,1.5,480
172,14,1,5,435,45,480,1.0,480
172,14,2,22,325,27,352,1.2,480
172,14,3,35,537,25,562,0.8,480
172,15,1,15,579,47,626,1.2,480
172,15,2,27,578,83,661,0.8,480
172,15,3,38,756,8,764,1.5,480
173,1,1,27,297,5,302,0.8,480
173,1,2,17,784,107,891,1.2,480
173,1,3,37,542,20,562,1.2,480
173,2,1,12,568,60,628,1.5,480
173,2,2,17,745,36,781,1.2,480
173,2,3,36,579,85,664,0.8,480
173,3,2,9,506,70,576,1.0,480
173,3,3,12,398,49,447,1.5,480
173,4,1,6,242,28,270,1.5,480
173,4,2,15,591,62,653,1.2,480
173,4,3,6,559,50,609,1.5,480
173,5,1,5,262,29,291,1.0,480
173,5,2,37,531,33,564,1.2,480
173,5,3,24,761,67,828,1.0,480
173,6,1,9,332,33,365,1.0,480
173,6,2,29,541,43,584,0.8,480
173,6,3,26,707,77,784,1.0,480
173,7,2,17,783,90,873,1.2,480
173,7,3,1,229,33,262,1.5,480
173,8,1,13,370,43,413,1.0,480
173,8,2,21,505,49,554,1.5,480
173,8,3,31,526,26,552,1.2,480
173,9,1,11,644,48,692,1.0,480
173,9,3,12,247,20,267,1.5,480
173,10,2,19,207,22,229,1.5,480
173,10,3,28,464,64,528,1.5,480
173,11,1,22,220,9,229,1.2,480
173,11,2,24,708,24,732,1.0,480
173,11,3,5,514,44,558,1.0,480
173,12,3,25,345,3,348,1.5,480
173,13,1,14,206,17,223,1.0,480
173,13,3,9,381,41,422,1.0,480
173,14,1,15,267,24,291,1.2,480
173,14,2,30,430,0,430,1.5,480
173,15,1,3,485,2,487,1.5,480
173,15,2,20,313,45,358,1.5,480
173,15,3,15,684,37,721,1.2,480
174,1,1,36,246,0,246,0.8,480
174,1,2,11,226,16,242,1.0,480
174,1,3,3,285,1,286,1.5,480
174,2,1,10,246,19,265,1.2,480
174,2,2,6,248,33,281,1.5,480
174,3,1,12,699,69,768,1.5,480
174,3,2,35,259,7,266,0.8,480
174,3,3,40,667,80,747,1.5,480
174,4,1,40,571,34,605,1.5,480
174,4,2,19,469,27,496,1.5,480
174,4,3,10,356,30,386,1.2,480
174,5,1,37,623,15,638,1.2,480
174,5,2,32,446,25,471,0.8,480
174,5,3,15,647,11,658,1.2,480
174,6,1,3,464,53,517,1.5,480
174,6,2,31,326,23,349,1.2,480
174,6,3,16,501,38,539,1.2,480
174,7,1,8,323,44,367,1.0,480
174,7,2,17,525,65,590,1.2,480
174,7,3,40,636,88,724,1.5,480
174,8,1,18,730,68,798,1.2,480
174,8,2,13,270,28,298,1.0,480
174,9,1,35,468,25,493,0.8,480
174,9,2,31,570,66,636,1.2,480
174,9,3,24,267,31,298,1.0,480
174,10,1,29,723,60,783,0.8,480
174,10,2,38,626,56,682,1.5,480
174,10,3,18,337,18,355,1.2,480
174,11,1,39,372,28,400,1.0,480
174,11,2,4,438,33,471,0.8,480
174,12,2,4,234,34,268,0.8,480
174,13,1,37,214,10,224,1.2,480
174,13,2,39,574,45,619,1.0,480
174,13,3,40,577,13,590,1.5,480
174,14,1,30,459,24,483,1.5,480
174,14,2,33,438,3,441,0.8,480
174,14,3,4,710,92,802,0.8,480
174,15,1,2,505,39,544,0.8,480
174,15,2,28,243,20,263,1.5,480
175,1,2,20,660,25,685,1.5,480
175,1,3,16,665,39,704,1.2,480
175,2,1,26,336,12,348,1.0,480
175,2,2,36,531,12,543,0.8,480
175,3,1,9,658,64,722,1.0,480
175,3,2,22,297,6,303,1.2,480
175,3,3,14,598,16,614,1.0,480
175,4,1,27,281,34,315,0.8,480
175,4,2,36,294,43,337,0.8,480
175,5,1,3,773,66,839,1.5,480
175,5,2,31,271,30,301,1.2,480
175,6,1,36,416,14,430,0.8,480
175,6,3,22,316,5,321,1.2,480
175,7,1,39,783,43,826,1.0,480
175,7,2,9,637,22,659,1.0,480
175,7,3,15,362,20,382,1.2,480
175,8,1,19,336,21,357,1.5,480
175,8,2,19,628,56,684,1.5,480
175,8,3,7,404,13,417,1.0,480
175,9,1,31,597,30,627,1.2,480
175,9,2,13,270,39,309,1.0,480
175,10,1,11,790,92,882,1.0,480
175,10,2,31,581,11,592,1.2,480
175,10,3,32,775,41,816,0.8,480
175,11,1,9,333,14,347,1.0,480
175,11,2,10,480,69,549,1.2,480
175,11,3,22,674,67,741,1.2,480
175,12,1,30,497,36,533,1.5,480
175,12,2,38,308,15,323,1.5,480
175,12,3,36,714,76,790,0.8,480
175,13,2,33,418,39,457,0.8,480
175,13,3,35,704,79,783,0.8,480
175,14,1,37,620,32,652,1.2,480
175,14,3,9,511,8,519,1.0,480
175,15,1,18,406,33,439,1.2,480
175,15,2,4,235,2,237,0.8,480
175,15,3,34,315,18,333,1.0,480
176,1,2,17,229,33,262,1.2,480
176,1,3,15,450,13,463,1.2,480
176,2,2,32,262,26,288,0.8,480
176,2,3,8,250,34,284,1.0,480
176,3,1,40,364,37,401,1.5,480
176,3,2,28,345,8,353,1.5,480
176,3,3,12,248,32,280,1.5,480
176,4,1,15,592,50,642,1.2,480
176,4,2,14,461,24,485,1.0,480
176,4,3,9,478,21,499,1.0,480
176,5,1,17,625,70,695,1.2,480
176,6,1,10,548,49,597,1.2,480
176,6,3,7,751,1,752,1.0,480
176,7,1,26,603,27,630,1.0,480
176,7,3,5,335,44,379,1.0,480
176,8,2,24,560,53,613,1.0,480
176,8,3,16,565,69,634,1.2,480
176,9,1,27,447,34,481,0.8,480
176,9,2,34,760,89,849,1.0,480
176,9,3,25,699,90,789,1.5,480
176,10,1,11,441,11,452,1.0,480
176,10,2,11,447,6,453,1.0,480
176,10,3,4,381,21,402,0.8,480
176,11,1,24,420,7,427,1.0,480
176,11,2,2,515,32,547,0.8,480
176,11,3,30,402,13,415,1.5,480
176,12,1,20,240,21,261,1.5,480
176,13,1,22,421,18,439,1.2,480
176,13,2,1,671,27,698,1.5,480
176,13,3,26,326,16,342,1.0,480
176,14,1,25,367,9,376,1.5,480
176,14,2,24,488,67,555,1.0,480
176,14,3,5,584,23,607,1.0,480
176,15,1,25,207,29,236,1.5,480
176,15,2,5,586,36,622,1.0,480
176,15,3,12,616,81,697,1.5,480
177,1,1,25,466,58,524,1.5,480
177,1,2,36,388,50,438,0.8,480
177,1,3,1,244,31,275,1.5,480
177,2,1,29,712,2,714,0.8,480
177,2,2,25,330,4,334,1.5,480
177,2,3,38,772,28,800,1.5,480
177,3,2,7,592,12,604,1.0,480
177,3,3,33,708,38,746,0.8,480
177,4,1,35,627,89,716,0.8,480
177,4,2,25,757,25,782,1.5,480
177,4,3,16,315,15,330,1.2,480
177,5,1,4,382,3,385,0.8,480
177,5,3,6,789,112,901,1.5,480
177,6,1,37,575,61,636,1.2,480
177,6,3,18,291,26,317,1.2,480
177,7,1,39,232,32,264,1.0,480
177,7,2,19,610,26,636,1.5,480
177,7,3,6,696,70,766,1.5,480
177,8,2,8,214,28,242,1.0,480
177,9,1,35,714,99,813,0.8,480
177,9,2,11,437,47,484,1.0,480
177,9,3,22,711,22,733,1.2,480
177,10,2,23,595,36,631,1.2,480
177,10,3,11,796,77,873,1.0,480
177,11,1,14,760,92,852,1.0,480
177,11,2,28,293,10,303,1.5,480
177,11,3,23,628,10,638,1.2,480
177,12,1,10,435,22,457,1.2,480
177,12,2,5,674,42,716,1.0,480
177,12,3,34,616,83,699,1.0,480
177,13,1,2,770,36,806,0.8,480
177,13,3,20,245,24,269,1.5,480
177,14,2,14,785,102,887,1.0,480
177,14,3,40,673,47,720,1.5,480
177,15,2,29,526,8,534,0.8,480
178,1,2,32,740,58,798,0.8,480
178,1,3,33,632,43,675,0.8,480
178,2,1,11,604,78,682,1.0,480
178,2,2,30,737,83,820,1.5,480
178,2,3,15,341,39,380,1.2,480
178,3,1,38,689,27,716,1.5,480
178,3,2,24,565,3,568,1.0,480
178,3,3,19,266,18,284,1.5,480
178,4,1,14,263,26,289,1.0,480
178,4,2,15,728,66,794,1.2,480
178,4,3,28,231,3,234,1.5,480
178,5,1,28,743,106,849,1.5,480
178,5,2,3,608,69,677,1.5,480
178,5,3,2,650,6,656,0.8,480
178,6,1,35,580,8,588,0.8,480
178,6,2,29,776,56,832,0.8,480
178,6,3,25,351,28,379,1.5,480
178,7,2,33,606,48,654,0.8,480
178,7,3,37,369,12,381,1.2,480
178,8,1,32,574,53,627,0.8,480
178,8,3,15,744,37,781,1.2,480
178,9,1,5,798,13,811,1.0,480
178,9,2,2,524,8,532,0.8,480
178,10,1,3,472,68,540,1.5,480
178,10,2,34,354,11,365,1.0,480
178,10,3,9,356,30,386,1.0,480
178,11,1,5,361,44,405,1.0,480
178,11,2,5,714,95,809,1.0,480
178,11,3,25,216,0,216,1.5,480
178,12,1,38,740,3,743,1.5,480
178,12,2,5,429,49,478,1.0,480
178,12,3,40,667,99,766,1.5,480
178,13,1,4,439,61,500,0.8,480
178,13,2,17,404,18,422,1.2,480
178,13,3,24,675,11,686,1.0,480
178,14,1,13,233,11,244,1.0,480
178,14,2,28,200,20,220,1.5,480
178,14,3,22,572,66,638,1.2,480
178,15,1,34,593,8,601,1.0,480
178,15,3,7,693,53,746,1.0,480
179,1,1,4,362,21,383,0.8,480
179,1,2,11,339,22,361,1.0,480
179,1,3,4,725,72,797,0.8,480
179,2,1,29,305,41,346,0.8,480
179,2,2,10,481,23,504,1.2,480
179,2,3,35,603,8,611,0.8,480
179,3,2,28,469,61,530,1.5,480
179,3,3,40,740,102,842,1.5,480
179,4,1,38,730,22,752,1.5,480
179,4,2,1,345,47,392,1.5,480
179,4,3,1,608,2,610,1.5,480
179,5,1,20,560,60,620,1.5,480
179,5,2,27,630,72,702,0.8,480
179,5,3,33,348,12,360,0.8,480
179,6,1,22,327,18,345,1.2,480
179,6,2,15,261,31,292,1.2,480
179,6,3,4,305,13,318,0.8,480
179,7,1,33,795,39,834,0.8,480
179,7,2,34,265,32,297,1.0,480
179,7,3,7,203,23,226,1.0,480
179,8,1,36,365,52,417,0.8,480
179,8,2,21,602,18,620,1.5,480
179,8,3,9,798,76,874,1.0,480
179,9,2,21,350,7,357,1.5,480
179,9,3,23,462,38,500,1.2,480
179,10,1,33,391,36,427,0.8,480
179,10,3,2,271,5,276,0.8,480
179,11,1,20,475,47,522,1.5,480
179,11,3,11,262,33,295,1.0,480
179,12,1,14,216,9,225,1.0,480
179,12,2,19,527,68,595,1.5,480
179,12,3,12,360,25,385,1.5,480
179,13,1,3,681,49,730,1.5,480
179,13,2,10,499,62,561,1.2,480
179,13,3,32,717,42,759,0.8,480
179,14,1,15,570,46,616,1.2,480
179,14,3,25,610,87,697,1.5,480
179,15,1,2,288,7,295,0.8,480
179,15,2,20,331,10,341,1.5,480
179,15,3,12,456,41,497,1.5,480
180,1,1,25,414,16,430,1.5,480
180,1,2,7,715,96,811,1.0,480
180,2,3,3,511,63,574,1.5,480
180,3,1,9,444,38,482,1.0,480
180,3,2,14,236,7,243,1.0,480
180,3,3,8,221,17,238,1.0,480
180,4,1,14,269,3,272,1.0,480
180,4,3,28,669,97,766,1.5,480
180,5,1,23,636,32,668,1.2,480
180,5,2,22,763,40,803,1.2,480
180,5,3,11,654,87,741,1.0,480
180,6,3,1,476,9,485,1.5,480
180,7,1,3,687,102,789,1.5,480
180,7,2,17,590,69,659,1.2,480
180,7,3,40,425,0,425,1.5,480
180,8,1,34,558,76,634,1.0,480
180,8,3,32,755,103,858,0.8,480
180,9,1,10,424,36,460,1.2,480
180,9,2,18,572,14,586,1.2,480
180,10,1,10,668,74,742,1.2,480
180,10,2,37,736,84,820,1.2,480
180,10,3,36,415,34,449,0.8,480
180,11,1,28,759,0,759,1.5,480
180,11,2,12,281,16,297,1.5,480
180,11,3,24,357,43,400,1.0,480
180,12,1,32,638,13,651,0.8,480
180,12,2,27,721,41,762,0.8,480
180,12,3,19,580,41,621,1.5,480
180,13,1,19,487,41,528,1.5,480
180,13,2,10,564,78,642,1.2,480
180,13,3,2,642,29,671,0.8,480
180,14,1,14,527,27,554,1.0,480
180,14,2,24,505,17,522,1.0,480
180,14,3,27,388,40,428,0.8,480
180,15,1,32,676,25,701,0.8,480
180,15,3,31,761,7,768,1.2,480
181,1,1,20,438,9,447,1.5,480
181,1,3,35,526,70,596,0.8,480
181,2,1,5,603,47,650,1.0,480
181,2,2,27,348,29,377,0.8,480
181,2,3,9,609,70,679,1.0,480
181,3,1,34,340,44,384,1.0,480
181,3,2,4,232,29,261,0.8,480
181,3,3,24,478,52,530,1.0,480
181,4,1,7,586,34,620,1.0,480
181,4,2,8,665,59,724,1.0,480
181,4,3,33,219,23,242,0.8,480
181,5,1,19,210,13,223,1.5,480
181,5,2,35,651,86,737,0.8,480
181,5,3,28,651,81,732,1.5,480
181,6,1,24,796,83,879,1.0,480
181,6,3,27,749,50,799,0.8,480
181,7,1,24,641,92,733,1.0,480
181,8,1,18,246,19,265,1.2,480
181,8,2,17,584,13,597,1.2,480
181,8,3,18,300,44,344,1.2,480
181,9,1,26,720,14,734,1.0,480
181,9,2,6,723,83,806,1.5,480
181,9,3,4,596,15,611,0.8,480
181,10,2,10,373,12,385,1.2,480
181,10,3,8,639,36,675,1.0,480
181,11,1,34,659,90,749,1.0,480
181,11,2,26,339,5,344,1.0,480
181,11,3,25,357,32,389,1.5,480
181,12,1,35,753,63,816,0.8,480
181,12,2,29,528,74,602,0.8,480
181,12,3,20,522,8,530,1.5,480
181,13,1,26,249,12,261,1.0,480
181,13,2,13,456,33,489,1.0,480
181,13,3,30,649,43,692,1.5,480
181,14,1,10,311,9,320,1.2,480
181,14,3,22,736,55,791,1.2,480
181,15,1,21,544,22,566,1.5,480
181,15,2,17,442,47,489,1.2,480
182,1,1,17,311,19,330,1.2,480
182,1,2,28,456,57,513,1.5,480
182,1,3,30,413,4,417,1.5,480
182,2,1,33,350,36,386,0.8,480
182,2,2,38,366,52,418,1.5,480
182,2,3,35,280,28,308,0.8,480
182,3,2,1,291,39,330,1.5,480
182,3,3,6,572,5,577,1.5,480
182,4,1,15,595,1,596,1.2,480
182,4,2,28,302,14,316,1.5,480
182,4,3,34,307,21,328,1.0,480
182,5,1,33,456,7,463,0.8,480
182,5,2,20,565,1,566,1.5,480
182,5,3,37,512,66,578,1.2,480
182,6,2,19,769,98,867,1.5,480
182,6,3,11,598,80,678,1.0,480
182,7,1,28,286,26,312,1.5,480
182,7,2,23,239,11,250,1.2,480
182,8,2,30,338,41,379,1.5,480
182,8,3,12,588,38,626,1.5,480
182,9,1,10,374,3,377,1.2,480
182,9,2,17,447,57,504,1.2,480
182,10,1,6,269,29,298,1.5,480
182,10,2,12,228,33,261,1.5,480
182,10,3,37,239,29,268,1.2,480
182,11,1,14,317,26,343,1.0,480
182,11,2,36,468,40,508,0.8,480
182,11,3,12,464,54,518,1.5,480
182,12,1,4,242,6,248,0.8,480
182,12,2,9,734,96,830,1.0,480
182,12,3,9,763,73,836,1.0,480
182,13,1,39,656,77,733,1.0,480
182,13,2,30,627,46,673,1.5,480
182,13,3,39,427,13,440,1.0,480
182,14,1,27,565,42,607,0.8,480
182,14,2,10,786,59,845,1.2,480
182,14,3,37,423,24,447,1.2,480
182,15,1,37,640,39,679,1.2,480
182,15,2,24,576,37,613,1.0,480
182,15,3,35,491,59,550,0.8,480
183,1,1,40,637,66,703,1.5,480
183,1,2,29,578,55,633,0.8,480
183,1,3,34,745,23,768,1.0,480
183,2,1,23,299,32,331,1.2,480
183,2,2,4,241,19,260,0.8,480
183,2,3,23,223,23,246,1.2,480
183,3,1,18,626,81,707,1.2,480
183,3,2,16,262,13,275,1.2,480
183,3,3,30,213,9,222,1.5,480
183,4,2,4,554,46,600,0.8,480
183,5,1,5,646,19,665,1.0,480
183,5,2,2,284,25,309,0.8,480
183,5,3,14,365,50,415,1.0,480
183,6,1,25,653,81,734,1.5,480
183,6,2,25,731,5,736,1.5,480
183,6,3,29,449,49,498,0.8,480
183,7,1,9,530,5,535,1.0,480
183,7,3,35,417,13,430,0.8,480
183,8,1,9,752,60,812,1.0,480
183,8,2,23,785,94,879,1.2,480
183,8,3,2,778,38,816,0.8,480
183,9,2,27,404,52,456,0.8,480
183,9,3,38,245,23,268,1.5,480
183,10,3,31,564,46,610,1.2,480
183,11,1,23,388,57,445,1.2,480
183,11,2,30,468,60,528,1.5,480
183,11,3,9,457,31,488,1.0,480
183,12,1,21,455,32,487,1.5,480
183,12,2,24,397,45,442,1.0,480
183,12,3,1,369,24,393,1.5,480
183,13,2,24,659,23,682,1.0,480
183,13,3,13,738,35,773,1.0,480
183,14,1,40,588,64,652,1.5,480
183,14,2,9,685,56,741,1.0,480
183,15,1,29,471,66,537,0.8,480
183,15,2,25,379,5,384,1.5,480
183,15,3,19,508,24,532,1.5,480
184,1,1,36,776,30,806,0.8,480
184,1,2,16,691,62,753,1.2,480
184,1,3,36,368,12,380,0.8,480
184,2,1,29,398,57,455,0.8,480
184,2,2,25,665,33,698,1.5,480
184,2,3,35,241,26,267,0.8,480
184,3,1,37,608,74,682,1.2,480
184,3,3,31,280,20,300,1.2,480
184,4,1,28,221,14,235,1.5,480
184,4,2,10,636,70,706,1.2,480
184,4,3,30,633,47,680,1.5,480
184,5,1,25,308,25,333,1.5,480
184,5,2,9,442,12,454,1.0,480
184,5,3,12,285,40,325,1.5,480
184,6,1,38,695,96,791,1.5,480
184,6,2,35,532,1,533,0.8,480
184,6,3,22,763,37,800,1.2,480
184,7,1,14,459,55,514,1.0,480
184,7,2,33,315,45,360,0.8,480
184,7,3,21,585,63,648,1.5,480
184,8,2,10,285,1,286,1.2,480
184,8,3,12,788,70,858,1.5,480
184,9,1,11,743,35,778,1.0,480
184,9,2,8,674,12,686,1.0,480
184,9,3,4,244,15,259,0.8,480
184,10,1,27,289,31,320,0.8,480
184,10,2,13,582,52,634,1.0,480
184,10,3,5,567,5,572,1.0,480
184,11,1,17,676,11,687,1.2,480
184,11,2,14,640,19,659,1.0,480
184,11,3,8,602,22,624,1.0,480
184,12,1,4,646,0,646,0.8,480
184,12,2,32,622,58,680,0.8,480
184,12,3,32,678,40,718,0.8,480
184,13,1,1,670,79,749,1.5,480
184,13,3,34,694,91,785,1.0,480
184,14,1,8,535,75,610,1.0,480
184,14,2,35,365,38,403,0.8,480
184,14,3,26,233,28,261,1.0,480
184,15,1,15,305,0,305,1.2,480
184,15,2,4,741,72,813,0.8,480
184,15,3,13,360,5,365,1.0,480
185,1,1,8,391,46,437,1.0,480
185,1,2,23,388,1,389,1.2,480
185,1,3,32,773,19,792,0.8,480
185,2,1,3,655,22,677,1.5,480
185,2,2,29,731,87,818,0.8,480
185,2,3,38,461,5,466,1.5,480
185,3,1,20,206,12,218,1.5,480
185,3,2,33,509,57,566,0.8,480
185,3,3,3,397,56,453,1.5,480
185,4,1,30,391,5,396,1.5,480
185,4,2,36,763,65,828,0.8,480
185,4,3,18,552,57,609,1.2,480
185,5,1,27,690,92,782,0.8,480
185,5,2,23,293,26,319,1.2,480
185,5,3,24,643,25,668,1.0,480
185,6,2,18,405,27,432,1.2,480
185,7,1,3,602,50,652,1.5,480
185,7,2,12,729,38,767,1.5,480
185,7,3,2,629,77,706,0.8,480
185,8,1,10,462,37,499,1.2,480
185,8,2,37,706,22,728,1.2,480
185,8,3,36,681,97,778,0.8,480
185,9,1,40,530,47,577,1.5,480
185,9,2,17,651,68,719,1.2,480
185,9,3,23,359,31,390,1.2,480
185,10,1,24,760,3,763,1.0,480
185,10,3,15,730,70,800,1.2,480
185,11,1,36,619,90,709,0.8,480
185,11,3,15,204,25,229,1.2,480
185,12,1,21,684,17,701,1.5,480
185,12,2,21,503,46,549,1.5,480
185,13,1,8,768,6,774,1.0,480
185,13,2,29,624,85,709,0.8,480
185,13,3,25,619,48,667,1.5,480
185,14,1,37,277,7,284,1.2,480
185,14,2,1,409,42,451,1.5,480
185,14,3,7,544,3,547,1.0,480
185,15,1,7,273,27,300,1.0,480
185,15,2,2,286,11,297,0.8,480
185,15,3,7,511,63,574,1.0,480
186,1,1,17,662,65,727,1.2,480
186,1,2,27,493,71,564,0.8,480
186,1,3,37,762,83,845,1.2,480
186,2,1,37,344,30,374,1.2,480
186,2,2,16,588,25,613,1.2,480
186,2,3,1,697,55,752,1.5,480
186,3,1,35,404,29,433,0.8,480
186,3,2,26,613,4,617,1.0,480
186,3,3,21,694,50,744,1.5,480
186,4,1,24,511,9,520,1.0,480
186,4,3,5,351,22,373,1.0,480
186,5,1,33,536,51,587,0.8,480
186,5,3,3,285,35,320,1.5,480
186,6,1,11,406,4,410,1.0,480
186,6,2,17,240,25,265,1.2,480
186,6,3,4,569,74,643,0.8,480
186,7,1,13,622,61,683,1.0,480
186,7,2,11,440,22,462,1.0,480
186,7,3,17,333,11,344,1.2,480
186,8,1,5,523,4,527,1.0,480
186,8,2,40,364,9,373,1.5,480
186,8,3,22,604,10,614,1.2,480
186,9,1,15,732,71,803,1.2,480
186,9,2,26,561,5,566,1.0,480
186,9,3,20,229,8,237,1.5,480
186,10,1,5,700,48,748,1.0,480
186,10,2,28,333,38,371,1.5,480
186,10,3,34,559,74,633,1.0,480
186,11,1,34,489,63,552,1.0,480
186,11,2,5,770,83,853,1.0,480
186,11,3,12,431,61,492,1.5,480
186,12,1,23,371,0,371,1.2,480
186,12,2,40,716,76,792,1.5,480
186,12,3,8,509,75,584,1.0,480
186,13,3,32,599,73,672,0.8,480
186,14,1,25,423,30,453,1.5,480
186,14,2,23,519,72,591,1.2,480
186,15,1,23,752,41,793,1.2,480
186,15,2,15,217,4,221,1.2,480
187,1,1,1,784,1,785,1.5,480
187,1,2,11,559,23,582,1.0,480
187,1,3,7,252,9,261,1.0,480
187,2,1,32,386,29,415,0.8,480
187,2,2,3,488,71,559,1.5,480
187,2,3,19,753,33,786,1.5,480
187,3,1,3,378,10,388,1.5,480
187,3,3,18,303,40,343,1.2,480
187,4,1,16,791,14,805,1.2,480
187,4,3,33,328,38,366,0.8,480
187,5,1,1,435,50,485,1.5,480
187,5,2,5,214,21,235,1.0,480
187,5,3,24,587,33,620,1.0,480
187,6,1,15,622,58,680,1.2,480
187,6,2,40,744,53,797,1.5,480
187,6,3,29,364,33,397,0.8,480
187,7,1,19,412,19,431,1.5,480
187,7,2,25,360,53,413,1.5,480
187,7,3,5,660,7,667,1.0,480
187,8,2,30,506,19,525,1.5,480
187,8,3,23,509,15,524,1.2,480
187,9,1,7,205,1,206,1.0,480
187,9,2,1,414,61,475,1.5,480
187,9,3,13,519,30,549,1.0,480
187,10,1,22,597,24,621,1.2,480
187,10,2,2,517,76,593,0.8,480
187,10,3,2,278,4,282,0.8,480
187,11,2,38,252,0,252,1.5,480
187,11,3,8,431,26,457,1.0,480
187,12,1,8,350,14,364,1.0,480
187,12,2,34,347,28,375,1.0,480
187,12,3,37,314,0,314,1.2,480
187,13,1,3,333,22,355,1.5,480
187,13,3,2,702,73,775,0.8,480
187,14,1,31,685,78,763,1.2,480
187,14,2,34,672,24,696,1.0,480
187,14,3,11,551,38,589,1.0,480
187,15,2,17,215,16,231,1.2,480
187,15,3,5,360,9,369,1.0,480
188,1,1,3,449,19,468,1.5,480
188,1,3,8,579,12,591,1.0,480
188,2,1,35,607,81,688,0.8,480
188,2,2,28,311,44,355,1.5,480
188,2,3,9,795,53,848,1.0,480
188,3,1,4,688,102,790,0.8,480
188,3,2,12,428,58,486,1.5,480
188,3,3,13,401,53,454,1.0,480
188,4,1,23,380,17,397,1.2,480
188,4,2,14,329,7,336,1.0,480
188,4,3,27,570,19,589,0.8,480
188,5,1,21,357,46,403,1.5,480
188,5,2,32,304,5,309,0.8,480
188,6,1,32,257,25,282,0.8,480
188,6,2,20,773,58,831,1.5,480
188,6,3,30,751,78,829,1.5,480
188,7,1,18,654,53,707,1.2,480
188,7,3,34,622,53,675,1.0,480
188,8,2,13,315,1,316,1.0,480
188,8,3,37,622,85,707,1.2,480
188,9,1,17,380,42,422,1.2,480
188,9,2,20,442,29,471,1.5,480
188,9,3,40,763,100,863,1.5,480
188,10,1,37,334,23,357,1.2,480
188,10,2,36,783,1,784,0.8,480
188,10,3,8,521,43,564,1.0,480
188,11,2,33,432,8,440,0.8,480
188,11,3,25,713,54,767,1.5,480
188,12,1,30,222,17,239,1.5,480
188,12,2,12,243,30,273,1.5,480
188,12,3,18,341,14,355,1.2,480
188,13,1,40,730,50,780,1.5,480
188,13,2,7,418,41,459,1.0,480
188,13,3,32,734,64,798,0.8,480
188,14,3,10,550,34,584,1.2,480
188,15,2,3,777,18,795,1.5,480
188,15,3,6,602,15,617,1.5,480
189,1,1,25,460,55,515,1.5,480
189,1,2,19,597,18,615,1.5,480
189,1,3,8,563,74,637,1.0,480
189,2,1,2,203,17,220,0.8,480
189,2,2,28,318,22,340,1.5,480
189,3,1,3,440,36,476,1.5,480
189,3,2,36,213,14,227,0.8,480
189,3,3,40,225,14,239,1.5,480
189,4,1,15,392,40,432,1.2,480
189,4,2,5,631,39,670,1.0,480
189,4,3,18,278,31,309,1.2,480
189,5,2,35,617,13,630,0.8,480
189,5,3,17,400,29,429,1.2,480
189,6,1,11,458,12,470,1.0,480
189,6,3,29,329,8,337,0.8,480
189,7,1,40,767,87,854,1.5,480
189,7,2,19,462,50,512,1.5,480
189,7,3,27,626,67,693,0.8,480
189,8,1,27,276,9,285,0.8,480
189,8,2,16,459,48,507,1.2,480
189,8,3,21,219,8,227,1.5,480
189,9,1,23,740,4,744,1.2,480
189,9,2,17,474,63,537,1.2,480
189,9,3,8,470,12,482,1.0,480
189,10,1,20,667,2,669,1.5,480
189,10,2,39,420,8,428,1.0,480
189,11,1,9,613,77,690,1.0,480
189,11,3,1,766,6,772,1.5,480
189,12,1,7,286,26,312,1.0,480
189,12,2,26,502,22,524,1.0,480
189,12,3,13,365,8,373,1.0,480
189,13,1,33,273,0,273,0.8,480
189,14,1,5,588,6,594,1.0,480
189,14,2,4,522,4,526,0.8,480
189,14,3,14,764,56,820,1.0,480
189,15,1,6,246,21,267,1.5,480
189,15,2,24,776,66,842,1.0,480
189,15,3,21,542,62,604,1.5,480
190,1,1,35,304,25,329,0.8,480
190,1,2,15,437,32,469,1.2,480
190,1,3,1,202,26,228,1.5,480
190,2,1,4,354,51,405,0.8,480
190,2,2,9,343,0,343,1.0,480
190,2,3,19,385,50,435,1.5,480
190,3,1,23,614,68,682,1.2,480
190,3,2,6,384,45,429,1.5,480
190,3,3,20,286,8,294,1.5,480
190,4,2,35,378,33,411,0.8,480
190,4,3,26,411,2,413,1.0,480
190,5,1,18,514,41,555,1.2,480
190,5,2,22,558,42,600,1.2,480
190,5,3,33,473,5,478,0.8,480
190,6,1,8,434,50,484,1.0,480
190,6,2,38,265,30,295,1.5,480
190,6,3,17,279,5,284,1.2,480
190,7,1,37,755,97,852,1.2,480
190,7,2,3,492,2,494,1.5,480
190,7,3,34,360,17,377,1.0,480
190,8,1,37,425,3,428,1.2,480
190,8,2,9,296,35,331,1.0,480
190,8,3,23,624,75,699,1.2,480
190,9,1,37,744,16,760,1.2,480
190,9,2,34,467,13,480,1.0,480
190,10,1,36,604,80,684,0.8,480
190,10,2,28,594,22,616,1.5,480
190,10,3,10,339,47,386,1.2,480
190,11,1,30,747,44,791,1.5,480
190,11,2,28,541,28,569,1.5,480
190,11,3,31,379,22,401,1.2,480
190,12,1,27,663,89,752,0.8,480
190,12,2,40,278,4,282,1.5,480
190,12,3,4,602,64,666,0.8,480
190,13,1,33,583,11,594,0.8,480
190,13,2,37,587,18,605,1.2,480
190,13,3,39,703,75,778,1.0,480
190,14,1,22,307,27,334,1.2,480
190,14,2,35,595,78,673,0.8,480
190,14,3,10,723,33,756,1.2,480
190,15,1,6,757,42,799,1.5,480
190,15,2,14,298,4,302,1.0,480
190,15,3,2,246,17,263,0.8,480
191,1,2,21,372,15,387,1.5,480
191,2,1,9,580,19,599,1.0,480
191,2,2,29,286,40,326,0.8,480
191,3,1,17,231,6,237,1.2,480
191,3,2,30,414,43,457,1.5,480
191,3,3,27,475,2,477,0.8,480
191,4,1,18,241,19,260,1.2,480
191,4,2,17,468,32,500,1.2,480
191,4,3,40,267,31,298,1.5,480
191,5,1,30,311,25,336,1.5,480
191,5,2,27,244,17,261,0.8,480
191,5,3,39,798,0,798,1.0,480
191,6,1,38,510,36,546,1.5,480
191,6,2,3,546,70,616,1.5,480
191,6,3,26,760,16,776,1.0,480
191,7,2,10,760,15,775,1.2,480
191,7,3,9,764,95,859,1.0,480
191,8,1,20,262,15,277,1.5,480
191,8,2,28,638,38,676,1.5,480
191,8,3,14,704,93,797,1.0,480
191,9,1,1,635,59,694,1.5,480
191,9,2,8,319,39,358,1.0,480
191,9,3,14,444,53,497,1.0,480
191,10,1,32,505,72,577,0.8,480
191,10,3,13,332,17,349,1.0,480
191,11,1,28,490,6,496,1.5,480
191,11,2,2,577,12,589,0.8,480
191,11,3,10,795,76,871,1.2,480
191,12,1,34,437,42,479,1.0,480
191,12,2,1,732,88,820,1.5,480
191,12,3,26,358,15,373,1.0,480
191,13,1,6,649,45,694,1.5,480
191,13,2,32,274,39,313,0.8,480
191,13,3,23,742,82,824,1.2,480
191,14,2,3,603,8,611,1.5,480
191,14,3,21,343,31,374,1.5,480
191,15,1,37,231,11,242,1.2,480
191,15,2,2,631,46,677,0.8,480
191,15,3,16,323,30,353,1.2,480
192,1,1,29,724,9,733,0.8,480
192,1,2,4,660,76,736,0.8,480
192,1,3,1,679,100,779,1.5,480
192,2,1,36,264,7,271,0.8,480
192,2,2,3,528,51,579,1.5,480
192,3,1,40,541,50,591,1.5,480
192,3,2,26,582,55,637,1.0,480
192,4,2,1,707,15,722,1.5,480
192,4,3,33,719,5,724,0.8,480
192,5,1,13,321,41,362,1.0,480
192,5,2,8,380,20,400,1.0,480
192,6,1,25,363,44,407,1.5,480
192,6,3,18,604,55,659,1.2,480
192,7,2,23,746,2,748,1.2,480
192,7,3,16,664,90,754,1.2,480
192,8,1,25,533,24,557,1.5,480
192,8,2,36,290,20,310,0.8,480
192,9,1,2,387,6,393,0.8,480
192,9,2,11,709,84,793,1.0,480
192,9,3,34,798,91,889,1.0,480
192,10,1,13,311,0,311,1.0,480
192,10,2,23,474,55,529,1.2,480
192,11,2,7,414,34,448,1.0,480
192,11,3,14,342,23,365,1.0,480
192,12,1,23,228,15,243,1.2,480
192,12,2,5,639,24,663,1.0,480
192,12,3,30,516,65,581,1.5,480
192,13,2,7,694,3,697,1.0,480
192,14,1,1,299,27,326,1.5,480
192,14,2,32,363,26,389,0.8,480
192,14,3,39,795,39,834,1.0,480
192,15,3,39,741,5,746,1.0,480
193,1,1,29,609,4,613,0.8,480
193,1,2,2,359,2,361,0.8,480
193,1,3,29,605,40,645,0.8,480
193,2,1,10,251,36,287,1.2,480
193,2,2,24,361,40,401,1.0,480
193,2,3,27,464,36,500,0.8,480
193,3,1,10,355,35,390,1.2,480
193,3,2,33,626,14,640,0.8,480
193,3,3,21,649,2,651,1.5,480
193,5,2,37,752,70,822,1.2,480
193,5,3,15,798,68,866,1.2,480
193,6,1,9,608,69,677,1.0,480
193,6,2,20,225,1,226,1.5,480
193,7,1,22,203,23,226,1.2,480
193,7,2,22,669,74,743,1.2,480
193,7,3,14,464,51,515,1.0,480
193,8,1,27,459,31,490,0.8,480
193,8,2,15,703,92,795,1.2,480
193,8,3,11,662,29,691,1.0,480
193,9,1,39,414,44,458,1.0,480
193,9,2,20,498,39,537,1.5,480
193,9,3,28,339,30,369,1.5,480
193,10,1,32,758,74,832,0.8,480
193,10,2,8,388,22,410,1.0,480
193,10,3,24,797,98,895,1.0,480
193,11,1,31,228,3,231,1.2,480
193,11,2,35,467,4,471,0.8,480
193,11,3,12,788,100,888,1.5,480
193,12,2,9,652,43,695,1.0,480
193,12,3,34,730,107,837,1.0,480
193,13,1,27,261,26,287,0.8,480
193,13,2,18,655,74,729,1.2,480
193,13,3,18,226,25,251,1.2,480
193,14,1,10,774,105,879,1.2,480
193,14,2,20,720,60,780,1.5,480
193,15,1,8,683,81,764,1.0,480
194,1,1,28,729,40,769,1.5,480
194,1,2,30,419,12,431,1.5,480
194,1,3,39,618,0,618,1.0,480
194,2,1,6,369,30,399,1.5,480
194,2,2,4,698,42,740,0.8,480
194,3,1,19,200,8,208,1.5,480
194,3,2,14,377,47,424,1.0,480
194,3,3,38,394,31,425,1.5,480
194,4,2,22,505,24,529,1.2,480
194,5,1,18,426,23,449,1.2,480
194,5,2,20,376,28,404,1.5,480
194,5,3,32,575,73,648,0.8,480
194,6,1,15,344,21,365,1.2,480
194,6,2,5,201,17,218,1.0,480
194,6,3,21,764,27,791,1.5,480
194,7,1,8,467,17,484,1.0,480
194,7,2,35,272,6,278,0.8,480
194,7,3,32,438,9,447,0.8,480
194,8,1,15,450,2,452,1.2,480
194,8,2,13,290,7,297,1.0,480
194,8,3,22,755,110,865,1.2,480
194,9,1,14,458,12,470,1.0,480
194,9,3,19,325,45,370,1.5,480
194,10,1,24,403,2,405,1.0,480
194,10,2,9,328,16,344,1.0,480
194,10,3,17,770,56,826,1.2,480
194,11,1,18,603,40,643,1.2,480
194,11,2,9,361,27,388,1.0,480
194,11,3,8,796,5,801,1.0,480
194,12,1,10,594,75,669,1.2,480
194,12,2,34,422,7,429,1.0,480
194,13,1,31,380,45,425,1.2,480
194,14,1,32,230,7,237,0.8,480
194,14,2,21,574,20,594,1.5,480
194,14,3,34,219,6,225,1.0,480
194,15,1,35,294,2,296,0.8,480
194,15,2,12,734,92,826,1.5,480
194,15,3,8,299,14,313,1.0,480
195,1,1,7,312,21,333,1.0,480
195,1,2,10,235,21,256,1.2,480
195,1,3,33,787,90,877,0.8,480
195,2,1,14,229,21,250,1.0,480
195,2,3,35,713,41,754,0.8,480
195,3,1,17,204,22,226,1.2,480
195,3,2,15,465,39,504,1.2,480
195,3,3,5,314,3,317,1.0,480
195,4,1,29,336,45,381,0.8,480
195,4,2,22,235,0,235,1.2,480
195,5,1,27,641,14,655,0.8,480
195,5,2,37,557,27,584,1.2,480
195,5,3,35,379,18,397,0.8,480
195,6,1,19,390,12,402,1.5,480
195,6,2,3,666,91,757,1.5,480
195,6,3,16,442,19,461,1.2,480
195,7,1,37,776,67,843,1.2,480
195,7,2,35,534,9,543,0.8,480
195,7,3,1,491,34,525,1.5,480
195,8,2,13,388,24,412,1.0,480
195,9,1,10,523,11,534,1.2,480
195,9,2,1,288,35,323,1.5,480
195,9,3,38,300,36,336,1.5,480
195,10,1,25,233,17,250,1.5,480
195,10,2,1,674,75,749,1.5,480
195,10,3,14,219,12,231,1.0,480
195,11,1,19,599,63,662,1.5,480
195,11,2,31,241,33,274,1.2,480
195,12,2,16,768,36,804,1.2,480
195,12,3,12,439,26,465,1.5,480
195,13,1,38,783,38,821,1.5,480
195,13,2,22,246,4,250,1.2,480
195,13,3,23,368,9,377,1.2,480
195,14,1,18,653,63,716,1.2,480
195,14,2,21,542,80,622,1.5,480
195,14,3,18,330,43,373,1.2,480
195,15,1,3,563,75,638,1.5,480
195,15,2,24,494,61,555,1.0,480
195,15,3,36,705,92,797,0.8,480
196,1,1,3,781,36,817,1.5,480
196,1,2,19,773,95,868,1.5,480
196,2,1,27,403,20,423,0.8,480
196,2,2,17,265,0,265,1.2,480
196,2,3,25,358,29,387,1.5,480
196,3,1,31,381,0,381,1.2,480
196,3,2,36,383,13,396,0.8,480
196,3,3,15,617,58,675,1.2,480
196,4,1,37,608,21,629,1.2,480
196,4,2,26,399,32,431,1.0,480
196,4,3,17,223,2,225,1.2,480
196,5,1,11,645,61,706,1.0,480
196,5,2,8,744,9,753,1.0,480
196,5,3,37,553,36,589,1.2,480
196,6,1,38,360,35,395,1.5,480
196,6,2,13,689,61,750,1.0,480
196,6,3,21,530,0,530,1.5,480
196,7,2,11,750,17,767,1.0,480
196,7,3,6,466,47,513,1.5,480
196,8,1,27,536,40,576,0.8,480
196,8,2,39,499,18,517,1.0,480
196,8,3,5,514,31,545,1.0,480
196,9,1,14,268,38,306,1.0,480
196,9,2,36,764,50,814,0.8,480
196,9,3,32,451,24,475,0.8,480
196,10,1,34,284,24,308,1.0,480
196,10,2,1,695,22,717,1.5,480
196,10,3,6,383,52,435,1.5,480
196,11,1,14,770,99,869,1.0,480
196,11,3,32,291,27,318,0.8,480
196,12,2,15,279,32,311,1.2,480
196,12,3,30,662,95,757,1.5,480
196,13,1,32,347,42,389,0.8,480
196,13,2,40,702,39,741,1.5,480
196,13,3,36,576,41,617,0.8,480
196,14,2,22,397,53,450,1.2,480
196,14,3,34,668,80,748,1.0,480
196,15,1,40,798,60,858,1.5,480
196,15,2,7,774,47,821,1.0,480
196,15,3,18,708,61,769,1.2,480
197,1,1,40,736,2,738,1.5,480
197,1,2,16,769,73,842,1.2,480
197,1,3,21,258,4,262,1.5,480
197,2,1,33,252,6,258,0.8,480
197,2,2,33,453,42,495,0.8,480
197,2,3,40,477,51,528,1.5,480
197,3,1,32,589,59,648,0.8,480
197,3,2,2,778,29,807,0.8,480
197,3,3,20,750,30,780,1.5,480
197,4,1,20,232,6,238,1.5,480
197,4,3,3,294,6,300,1.5,480
197,5,2,2,697,83,780,0.8,480
197,6,1,32,345,12,357,0.8,480
197,6,3,26,359,25,384,1.0,480
197,7,1,11,401,33,434,1.0,480
197,7,3,20,317,21,338,1.5,480
197,8,1,30,638,29,667,1.5,480
197,8,2,1,536,2,538,1.5,480
197,9,1,21,319,7,326,1.5,480
197,9,2,11,595,38,633,1.0,480
197,10,1,16,314,9,323,1.2,480
197,10,2,17,622,77,699,1.2,480
197,10,3,23,457,61,518,1.2,480
197,11,2,2,378,0,378,0.8,480
197,11,3,3,624,61,685,1.5,480
197,12,2,10,341,32,373,1.2,480
197,13,1,38,695,90,785,1.5,480
197,13,2,9,267,1,268,1.0,480
197,13,3,31,381,18,399,1.2,480
197,14,1,25,458,13,471,1.5,480
197,14,2,36,462,16,478,0.8,480
197,14,3,22,710,103,813,1.2,480
197,15,1,16,634,92,726,1.2,480
197,15,2,2,332,34,366,0.8,480
198,1,3,28,278,14,292,1.5,480
198,2,1,8,662,73,735,1.0,480
198,2,2,35,374,18,392,0.8,480
198,3,1,28,675,78,753,1.5,480
198,3,3,17,665,72,737,1.2,480
198,4,2,24,709,54,763,1.0,480
198,4,3,13,214,16,230,1.0,480
198,5,1,6,675,46,721,1.5,480
198,5,2,3,554,23,577,1.5,480
198,6,2,16,421,55,476,1.2,480
198,6,3,8,525,6,531,1.0,480
198,7,2,36,321,5,326,0.8,480
198,7,3,4,388,2,390,0.8,480
198,8,1,30,694,84,778,1.5,480
198,8,2,37,704,11,715,1.2,480
198,8,3,25,212,29,241,1.5,480
198,9,1,33,592,26,618,0.8,480
198,10,2,23,401,7,408,1.2,480
198,11,1,4,753,92,845,0.8,480
198,11,3,30,709,18,727,1.5,480
198,12,2,18,394,55,449,1.2,480
198,12,3,27,719,98,817,0.8,480
198,13,1,16,731,3,734,1.2,480
198,13,2,28,260,12,272,1.5,480
198,13,3,10,724,69,793,1.2,480
198,14,1,17,570,14,584,1.2,480
198,14,2,11,754,86,840,1.0,480
198,14,3,28,723,101,824,1.5,480
198,15,1,37,786,22,808,1.2,480
198,15,2,5,469,65,534,1.0,480
198,15,3,12,396,27,423,1.5,480
199,1,1,23,407,21,428,1.2,480
199,1,2,32,575,73,648,0.8,480
199,1,3,6,709,45,754,1.5,480
199,2,1,33,643,28,671,0.8,480
199,2,3,2,576,77,653,0.8,480
199,3,1,37,650,6,656,1.2,480
199,3,2,31,517,6,523,1.2,480
199,4,1,38,510,8,518,1.5,480
199,4,2,9,451,63,514,1.0,480
199,4,3,31,328,7,335,1.2,480
199,5,1,27,313,37,350,0.8,480
199,5,2,32,578,64,642,0.8,480
199,5,3,11,799,37,836,1.0,480
199,6,1,18,468,55,523,1.2,480
199,6,2,25,763,20,783,1.5,480
199,6,3,7,625,88,713,1.0,480
199,7,1,4,687,11,698,0.8,480
199,7,2,6,486,70,556,1.5,480
199,7,3,39,581,42,623,1.0,480
199,8,2,24,250,9,259,1.0,480
199,8,3,8,686,84,770,1.0,480
199,9,1,11,405,12,417,1.0,480
199,9,2,8,260,0,260,1.0,480
199,10,2,24,462,0,462,1.0,480
199,10,3,22,675,56,731,1.2,480
199,11,1,33,460,44,504,0.8,480
199,11,2,25,390,20,410,1.5,480
199,12,1,22,373,39,412,1.2,480
199,12,3,22,746,11,757,1.2,480
199,13,1,16,633,39,672,1.2,480
199,13,2,37,563,1,564,1.2,480
199,13,3,3,536,10,546,1.5,480
199,14,1,3,326,47,373,1.5,480
199,14,2,26,680,88,768,1.0,480
200,1,1,1,436,15,451,1.5,480
200,1,2,18,345,8,353,1.2,480
200,2,1,28,728,2,730,1.5,480
200,2,2,36,720,39,759,0.8,480
200,2,3,28,461,10,471,1.5,480
200,3,1,40,786,62,848,1.5,480
200,3,2,20,689,16,705,1.5,480
200,3,3,34,502,47,549,1.0,480
200,4,2,16,499,1,500,1.2,480
200,4,3,18,713,53,766,1.2,480
200,5,1,27,503,61,564,0.8,480
200,5,3,18,604,81,685,1.2,480
200,6,1,8,752,16,768,1.0,480
200,6,3,38,694,70,764,1.5,480
200,7,1,29,771,49,820,0.8,480
200,7,2,35,591,71,662,0.8,480
200,7,3,9,237,14,251,1.0,480
200,8,1,13,665,63,728,1.0,480
200,8,3,39,269,6,275,1.0,480
200,9,1,3,551,79,630,1.5,480
200,9,3,36,398,19,417,0.8,480
200,10,1,36,380,27,407,0.8,480
200,10,2,36,794,1,795,0.8,480
200,11,1,14,419,59,478,1.0,480
200,11,2,39,394,17,411,1.0,480
200,11,3,22,303,17,320,1.2,480
200,12,1,13,214,17,231,1.0,480
200,12,3,22,560,22,582,1.2,480
200,13,1,25,318,29,347,1.5,480
200,13,3,18,297,36,333,1.2,480
200,14,3,22,633,52,685,1.2,480
200,15,1,15,267,25,292,1.2,480
200,15,2,28,358,31,389,1.5,480
201,1,1,13,400,20,420,1.0,480
201,1,2,15,250,31,281,1.2,480
201,1,3,13,745,62,807,1.0,480
201,2,1,22,245,4,249,1.2,480
201,2,2,18,331,47,378,1.2,480
201,2,3,20,391,26,417,1.5,480
201,3,1,11,405,16,421,1.0,480
201,3,2,33,562,25,587,0.8,480
201,3,3,23,241,35,276,1.2,480
201,4,1,15,707,105,812,1.2,480
201,4,2,28,289,29,318,1.5,480
201,4,3,34,761,44,805,1.0,480
201,5,3,25,333,13,346,1.5,480
201,6,1,1,708,63,771,1.5,480
201,6,2,6,650,21,671,1.5,480
201,6,3,33,384,29,413,0.8,480
201,7,2,5,302,41,343,1.0,480
201,7,3,18,588,73,661,1.2,480
201,8,2,23,397,13,410,1.2,480
201,8,3,17,795,15,810,1.2,480
201,9,1,9,785,32,817,1.0,480
201,9,2,23,702,20,722,1.2,480
201,9,3,18,703,93,796,1.2,480
201,10,1,3,770,106,876,1.5,480
201,10,2,7,239,4,243,1.0,480
201,10,3,11,469,63,532,1.0,480
201,11,1,36,387,46,433,0.8,480
201,11,2,40,248,10,258,1.5,480
201,11,3,25,674,77,751,1.5,480
201,12,1,38,425,53,478,1.5,480
201,12,2,8,700,96,796,1.0,480
201,13,1,9,321,41,362,1.0,480
201,13,2,35,693,51,744,0.8,480
201,13,3,31,654,41,695,1.2,480
201,14,1,39,703,20,723,1.0,480
201,14,2,7,313,13,326,1.0,480
201,14,3,6,210,13,223,1.5,480
201,15,1,30,774,27,801,1.5,480
201,15,2,40,624,28,652,1.5,480
201,15,3,24,754,106,860,1.0,480
202,1,2,33,419,20,439,0.8,480
202,1,3,8,341,10,351,1.0,480
202,2,1,39,528,46,574,1.0,480
202,2,2,17,224,28,252,1.2,480
202,3,1,12,251,10,261,1.5,480
202,3,2,11,328,29,357,1.0,480
202,3,3,31,539,71,610,1.2,480
202,4,1,2,285,15,300,0.8,480
202,4,2,28,522,71,593,1.5,480
202,5,2,3,640,45,685,1.5,480
202,5,3,32,601,21,622,0.8,480
202,6,1,23,477,44,521,1.2,480
202,6,2,6,608,19,627,1.5,480
202,6,3,10,590,37,627,1.2,480
202,7,1,15,359,0,359,1.2,480
202,7,3,28,388,55,443,1.5,480
202,8,3,17,263,25,288,1.2,480
202,9,1,26,633,17,650,1.0,480
202,9,2,31,670,14,684,1.2,480
202,9,3,20,697,36,733,1.5,480
202,10,1,19,484,60,544,1.5,480
202,10,2,6,304,43,347,1.5,480
202,10,3,40,519,74,593,1.5,480
202,11,1,37,657,42,699,1.2,480
202,11,2,36,652,63,715,0.8,480
202,12,1,2,469,47,516,0.8,480
202,12,2,10,664,55,719,1.2,480
202,12,3,13,244,31,275,1.0,480
202,13,1,2,744,95,839,0.8,480
202,13,2,8,237,24,261,1.0,480
202,13,3,3,492,13,505,1.5,480
202,14,1,3,316,41,357,1.5,480
202,14,2,37,444,50,494,1.2,480
202,14,3,8,204,1,205,1.0,480
202,15,1,7,268,13,281,1.0,480
202,15,2,33,311,44,355,0.8,480
202,15,3,18,217,24,241,1.2,480
203,1,2,16,376,46,422,1.2,480
203,1,3,9,566,56,622,1.0,480
203,2,1,23,321,18,339,1.2,480
203,2,2,4,512,58,570,0.8,480
203,2,3,32,483,46,529,0.8,480
203,3,1,31,399,35,434,1.2,480
203,3,3,15,517,56,573,1.2,480
203,4,2,40,544,40,584,1.5,480
203,4,3,23,473,8,481,1.2,480
203,5,1,12,236,8,244,1.5,480
203,5,3,28,597,16,613,1.5,480
203,6,1,2,649,96,745,0.8,480
203,6,2,24,255,30,285,1.0,480
203,7,1,28,344,31,375,1.5,480
203,7,2,35,676,18,694,0.8,480
203,7,3,25,508,71,579,1.5,480
203,8,1,4,679,49,728,0.8,480
203,8,2,18,613,85,698,1.2,480
203,8,3,40,727,106,833,1.5,480
203,9,1,19,589,52,641,1.5,480
203,9,2,2,214,15,229,0.8,480
203,9,3,40,374,25,399,1.5,480
203,10,1,34,549,41,590,1.0,480
203,10,3,19,320,34,354,1.5,480
203,11,1,1,661,21,682,1.5,480
203,11,2,29,453,27,480,0.8,480
203,11,3,5,740,71,811,1.0,480
203,12,1,7,303,20,323,1.0,480
203,12,2,9,344,26,370,1.0,480
203,12,3,20,677,59,736,1.5,480
203,13,1,8,699,12,711,1.0,480
203,13,2,34,535,69,604,1.0,480
203,13,3,4,412,35,447,0.8,480
203,14,2,24,516,61,577,1.0,480
203,14,3,21,599,27,626,1.5,480
203,15,1,23,611,40,651,1.2,480
203,15,2,37,209,16,225,1.2,480
203,15,3,4,421,26,447,0.8,480
204,1,1,9,578,35,613,1.0,480
204,1,2,39,439,21,460,1.0,480
204,1,3,27,514,42,556,0.8,480
204,2,1,3,238,12,250,1.5,480
204,2,2,16,589,37,626,1.2,480
204,2,3,38,496,34,530,1.5,480
204,3,3,2,695,75,770,0.8,480
204,4,1,2,767,34,801,0.8,480
204,4,2,25,579,16,595,1.5,480
204,5,1,17,381,3,384,1.2,480
204,5,3,20,710,15,725,1.5,480
204,6,1,13,233,25,258,1.0,480
204,6,3,9,608,73,681,1.0,480
204,7,1,16,725,52,777,1.2,480
204,7,2,9,733,30,763,1.0,480
204,7,3,34,450,4,454,1.0,480
204,8,1,14,287,7,294,1.0,480
204,8,2,9,594,25,619,1.0,480
204,8,3,30,634,61,695,1.5,480
204,9,1,24,356,35,391,1.0,480
204,9,2,25,201,19,220,1.5,480
204,9,3,35,318,23,341,0.8,480
204,10,1,1,234,0,234,1.5,480
204,10,2,6,306,41,347,1.5,480
204,11,2,38,450,22,472,1.5,480
204,11,3,22,353,7,360,1.2,480
204,12,1,23,266,15,281,1.2,480
204,12,2,19,565,2,567,1.5,480
204,12,3,19,431,20,451,1.5,480
204,13,1,20,244,31,275,1.5,480
204,13,2,24,307,12,319,1.0,480
204,14,1,26,790,55,845,1.0,480
204,14,2,38,205,18,223,1.5,480
204,14,3,38,260,27,287,1.5,480
204,15,1,31,619,52,671,1.2,480
204,15,2,29,239,28,267,0.8,480
205,1,1,23,222,10,232,1.2,480
205,1,2,12,537,71,608,1.5,480
205,2,1,21,567,5,572,1.5,480
205,2,2,9,600,18,618,1.0,480
205,2,3,16,257,10,267,1.2,480
205,3,1,32,722,85,807,0.8,480
205,3,2,9,599,49,648,1.0,480
205,4,1,13,381,6,387,1.0,480
205,4,2,1,258,19,277,1.5,480
205,4,3,28,522,18,540,1.5,480
205,5,1,31,266,4,270,1.2,480
205,5,3,40,607,61,668,1.5,480
205,6,1,37,381,43,424,1.2,480
205,6,3,14,772,103,875,1.0,480
205,7,1,27,530,6,536,0.8,480
205,7,2,21,269,7,276,1.5,480
205,7,3,22,266,38,304,1.2,480
205,8,1,18,487,70,557,1.2,480
205,8,2,9,410,5,415,1.0,480
205,9,1,38,787,9,796,1.5,480
205,9,2,20,415,15,430,1.5,480
205,9,3,34,369,16,385,1.0,480
205,10,1,8,225,32,257,1.0,480
205,10,2,7,587,62,649,1.0,480
205,10,3,22,689,54,743,1.2,480
205,11,1,38,718,20,738,1.5,480
205,11,2,37,777,19,796,1.2,480
205,11,3,5,356,1,357,1.0,480
205,12,2,22,594,41,635,1.2,480
205,12,3,25,665,11,676,1.5,480
205,13,1,38,532,50,582,1.5,480
205,13,2,23,658,92,750,1.2,480
205,13,3,29,453,24,477,0.8,480
205,14,1,2,403,58,461,0.8,480
205,14,2,4,213,4,217,0.8,480
205,15,1,30,676,85,761,1.5,480
205,15,3,20,261,35,296,1.5,480
206,1,2,15,235,10,245,1.2,480
206,1,3,37,699,17,716,1.2,480
206,2,1,25,274,13,287,1.5,480
206,2,2,32,660,8,668,0.8,480
206,2,3,21,413,1,414,1.5,480
206,3,1,21,540,69,609,1.5,480
206,3,2,24,527,32,559,1.0,480
206,3,3,31,294,7,301,1.2,480
206,4,1,14,561,24,585,1.0,480
206,4,3,15,297,36,333,1.2,480
206,5,1,19,201,3,204,1.5,480
206,5,2,23,302,12,314,1.2,480
206,6,1,8,239,15,254,1.0,480
206,6,2,22,242,7,249,1.2,480
206,6,3,14,443,31,474,1.0,480
206,7,1,27,507,36,543,0.8,480
206,7,2,21,624,4,628,1.5,480
206,7,3,28,515,20,535,1.5,480
206,8,1,21,658,91,749,1.5,480
206,8,2,27,494,0,494,0.8,480
206,8,3,9,708,61,769,1.0,480
206,9,1,30,604,82,686,1.5,480
206,9,2,31,259,3,262,1.2,480
206,9,3,27,663,13,676,0.8,480
206,10,2,9,455,4,459,1.0,480
206,10,3,17,799,39,838,1.2,480
206,11,2,40,451,58,509,1.5,480
206,11,3,9,723,106,829,1.0,480
206,12,1,21,215,1,216,1.5,480
206,12,2,11,601,85,686,1.0,480
206,12,3,8,796,29,825,1.0,480
206,13,1,35,405,7,412,0.8,480
206,13,2,7,688,68,756,1.0,480
206,13,3,23,253,28,281,1.2,480
206,14,1,13,371,34,405,1.0,480
206,14,3,19,467,58,525,1.5,480
206,15,1,20,768,113,881,1.5,480
206,15,2,40,270,24,294,1.5,480
206,15,3,3,277,27,304,1.5,480
207,1,1,5,454,17,471,1.0,480
207,1,2,10,348,12,360,1.2,480
207,1,3,25,604,52,656,1.5,480
207,2,1,1,628,43,671,1.5,480
207,2,2,2,313,37,350,0.8,480
207,2,3,39,347,16,363,1.0,480
207,3,1,1,328,27,355,1.5,480
207,3,2,38,670,58,728,1.5,480
207,3,3,9,746,9,755,1.0,480
207,4,1,38,548,54,602,1.5,480
207,4,2,25,596,35,631,1.5,480
207,4,3,10,536,61,597,1.2,480
207,5,2,22,670,59,729,1.2,480
207,5,3,38,404,52,456,1.5,480
207,6,1,3,509,66,575,1.5,480
207,6,2,3,735,43,778,1.5,480
207,6,3,39,335,6,341,1.0,480
207,7,2,40,702,11,713,1.5,480
207,7,3,22,317,33,350,1.2,480
207,8,1,31,507,45,552,1.2,480
207,8,2,18,776,70,846,1.2,480
207,8,3,18,566,43,609,1.2,480
207,9,1,5,269,21,290,1.0,480
207,9,2,36,546,0,546,0.8,480
207,10,1,27,434,48,482,0.8,480
207,10,2,32,518,46,564,0.8,480
207,10,3,24,276,4,280,1.0,480
207,11,1,39,258,1,259,1.0,480
207,11,2,11,318,34,352,1.0,480
207,12,1,34,695,9,704,1.0,480
207,12,2,30,426,13,439,1.5,480
207,12,3,40,308,28,336,1.5,480
207,13,3,30,458,45,503,1.5,480
207,14,1,21,517,66,583,1.5,480
207,14,3,33,686,87,773,0.8,480
207,15,1,35,654,96,750,0.8,480
207,15,2,24,210,1,211,1.0,480
207,15,3,11,279,15,294,1.0,480
208,1,1,11,673,93,766,1.0,480
208,1,2,13,247,27,274,1.0,480
208,1,3,34,756,5,761,1.0,480
208,2,1,34,630,47,677,1.0,480
208,2,2,6,740,8,748,1.5,480
208,2,3,40,692,42,734,1.5,480
208,3,1,20,796,8,804,1.5,480
208,3,2,11,562,74,636,1.0,480
208,3,3,5,492,25,517,1.0,480
208,4,2,26,445,3,448,1.0,480
208,5,3,27,379,49,428,0.8,480
208,6,1,2,412,56,468,0.8,480
208,6,2,39,266,24,290,1.0,480
208,6,3,6,584,20,604,1.5,480
208,7,1,17,555,31,586,1.2,480
208,7,2,16,423,52,475,1.2,480
208,8,1,11,667,92,759,1.0,480
208,8,2,25,521,15,536,1.5,480
208,8,3,32,773,36,809,0.8,480
208,9,1,30,394,24,418,1.5,480
208,9,2,25,322,38,360,1.5,480
208,9,3,18,370,27,397,1.2,480
208,10,1,7,597,88,685,1.0,480
208,10,2,5,269,6,275,1.0,480
208,10,3,36,242,9,251,0.8,480
208,11,1,10,676,10,686,1.2,480
208,11,2,2,571,83,654,0.8,480
208,11,3,24,670,54,724,1.0,480
208,12,2,22,425,50,475,1.2,480
208,12,3,2,290,3,293,0.8,480
208,13,1,1,313,39,352,1.5,480
208,13,2,31,492,21,513,1.2,480
208,13,3,5,247,23,270,1.0,480
208,14,1,22,799,21,820,1.2,480
208,14,3,15,350,33,383,1.2,480
208,15,1,14,656,19,675,1.0,480
208,15,2,10,361,18,379,1.2,480
209,1,1,25,567,1,568,1.5,480
209,1,2,17,526,6,532,1.2,480
209,2,1,33,504,61,565,0.8,480
209,2,2,2,587,6,593,0.8,480
209,2,3,22,679,32,711,1.2,480
209,3,1,9,355,49,404,1.0,480
209,3,2,1,654,26,680,1.5,480
209,4,1,11,616,12,628,1.0,480
209,4,3,21,646,12,658,1.5,480
209,5,1,40,696,94,790,1.5,480
209,5,2,28,682,70,752,1.5,480
209,5,3,10,244,33,277,1.2,480
209,6,1,10,475,20,495,1.2,480
209,6,2,40,687,8,695,1.5,480
209,7,2,40,432,6,438,1.5,480
209,7,3,15,395,35,430,1.2,480
209,8,1,36,330,48,378,0.8,480
209,8,2,35,368,7,375,0.8,480
209,8,3,28,386,38,424,1.5,480
209,9,1,40,492,33,525,1.5,480
209,9,2,3,318,2,320,1.5,480
209,9,3,7,683,77,760,1.0,480
209,10,2,11,241,13,254,1.0,480
209,10,3,27,731,108,839,0.8,480
209,11,1,37,239,0,239,1.2,480
209,11,2,32,718,50,768,0.8,480
209,11,3,37,307,6,313,1.2,480
209,12,1,18,365,21,386,1.2,480
209,12,3,17,547,22,569,1.2,480
209,13,1,8,686,7,693,1.0,480
209,13,2,39,576,24,600,1.0,480
209,13,3,19,328,7,335,1.5,480
209,14,1,24,374,47,421,1.0,480
209,14,2,23,513,15,528,1.2,480
209,14,3,24,299,2,301,1.0,480
209,15,1,26,224,20,244,1.0,480
209,15,2,16,616,44,660,1.2,480
209,15,3,31,547,23,570,1.2,480
210,1,2,29,799,7,806,0.8,480
210,1,3,23,533,60,593,1.2,480
210,2,1,7,698,28,726,1.0,480
210,2,2,19,462,15,477,1.5,480
210,2,3,24,321,24,345,1.0,480
210,3,1,20,533,6,539,1.5,480
210,3,2,16,673,44,717,1.2,480
210,3,3,10,719,55,774,1.2,480
210,4,1,20,247,0,247,1.5,480
210,4,2,29,768,96,864,0.8,480
210,5,1,22,683,16,699,1.2,480
210,5,3,23,486,13,499,1.2,480
210,6,1,27,393,38,431,0.8,480
210,6,2,28,529,23,552,1.5,480
210,6,3,22,227,16,243,1.2,480
210,7,1,3,472,40,512,1.5,480
210,7,2,7,691,55,746,1.0,480
210,7,3,37,616,15,631,1.2,480
210,8,1,13,510,75,585,1.0,480
210,8,3,35,357,39,396,0.8,480
210,9,3,30,401,45,446,1.5,480
210,10,2,18,255,20,275,1.2,480
210,11,1,31,620,28,648,1.2,480
210,11,2,33,203,21,224,0.8,480
210,12,1,30,493,42,535,1.5,480
210,12,2,2,580,33,613,0.8,480
210,12,3,39,370,34,404,1.0,480
210,13,1,10,401,4,405,1.2,480
210,13,2,14,489,10,499,1.0,480
210,13,3,40,269,26,295,1.5,480
210,14,1,28,422,23,445,1.5,480
210,14,2,39,735,30,765,1.0,480
210,14,3,3,362,24,386,1.5,480
210,15,1,9,219,24,243,1.0,480
210,15,3,16,330,7,337,1.2,480
211,1,1,16,523,50,573,1.2,480
211,2,2,26,586,38,624,1.0,480
211,2,3,27,568,69,637,0.8,480
211,3,1,11,769,102,871,1.0,480
211,3,2,15,726,95,821,1.2,480
211,3,3,25,299,30,329,1.5,480
211,4,1,9,434,36,470,1.0,480
211,4,2,34,681,60,741,1.0,480
211,4,3,17,693,23,716,1.2,480
211,5,1,23,634,46,680,1.2,480
211,5,2,38,419,27,446,1.5,480
211,5,3,15,740,40,780,1.2,480
211,6,1,6,427,10,437,1.5,480
211,6,2,24,704,3,707,1.0,480
211,6,3,2,358,32,390,0.8,480
211,7,1,35,756,97,853,0.8,480
211,7,2,23,591,57,648,1.2,480
211,7,3,31,720,11,731,1.2,480
211,8,3,32,304,38,342,0.8,480
211,9,1,34,548,64,612,1.0,480
211,9,2,2,334,45,379,0.8,480
211,10,1,8,689,54,743,1.0,480
211,10,2,33,610,33,643,0.8,480
211,10,3,11,668,92,760,1.0,480
211,11,1,31,643,71,714,1.2,480
211,11,2,18,370,50,420,1.2,480
211,11,3,32,665,54,719,0.8,480
211,12,1,12,351,18,369,1.5,480
211,12,2,2,721,1,722,0.8,480
211,12,3,4,473,24,497,0.8,480
211,13,1,11,619,59,678,1.0,480
211,13,2,33,497,50,547,0.8,480
211,13,3,12,534,56,590,1.5,480
211,14,1,36,474,38,512,0.8,480
211,14,3,23,586,60,646,1.2,480
211,15,1,27,592,68,660,0.8,480
211,15,2,12,283,18,301,1.5,480
211,15,3,26,722,91,813,1.0,480
212,1,1,26,267,5,272,1.0,480
212,1,2,29,367,43,410,0.8,480
212,1,3,18,213,29,242,1.2,480
212,2,1,16,380,22,402,1.2,480
212,2,2,2,200,5,205,0.8,480
212,2,3,19,348,49,397,1.5,480
212,3,1,12,396,41,437,1.5,480
212,3,2,19,664,33,697,1.5,480
212,3,3,31,439,58,497,1.2,480
212,4,1,30,374,6,380,1.5,480
212,4,2,20,467,12,479,1.5,480
212,4,3,23,513,24,537,1.2,480
212,5,1,21,661,15,676,1.5,480
212,5,2,2,304,34,338,0.8,480
212,5,3,15,474,66,540,1.2,480
212,6,1,8,716,43,759,1.0,480
212,6,2,35,579,3,582,0.8,480
212,6,3,3,353,3,356,1.5,480
212,7,2,37,316,40,356,1.2,480
212,7,3,5,257,20,277,1.0,480
212,8,1,6,633,10,643,1.5,480
212,8,2,40,607,27,634,1.5,480
212,8,3,5,290,37,327,1.0,480
212,9,1,29,522,77,599,0.8,480
212,9,2,30,634,7,641,1.5,480
212,9,3,38,646,13,659,1.5,480
212,10,1,37,598,56,654,1.2,480
212,10,2,5,391,3,394,1.0,480
212,10,3,5,284,23,307,1.0,480
212,11,1,32,371,45,416,0.8,480
212,11,2,1,296,5,301,1.5,480
212,11,3,31,755,14,769,1.2,480
212,12,1,24,376,4,380,1.0,480
212,12,2,25,709,42,751,1.5,480
212,12,3,1,524,76,600,1.5,480
212,13,1,40,730,85,815,1.5,480
212,13,2,39,654,88,742,1.0,480
212,13,3,18,654,62,716,1.2,480
212,14,1,15,703,63,766,1.2,480
212,14,3,19,516,1,517,1.5,480
212,15,1,20,549,22,571,1.5,480
212,15,2,37,362,33,395,1.2,480
212,15,3,3,333,47,380,1.5,480
213,1,2,20,408,23,431,1.5,480
213,1,3,4,727,53,780,0.8,480
213,2,1,8,369,40,409,1.0,480
213,2,2,14,366,4,370,1.0,480
213,2,3,6,378,51,429,1.5,480
213,3,2,39,431,0,431,1.0,480
213,3,3,12,356,28,384,1.5,480
213,4,1,12,540,65,605,1.5,480
213,4,2,22,235,31,266,1.2,480
213,4,3,30,315,22,337,1.5,480
213,5,1,35,613,8,621,0.8,480
213,5,2,40,538,6,544,1.5,480
213,5,3,29,548,72,620,0.8,480
213,6,1,2,684,45,729,0.8,480
213,6,3,13,389,46,435,1.0,480
213,7,1,38,669,7,676,1.5,480
213,7,2,32,661,9,670,0.8,480
213,7,3,16,725,80,805,1.2,480
213,8,1,1,621,76,697,1.5,480
213,8,3,22,605,56,661,1.2,480
213,9,1,23,582,31,613,1.2,480
213,9,2,22,461,38,499,1.2,480
213,9,3,25,465,68,533,1.5,480
213,10,1,38,544,12,556,1.5,480
213,10,2,6,650,11,661,1.5,480
213,10,3,2,421,38,459,0.8,480
213,11,1,6,473,69,542,1.5,480
213,11,2,22,279,8,287,1.2,480
213,11,3,35,425,59,484,0.8,480
213,12,1,12,592,15,607,1.5,480
213,12,2,33,431,34,465,0.8,480
213,12,3,10,215,2,217,1.2,480
213,13,1,28,563,17,580,1.5,480
213,13,2,31,791,42,833,1.2,480
213,14,1,37,665,68,733,1.2,480
213,14,2,39,241,8,249,1.0,480
213,14,3,32,596,70,666,0.8,480
213,15,1,33,762,109,871,0.8,480
213,15,2,29,438,26,464,0.8,480
213,15,3,32,236,8,244,0.8,480
214,1,1,36,793,98,891,0.8,480
214,1,3,35,560,62,622,0.8,480
214,2,1,31,205,26,231,1.2,480
214,2,2,29,569,60,629,0.8,480
214,2,3,22,694,94,788,1.2,480
214,3,1,25,497,54,551,1.5,480
214,3,2,16,268,37,305,1.2,480
214,3,3,40,654,27,681,1.5,480
214,4,2,7,397,13,410,1.0,480
214,4,3,24,528,42,570,1.0,480
214,5,1,25,756,102,858,1.5,480
214,5,2,24,453,5,458,1.0,480
214,5,3,4,460,18,478,0.8,480
214,6,1,24,547,25,572,1.0,480
214,6,2,40,340,20,360,1.5,480
214,6,3,37,667,83,750,1.2,480
214,7,2,29,542,47,589,0.8,480
214,7,3,24,254,9,263,1.0,480
214,8,1,19,656,80,736,1.5,480
214,8,3,20,778,52,830,1.5,480
214,9,1,2,631,6,637,0.8,480
214,9,2,20,416,26,442,1.5,480
214,9,3,34,417,0,417,1.0,480
214,10,1,1,432,32,464,1.5,480
214,10,2,5,461,51,512,1.0,480
214,10,3,25,387,52,439,1.5,480
214,11,1,19,324,34,358,1.5,480
214,11,2,26,332,44,376,1.0,480
214,11,3,25,437,24,461,1.5,480
214,12,1,20,711,26,737,1.5,480
214,12,2,2,275,13,288,0.8,480
214,12,3,11,474,49,523,1.0,480
214,13,1,30,392,20,412,1.5,480
214,13,2,1,632,78,710,1.5,480
214,13,3,38,463,63,526,1.5,480
214,14,1,5,666,15,681,1.0,480
214,14,2,6,590,86,676,1.5,480
214,15,1,28,689,15,704,1.5,480
214,15,2,19,689,9,698,1.5,480
214,15,3,37,378,42,420,1.2,480
215,1,1,23,692,100,792,1.2,480
215,1,2,29,651,94,745,0.8,480
215,1,3,31,428,4,432,1.2,480
215,2,1,10,719,45,764,1.2,480
215,2,2,17,557,10,567,1.2,480
215,2,3,17,796,83,879,1.2,480
215,3,2,35,441,24,465,0.8,480
215,3,3,26,301,0,301,1.0,480
215,4,1,4,332,23,355,0.8,480
215,4,2,22,375,7,382,1.2,480
215,4,3,31,776,42,818,1.2,480
215,5,1,40,634,21,655,1.5,480
215,6,1,16,633,71,704,1.2,480
215,6,2,27,683,82,765,0.8,480
215,6,3,13,655,66,721,1.0,480
215,7,1,4,398,5,403,0.8,480
215,7,3,28,548,59,607,1.5,480
215,8,1,17,408,47,455,1.2,480
215,8,2,39,492,2,494,1.0,480
215,8,3,13,695,61,756,1.0,480
215,9,1,20,545,62,607,1.5,480
215,9,2,36,687,27,714,0.8,480
215,9,3,17,507,55,562,1.2,480
215,10,1,36,729,103,832,0.8,480
215,10,3,11,786,33,819,1.0,480
215,11,1,33,555,53,608,0.8,480
215,11,2,15,716,17,733,1.2,480
215,11,3,19,783,70,853,1.5,480
215,12,1,29,449,23,472,0.8,480
215,12,2,5,218,24,242,1.0,480
215,12,3,13,506,37,543,1.0,480
215,13,1,39,747,102,849,1.0,480
215,13,2,16,518,27,545,1.2,480
215,13,3,21,273,35,308,1.5,480
215,14,1,26,331,19,350,1.0,480
215,14,3,22,756,75,831,1.2,480
215,15,1,26,516,58,574,1.0,480
215,15,2,34,725,40,765,1.0,480
215,15,3,14,594,49,643,1.0,480
216,1,1,16,577,18,595,1.2,480
216,1,2,24,494,60,554,1.0,480
216,1,3,18,764,4,768,1.2,480
216,2,1,12,365,41,406,1.5,480
216,2,2,12,416,2,418,1.5,480
216,2,3,39,518,39,557,1.0,480
216,3,1,8,653,18,671,1.0,480
216,3,2,28,553,59,612,1.5,480
216,3,3,12,428,47,475,1.5,480
216,4,1,15,417,28,445,1.2,480
216,4,2,7,209,23,232,1.0,480
216,4,3,8,245,34,279,1.0,480
216,5,1,3,202,17,219,1.5,480
216,5,2,22,403,51,454,1.2,480
216,5,3,27,387,48,435,0.8,480
216,6,1,27,613,78,691,0.8,480
216,6,2,4,605,46,651,0.8,480
216,6,3,25,315,35,350,1.5,480
216,7,1,19,615,22,637,1.5,480
216,7,2,16,512,60,572,1.2,480
216,7,3,8,529,64,593,1.0,480
216,8,1,36,624,40,664,0.8,480
216,8,2,25,302,12,314,1.5,480
216,8,3,22,479,57,536,1.2,480
216,9,1,29,577,10,587,0.8,480
216,9,2,39,707,56,763,1.0,480
216,10,1,17,690,13,703,1.2,480
216,10,2,16,527,8,535,1.2,480
216,10,3,40,365,29,394,1.5,480
216,11,1,27,600,31,631,0.8,480
216,11,2,21,428,4,432,1.5,480
216,11,3,26,324,2,326,1.0,480
216,12,1,39,211,24,235,1.0,480
216,12,2,18,481,41,522,1.2,480
216,12,3,15,587,12,599,1.2,480
216,13,1,23,341,19,360,1.2,480
216,13,2,16,582,8,590,1.2,480
216,13,3,26,434,60,494,1.0,480
216,14,2,7,659,58,717,1.0,480
216,14,3,15,588,44,632,1.2,480
216,15,1,33,566,75,641,0.8,480
216,15,2,26,400,38,438,1.0,480
216,15,3,34,510,51,561,1.0,480
217,1,1,6,420,24,444,1.5,480
217,1,2,15,666,81,747,1.2,480
217,1,3,27,739,73,812,0.8,480
217,2,2,20,645,19,664,1.5,480
217,2,3,40,327,11,338,1.5,480
217,3,1,17,778,108,886,1.2,480
217,3,2,1,414,15,429,1.5,480
217,3,3,31,205,4,209,1.2,480
217,4,1,17,725,38,763,1.2,480
217,4,2,23,455,44,499,1.2,480
217,4,3,16,355,26,381,1.2,480
217,5,1,38,565,48,613,1.5,480
217,6,1,18,740,90,830,1.2,480
217,6,2,4,763,109,872,0.8,480
217,6,3,36,207,7,214,0.8,480
217,7,1,24,645,88,733,1.0,480
217,7,2,22,345,20,365,1.2,480
217,7,3,26,679,83,762,1.0,480
217,8,1,34,288,36,324,1.0,480
217,8,2,35,402,52,454,0.8,480
217,8,3,35,706,14,720,0.8,480
217,9,1,13,788,31,819,1.0,480
217,9,2,13,470,24,494,1.0,480
217,9,3,27,717,99,816,0.8,480
217,10,1,36,411,42,453,0.8,480
217,10,2,10,450,53,503,1.2,480
217,10,3,2,718,22,740,0.8,480
217,11,1,12,575,34,609,1.5,480
217,11,2,2,407,42,449,0.8,480
217,11,3,3,612,39,651,1.5,480
217,12,1,22,595,42,637,1.2,480
217,12,3,23,341,2,343,1.2,480
217,13,1,33,740,90,830,0.8,480
217,13,2,2,214,25,239,0.8,480
217,14,1,32,698,40,738,0.8,480
217,14,2,4,368,26,394,0.8,480
217,14,3,21,789,12,801,1.5,480
217,15,1,3,211,1,212,1.5,480
217,15,2,22,740,53,793,1.2,480
217,15,3,18,282,32,314,1.2,480
218,1,2,36,799,113,912,0.8,480
218,1,3,28,428,42,470,1.5,480
218,2,1,15,589,29,618,1.2,480
218,2,2,22,622,72,694,1.2,480
218,2,3,13,765,86,851,1.0,480
218,3,1,38,566,47,613,1.5,480
218,3,2,17,274,16,290,1.2,480
218,3,3,8,717,12,729,1.0,480
218,4,1,15,304,1,305,1.2,480
218,4,3,39,696,28,724,1.0,480
218,5,1,33,545,16,561,0.8,480
218,5,2,19,253,17,270,1.5,480
218,6,1,23,323,23,346,1.2,480
218,6,2,30,696,94,790,1.5,480
218,6,3,36,415,26,441,0.8,480
218,7,1,30,569,5,574,1.5,480
218,7,2,8,545,27,572,1.0,480
218,7,3,2,614,50,664,0.8,480
218,8,2,25,457,54,511,1.5,480
218,8,3,34,549,60,609,1.0,480
218,9,1,35,316,12,328,0.8,480
218,9,2,2,413,22,435,0.8,480
218,9,3,26,694,55,749,1.0,480
218,10,1,3,482,18,500,1.5,480
218,10,3,26,232,21,253,1.0,480
218,11,1,6,673,9,682,1.5,480
218,11,2,4,236,4,240,0.8,480
218,11,3,10,292,11,303,1.2,480
218,12,1,40,542,63,605,1.5,480
218,12,2,16,577,39,616,1.2,480
218,12,3,15,633,25,658,1.2,480
218,13,1,17,511,2,513,1.2,480
218,13,2,22,688,52,740,1.2,480
218,13,3,31,212,8,220,1.2,480
218,14,1,31,527,75,602,1.2,480
218,14,2,16,419,20,439,1.2,480
218,14,3,2,222,22,244,0.8,480
218,15,1,34,413,50,463,1.0,480
218,15,2,35,673,52,725,0.8,480
218,15,3,20,412,40,452,1.5,480
219,1,1,29,520,21,541,0.8,480
219,1,2,30,703,100,803,1.5,480
219,1,3,24,649,86,735,1.0,480
219,2,1,11,651,42,693,1.0,480
219,2,2,18,306,11,317,1.2,480
219,2,3,15,292,12,304,1.2,480
219,3,1,22,356,0,356,1.2,480
219,3,2,20,492,16,508,1.5,480
219,3,3,39,475,38,513,1.0,480
219,4,1,40,300,33,333,1.5,480
219,4,2,22,205,23,228,1.2,480
219,4,3,21,660,59,719,1.5,480
219,5,1,9,206,2,208,1.0,480
219,5,2,18,320,41,361,1.2,480
219,5,3,33,572,18,590,0.8,480
219,6,1,5,442,11,453,1.0,480
219,6,3,27,783,31,814,0.8,480
219,7,2,25,540,36,576,1.5,480
219,7,3,39,646,86,732,1.0,480
219,8,1,16,543,5,548,1.2,480
219,8,2,27,716,91,807,0.8,480
219,8,3,4,215,1,216,0.8,480
219,9,2,20,332,21,353,1.5,480
219,9,3,8,242,3,245,1.0,480
219,10,1,4,488,19,507,0.8,480
219,11,1,33,499,44,543,0.8,480
219,11,2,31,485,68,553,1.2,480
219,12,1,26,540,41,581,1.0,480
219,12,2,30,347,36,383,1.5,480
219,12,3,39,202,4,206,1.0,480
219,13,2,18,742,29,771,1.2,480
219,13,3,8,695,88,783,1.0,480
219,14,2,6,411,8,419,1.5,480
219,14,3,17,732,100,832,1.2,480
219,15,1,25,437,26,463,1.5,480
219,15,2,7,421,52,473,1.0,480
219,15,3,7,549,54,603,1.0,480
220,1,1,17,427,14,441,1.2,480
220,1,2,11,594,16,610,1.0,480
220,2,1,16,521,36,557,1.2,480
220,2,2,35,743,101,844,0.8,480
220,3,1,21,301,8,309,1.5,480
220,3,2,32,570,63,633,0.8,480
220,3,3,35,280,38,318,0.8,480
220,4,1,1,388,41,429,1.5,480
220,4,2,18,782,36,818,1.2,480
220,5,2,6,729,6,735,1.5,480
220,5,3,1,590,0,590,1.5,480
220,6,1,29,648,5,653,0.8,480
220,6,2,27,722,99,821,0.8,480
220,6,3,1,373,10,383,1.5,480
220,7,1,40,540,66,606,1.5,480
220,7,2,36,633,52,685,0.8,480
220,7,3,3,621,79,700,1.5,480
220,8,1,34,497,70,567,1.0,480
220,8,3,3,232,20,252,1.5,480
220,9,1,16,795,26,821,1.2,480
220,9,2,5,395,9,404,1.0,480
220,9,3,7,522,28,550,1.0,480
220,10,1,3,252,8,260,1.5,480
220,10,2,36,459,49,508,0.8,480
220,10,3,33,249,31,280,0.8,480
220,11,1,2,485,15,500,0.8,480
220,11,2,28,570,2,572,1.5,480
220,11,3,37,362,30,392,1.2,480
220,12,1,20,219,4,223,1.5,480
220,12,2,25,767,114,881,1.5,480
220,12,3,23,220,24,244,1.2,480
220,13,1,18,380,0,380,1.2,480
220,13,2,11,756,96,852,1.0,480
220,14,1,6,742,33,775,1.5,480
220,14,3,3,290,26,316,1.5,480
220,15,2,37,655,75,730,1.2,480
220,15,3,7,710,47,757,1.0,480
221,1,1,17,639,15,654,1.2,480
221,1,2,27,628,28,656,0.8,480
221,1,3,11,605,6,611,1.0,480
221,2,1,13,264,28,292,1.0,480
221,2,2,17,468,4,472,1.2,480
221,2,3,22,256,21,277,1.2,480
221,3,1,5,764,107,871,1.0,480
221,3,2,15,620,15,635,1.2,480
221,3,3,19,333,27,360,1.5,480
221,4,1,5,429,18,447,1.0,480
221,4,2,35,644,77,721,0.8,480
221,4,3,18,765,41,806,1.2,480
221,5,1,10,219,2,221,1.2,480
221,5,2,11,487,24,511,1.0,480
221,5,3,31,400,28,428,1.2,480
221,6,1,15,563,60,623,1.2,480
221,6,2,15,388,44,432,1.2,480
221,6,3,2,302,6,308,0.8,480
221,7,1,2,465,55,520,0.8,480
221,7,2,28,436,53,489,1.5,480
221,7,3,28,442,52,494,1.5,480
221,8,1,17,536,62,598,1.2,480
221,8,2,9,511,1,512,1.0,480
221,8,3,19,473,31,504,1.5,480
221,9,1,28,215,26,241,1.5,480
221,9,2,4,221,1,222,0.8,480
221,9,3,35,533,30,563,0.8,480
221,10,1,17,663,15,678,1.2,480
221,10,2,31,564,71,635,1.2,480
221,10,3,29,629,0,629,0.8,480
221,11,1,5,610,9,619,1.0,480
221,11,2,7,440,8,448,1.0,480
221,12,1,23,207,6,213,1.2,480
221,12,2,39,541,25,566,1.0,480
221,12,3,14,229,11,240,1.0,480
221,13,1,27,319,28,347,0.8,480
221,13,2,7,660,83,743,1.0,480
221,13,3,32,637,80,717,0.8,480
221,14,2,32,209,26,235,0.8,480
221,14,3,35,313,31,344,0.8,480
221,15,1,26,490,13,503,1.0,480
221,15,2,20,437,27,464,1.5,480
221,15,3,36,244,32,276,0.8,480
222,1,1,40,722,99,821,1.5,480
222,1,2,33,614,70,684,0.8,480
222,1,3,10,673,53,726,1.2,480
222,2,1,36,524,38,562,0.8,480
222,2,2,37,499,48,547,1.2,480
222,2,3,37,365,43,408,1.2,480
222,3,2,33,531,2,533,0.8,480
222,3,3,9,756,70,826,1.0,480
222,4,1,23,202,27,229,1.2,480
222,4,2,40,735,88,823,1.5,480
222,4,3,21,700,100,800,1.5,480
222,5,1,22,463,15,478,1.2,480
222,5,2,14,735,44,779,1.0,480
222,6,1,10,522,50,572,1.2,480
222,6,3,14,386,13,399,1.0,480
222,7,1,23,511,74,585,1.2,480
222,7,2,1,753,40,793,1.5,480
222,7,3,21,640,24,664,1.5,480
222,8,1,9,411,8,419,1.0,480
222,9,1,39,326,45,371,1.0,480
222,9,2,9,321,5,326,1.0,480
222,9,3,20,686,54,740,1.5,480
222,10,2,18,426,49,475,1.2,480
222,10,3,4,720,73,793,0.8,480
222,11,2,33,350,0,350,0.8,480
222,11,3,38,713,38,751,1.5,480
222,12,1,23,768,11,779,1.2,480
222,13,1,25,380,45,425,1.5,480
222,13,2,40,689,46,735,1.5,480
222,13,3,33,288,8,296,0.8,480
222,14,1,18,708,61,769,1.2,480
222,14,2,28,648,8,656,1.5,480
222,15,1,25,325,30,355,1.5,480
222,15,2,37,493,25,518,1.2,480
222,15,3,11,577,27,604,1.0,480
223,1,1,28,743,5,748,1.5,480
223,1,2,2,357,25,382,0.8,480
223,1,3,19,718,84,802,1.5,480
223,2,1,37,266,0,266,1.2,480
223,2,2,34,696,39,735,1.0,480
223,2,3,35,315,12,327,0.8,480
223,3,1,32,784,2,786,0.8,480
223,3,2,18,462,45,507,1.2,480
223,3,3,31,774,46,820,1.2,480
223,4,2,29,590,17,607,0.8,480
223,4,3,17,231,3,234,1.2,480
223,5,1,38,418,5,423,1.5,480
223,5,2,18,221,14,235,1.2,480
223,5,3,35,299,41,340,0.8,480
223,6,2,15,642,10,652,1.2,480
223,6,3,25,202,17,219,1.5,480
223,7,1,6,612,15,627,1.5,480
223,7,2,6,621,7,628,1.5,480
223,7,3,33,679,10,689,0.8,480
223,8,1,30,597,8,605,1.5,480
223,8,2,34,262,7,269,1.0,480
223,9,1,8,395,41,436,1.0,480
223,9,2,31,673,10,683,1.2,480
223,9,3,1,796,94,890,1.5,480
223,10,2,27,689,51,740,0.8,480
223,10,3,29,765,101,866,0.8,480
223,11,1,7,419,33,452,1.0,480
223,11,2,37,328,24,352,1.2,480
223,11,3,37,326,11,337,1.2,480
223,12,1,20,783,62,845,1.5,480
223,12,2,17,372,3,375,1.2,480
223,12,3,30,523,8,531,1.5,480
223,13,1,26,514,1,515,1.0,480
223,13,2,18,297,22,319,1.2,480
223,13,3,8,439,22,461,1.0,480
223,14,1,28,658,33,691,1.5,480
223,14,2,28,639,6,645,1.5,480
223,14,3,37,216,28,244,1.2,480
223,15,2,16,670,58,728,1.2,480
223,15,3,14,760,50,810,1.0,480
224,1,1,31,527,29,556,1.2,480
224,1,2,30,698,79,777,1.5,480
224,1,3,32,683,91,774,0.8,480
224,2,1,6,261,14,275,1.5,480
224,3,1,25,220,3,223,1.5,480
224,3,2,1,570,3,573,1.5,480
224,4,1,32,213,15,228,0.8,480
224,4,2,19,412,10,422,1.5,480
224,4,3,19,352,19,371,1.5,480
224,5,2,29,587,54,641,0.8,480
224,6,1,10,415,37,452,1.2,480
224,6,3,14,549,15,564,1.0,480
224,7,1,4,406,26,432,0.8,480
224,7,2,15,490,60,550,1.2,480
224,7,3,11,552,31,583,1.0,480
224,8,1,17,480,4,484,1.2,480
224,8,2,19,260,20,280,1.5,480
224,8,3,17,249,16,265,1.2,480
224,10,1,19,534,70,604,1.5,480
224,10,2,9,616,13,629,1.0,480
224,10,3,25,682,21,703,1.5,480
224,11,1,19,411,23,434,1.5,480
224,11,2,31,313,3,316,1.2,480
224,12,1,27,537,77,614,0.8,480
224,12,2,6,658,65,723,1.5,480
224,12,3,14,712,13,725,1.0,480
224,13,1,7,506,17,523,1.0,480
224,13,2,37,395,13,408,1.2,480
224,13,3,1,674,87,761,1.5,480
224,14,1,11,314,27,341,1.0,480
224,14,3,21,589,42,631,1.5,480
224,15,1,4,240,10,250,0.8,480
224,15,2,13,291,13,304,1.0,480
224,15,3,23,668,57,725,1.2,480
225,1,1,17,528,34,562,1.2,480
225,1,3,38,466,20,486,1.5,480
225,2,1,28,380,50,430,1.5,480
225,2,2,22,422,13,435,1.2,480
225,2,3,5,352,24,376,1.0,480
225,3,1,29,562,34,596,0.8,480
225,3,3,37,570,16,586,1.2,480
225,4,2,20,536,48,584,1.5,480
225,5,1,9,200,15,215,1.0,480
225,5,3,27,577,62,639,0.8,480
225,6,2,28,493,51,544,1.5,480
225,6,3,24,600,59,659,1.0,480
225,7,1,22,684,56,740,1.2,480
225,7,2,11,254,20,274,1.0,480
225,8,1,3,332,47,379,1.5,480
225,8,2,24,256,20,276,1.0,480
225,8,3,30,682,63,745,1.5,480
225,9,1,40,736,57,793,1.5,480
225,9,2,8,266,16,282,1.0,480
225,9,3,10,761,76,837,1.2,480
225,10,1,35,755,42,797,0.8,480
225,10,2,32,399,51,450,0.8,480
225,11,1,10,459,27,486,1.2,480
225,11,2,8,499,15,514,1.0,480
225,11,3,17,386,32,418,1.2,480
225,12,1,17,358,7,365,1.2,480
225,12,2,23,374,23,397,1.2,480
225,12,3,40,244,2,246,1.5,480
225,14,1,31,730,33,763,1.2,480
225,14,2,28,263,16,279,1.5,480
225,14,3,8,768,106,874,1.0,480
225,15,1,26,392,25,417,1.0,480
225,15,2,10,611,2,613,1.2,480
225,15,3,24,487,44,531,1.0,480
226,1,1,13,529,29,558,1.0,480
226,1,2,18,531,24,555,1.2,480
226,1,3,17,731,59,790,1.2,480
226,2,2,6,403,56,459,1.5,480
226,2,3,31,464,40,504,1.2,480
226,3,1,38,674,7,681,1.5,480
226,3,2,36,358,9,367,0.8,480
226,3,3,25,559,39,598,1.5,480
226,4,1,17,500,44,544,1.2,480
226,4,2,35,619,26,645,0.8,480
226,4,3,24,667,70,737,1.0,480
226,5,1,5,279,17,296,1.0,480
226,5,3,27,254,35,289,0.8,480
226,6,1,36,254,26,280,0.8,480
226,6,2,20,535,22,557,1.5,480
226,6,3,14,377,50,427,1.0,480
226,7,1,30,428,31,459,1.5,480
226,7,2,20,580,8,588,1.5,480
226,7,3,28,349,28,377,1.5,480
226,8,1,11,249,6,255,1.0,480
226,8,2,7,689,92,781,1.0,480
226,9,1,1,691,27,718,1.5,480
226,9,2,24,692,61,753,1.0,480
226,9,3,35,420,36,456,0.8,480
226,10,2,16,588,13,601,1.2,480
226,11,1,3,261,35,296,1.5,480
226,11,2,11,647,76,723,1.0,480
226,12,3,17,336,21,357,1.2,480
226,13,2,38,600,28,628,1.5,480
226,13,3,30,787,114,901,1.5,480
226,14,1,26,748,20,768,1.0,480
226,14,2,28,451,35,486,1.5,480
226,14,3,36,427,16,443,0.8,480
226,15,1,28,566,38,604,1.5,480
226,15,3,30,468,17,485,1.5,480
227,1,1,33,624,63,687,0.8,480
227,1,3,8,500,0,500,1.0,480
227,2,1,24,663,20,683,1.0,480
227,2,2,23,735,36,771,1.2,480
227,2,3,9,686,33,719,1.0,480
227,3,1,39,447,9,456,1.0,480
227,3,3,35,625,16,641,0.8,480
227,4,1,33,561,57,618,0.8,480
227,4,2,23,796,31,827,1.2,480
227,4,3,38,579,72,651,1.5,480
227,5,1,14,646,66,712,1.0,480
227,5,2,15,296,1,297,1.2,480
227,5,3,39,337,6,343,1.0,480
227,6,1,10,286,37,323,1.2,480
227,6,2,34,665,97,762,1.0,480
227,7,1,33,301,22,323,0.8,480
227,7,2,17,428,36,464,1.2,480
227,7,3,27,760,106,866,0.8,480
227,8,1,37,306,33,339,1.2,480
227,8,2,36,679,35,714,0.8,480
227,8,3,4,635,1,636,0.8,480
227,9,1,37,343,11,354,1.2,480
227,9,3,21,250,3,253,1.5,480
227,10,1,2,214,16,230,0.8,480
227,10,2,16,239,6,245,1.2,480
227,10,3,39,630,70,700,1.0,480
227,11,1,16,320,12,332,1.2,480
227,11,2,15,466,43,509,1.2,480
227,11,3,23,715,27,742,1.2,480
227,12,1,24,358,34,392,1.0,480
227,12,2,8,774,27,801,1.0,480
227,12,3,9,760,70,830,1.0,480
227,13,2,7,335,11,346,1.0,480
227,14,1,16,663,76,739,1.2,480
227,14,2,16,222,24,246,1.2,480
227,14,3,34,718,34,752,1.0,480
227,15,1,40,392,40,432,1.5,480
228,1,1,34,440,51,491,1.0,480
228,1,2,37,483,51,534,1.2,480
228,1,3,21,661,19,680,1.5,480
228,2,2,9,411,49,460,1.0,480
228,2,3,13,717,50,767,1.0,480
228,3,1,5,738,57,795,1.0,480
228,3,2,5,309,29,338,1.0,480
228,3,3,12,404,22,426,1.5,480
228,4,1,38,346,8,354,1.5,480
228,4,2,28,431,19,450,1.5,480
228,4,3,20,488,10,498,1.5,480
228,5,1,7,747,25,772,1.0,480
228,5,2,28,386,33,419,1.5,480
228,5,3,22,344,37,381,1.2,480
228,6,1,20,386,15,401,1.5,480
228,6,2,37,446,39,485,1.2,480
228,6,3,24,735,7,742,1.0,480
228,7,1,10,675,69,744,1.2,480
228,7,2,8,341,26,367,1.0,480
228,7,3,27,471,67,538,0.8,480
228,8,1,36,747,70,817,0.8,480
228,8,2,35,682,2,684,0.8,480
228,8,3,29,745,23,768,0.8,480
228,9,1,15,668,43,711,1.2,480
228,9,2,4,487,65,552,0.8,480
228,9,3,8,564,8,572,1.0,480
228,10,1,38,563,33,596,1.5,480
228,10,2,12,310,9,319,1.5,480
228,10,3,36,394,22,416,0.8,480
228,11,1,3,457,56,513,1.5,480
228,11,3,35,781,78,859,0.8,480
228,12,1,36,298,8,306,0.8,480
228,12,2,17,465,31,496,1.2,480
228,12,3,4,600,35,635,0.8,480
228,13,1,22,592,7,599,1.2,480
228,13,2,9,790,10,800,1.0,480
228,14,1,39,430,58,488,1.0,480
228,14,2,23,200,20,220,1.2,480
228,14,3,5,252,4,256,1.0,480
228,15,1,32,702,74,776,0.8,480
228,15,2,30,291,2,293,1.5,480
228,15,3,23,577,17,594,1.2,480
229,1,1,33,301,15,316,0.8,480
229,1,2,7,494,21,515,1.0,480
229,2,1,11,706,70,776,1.0,480
229,2,2,37,443,43,486,1.2,480
229,2,3,22,564,60,624,1.2,480
229,3,1,2,488,32,520,0.8,480
229,3,2,18,775,84,859,1.2,480
229,3,3,14,281,41,322,1.0,480
229,4,1,7,604,46,650,1.0,480
229,4,2,34,663,33,696,1.0,480
229,4,3,27,463,36,499,0.8,480
229,5,2,13,482,39,521,1.0,480
229,6,1,15,507,31,538,1.2,480
229,6,2,8,453,65,518,1.0,480
229,6,3,7,424,32,456,1.0,480
229,7,1,7,546,29,575,1.0,480
229,7,3,10,321,18,339,1.2,480
229,8,1,32,705,44,749,0.8,480
229,8,2,35,449,57,506,0.8,480
229,8,3,5,405,59,464,1.0,480
229,9,1,20,415,48,463,1.5,480
229,9,2,3,515,4,519,1.5,480
229,9,3,14,637,25,662,1.0,480
229,10,1,21,202,19,221,1.5,480
229,10,2,5,650,31,681,1.0,480
229,10,3,1,591,74,665,1.5,480
229,11,1,11,438,40,478,1.0,480
229,11,2,12,746,38,784,1.5,480
229,11,3,21,739,37,776,1.5,480
229,12,1,30,439,58,497,1.5,480
229,12,3,6,620,24,644,1.5,480
229,13,1,36,487,70,557,0.8,480
229,13,2,10,713,78,791,1.2,480
229,13,3,21,424,55,479,1.5,480
229,14,1,25,496,1,497,1.5,480
229,14,2,22,279,29,308,1.2,480
229,14,3,35,745,87,832,0.8,480
229,15,1,18,235,12,247,1.2,480
229,15,3,36,276,5,281,0.8,480
230,1,1,40,600,76,676,1.5,480
230,1,2,22,763,65,828,1.2,480
230,1,3,21,324,25,349,1.5,480
230,2,1,40,691,45,736,1.5,480
230,2,3,9,227,18,245,1.0,480
230,3,1,27,285,10,295,0.8,480
230,3,2,37,374,25,399,1.2,480
230,4,1,29,614,68,682,0.8,480
230,4,3,40,536,49,585,1.5,480
230,5,1,12,476,9,485,1.5,480
230,5,2,6,620,5,625,1.5,480
230,5,3,5,756,27,783,1.0,480
230,6,1,12,559,29,588,1.5,480
230,6,2,21,359,4,363,1.5,480
230,6,3,9,613,59,672,1.0,480
230,7,1,14,766,48,814,1.0,480
230,7,2,34,427,61,488,1.0,480
230,7,3,24,714,30,744,1.0,480
230,8,1,1,337,2,339,1.5,480
230,8,2,33,404,27,431,0.8,480
230,8,3,38,770,57,827,1.5,480
230,9,1,35,493,18,511,0.8,480
230,9,2,24,656,88,744,1.0,480
230,9,3,13,643,13,656,1.0,480
230,10,1,25,436,55,491,1.5,480
230,10,2,14,617,91,708,1.0,480
230,10,3,17,339,15,354,1.2,480
230,11,1,8,774,105,879,1.0,480
230,11,2,39,619,72,691,1.0,480
230,11,3,36,646,20,666,0.8,480
230,12,1,1,658,48,706,1.5,480
230,12,2,18,664,7,671,1.2,480
230,12,3,22,314,4,318,1.2,480
230,13,2,39,742,9,751,1.0,480
230,13,3,6,784,4,788,1.5,480
230,14,1,26,564,33,597,1.0,480
230,14,2,25,285,29,314,1.5,480
230,15,3,17,595,52,647,1.2,480
231,1,1,4,350,42,392,0.8,480
231,1,2,8,451,3,454,1.0,480
231,2,2,15,397,1,398,1.2,480
231,2,3,9,449,66,515,1.0,480
231,3,2,21,758,25,783,1.5,480
231,3,3,19,335,15,350,1.5,480
231,4,1,23,424,13,437,1.2,480
231,4,2,25,458,42,500,1.5,480
231,4,3,10,708,56,764,1.2,480
231,5,1,25,288,42,330,1.5,480
231,5,2,30,539,60,599,1.5,480
231,5,3,16,375,7,382,1.2,480
231,6,1,23,338,1,339,1.2,480
231,6,2,17,782,46,828,1.2,480
231,6,3,6,426,30,456,1.5,480
231,7,1,33,506,45,551,0.8,480
231,7,2,14,532,34,566,1.0,480
231,8,1,36,272,16,288,0.8,480
231,8,3,7,503,2,505,1.0,480
231,9,1,15,418,48,466,1.2,480
231,9,2,23,341,37,378,1.2,480
231,9,3,26,567,9,576,1.0,480
231,10,1,40,216,21,237,1.5,480
231,10,2,17,368,8,376,1.2,480
231,10,3,18,609,80,689,1.2,480
231,11,1,26,630,66,696,1.0,480
231,11,2,28,780,11,791,1.5,480
231,11,3,24,648,73,721,1.0,480
231,12,1,39,773,66,839,1.0,480
231,12,2,25,298,12,310,1.5,480
231,12,3,11,794,97,891,1.0,480
231,13,1,14,285,36,321,1.0,480
231,13,2,19,405,28,433,1.5,480
231,13,3,14,333,8,341,1.0,480
231,14,3,31,436,46,482,1.2,480
231,15,1,35,581,2,583,0.8,480
231,15,3,34,219,17,236,1.0,480
232,1,1,30,451,40,491,1.5,480
232,1,2,15,402,18,420,1.2,480
232,1,3,39,748,43,791,1.0,480
232,2,2,35,499,68,567,0.8,480
232,2,3,2,601,23,624,0.8,480
232,3,1,7,347,23,370,1.0,480
232,3,3,17,670,80,750,1.2,480
232,4,2,36,283,10,293,0.8,480
232,4,3,9,599,74,673,1.0,480
232,5,1,26,690,50,740,1.0,480
232,5,3,10,591,67,658,1.2,480
232,6,2,10,395,22,417,1.2,480
232,7,1,24,211,20,231,1.0,480
232,7,2,40,732,53,785,1.5,480
232,7,3,6,798,64,862,1.5,480
232,8,1,29,499,0,499,0.8,480
232,8,2,16,682,67,749,1.2,480
232,8,3,31,756,97,853,1.2,480
232,9,1,7,531,53,584,1.0,480
232,9,2,20,591,55,646,1.5,480
232,9,3,19,669,7,676,1.5,480
232,10,1,19,739,23,762,1.5,480
232,10,2,7,259,29,288,1.0,480
232,10,3,32,619,8,627,0.8,480
232,11,1,25,205,14,219,1.5,480
232,11,2,24,733,69,802,1.0,480
232,11,3,33,745,37,782,0.8,480
232,12,1,38,211,6,217,1.5,480
232,12,2,2,513,17,530,0.8,480
232,13,1,32,380,13,393,0.8,480
232,13,2,1,396,58,454,1.5,480
232,13,3,14,714,17,731,1.0,480
232,14,1,3,389,16,405,1.5,480
232,14,2,28,294,36,330,1.5,480
232,14,3,2,505,74,579,0.8,480
232,15,1,40,307,10,317,1.5,480
232,15,2,10,735,2,737,1.2,480
232,15,3,31,621,27,648,1.2,480
233,1,1,39,639,11,650,1.0,480
233,1,2,23,489,52,541,1.2,480
233,1,3,31,305,36,341,1.2,480
233,2,1,22,233,6,239,1.2,480
233,2,2,6,717,5,722,1.5,480
233,2,3,10,770,87,857,1.2,480
233,3,2,18,534,56,590,1.2,480
233,4,1,1,744,106,850,1.5,480
233,4,3,36,349,1,350,0.8,480
233,5,1,13,439,64,503,1.0,480
233,5,2,13,333,31,364,1.0,480
233,5,3,19,485,62,547,1.5,480
233,6,1,35,280,31,311,0.8,480
233,6,2,28,516,0,516,1.5,480
233,6,3,29,411,12,423,0.8,480
233,7,1,38,515,22,537,1.5,480
233,7,3,33,660,44,704,0.8,480
233,8,1,36,481,24,505,0.8,480
233,8,2,32,780,49,829,0.8,480
233,8,3,36,731,73,804,0.8,480
233,9,1,33,258,5,263,0.8,480
233,9,2,12,374,48,422,1.5,480
233,10,1,6,663,4,667,1.5,480
233,10,2,39,481,54,535,1.0,480
233,10,3,30,629,15,644,1.5,480
233,11,1,35,729,85,814,0.8,480
233,11,2,18,527,77,604,1.2,480
233,11,3,16,246,6,252,1.2,480
233,12,1,22,301,9,310,1.2,480
233,12,2,3,439,49,488,1.5,480
233,12,3,7,452,0,452,1.0,480
233,13,2,2,340,39,379,0.8,480
233,13,3,1,287,39,326,1.5,480
233,14,1,38,410,32,442,1.5,480
233,14,2,5,763,32,795,1.0,480
233,14,3,8,245,16,261,1.0,480
233,15,1,6,431,63,494,1.5,480
233,15,2,30,771,40,811,1.5,480
233,15,3,13,272,36,308,1.0,480
234,1,1,37,540,80,620,1.2,480
234,1,2,26,558,79,637,1.0,480
234,2,1,17,428,1,429,1.2,480
234,2,2,12,771,19,790,1.5,480
234,2,3,38,208,1,209,1.5,480
234,3,1,18,424,15,439,1.2,480
234,3,2,25,793,51,844,1.5,480
234,4,1,12,687,53,740,1.5,480
234,4,2,16,279,16,295,1.2,480
234,4,3,35,209,10,219,0.8,480
234,5,1,33,726,107,833,0.8,480
234,5,2,35,692,63,755,0.8,480
234,5,3,34,426,57,483,1.0,480
234,6,1,14,574,34,608,1.0,480
234,6,3,8,715,55,770,1.0,480
234,7,3,38,482,30,512,1.5,480
234,8,1,37,671,98,769,1.2,480
234,8,2,19,307,34,341,1.5,480
234,8,3,14,327,10,337,1.0,480
234,9,2,15,456,37,493,1.2,480
234,9,3,12,505,0,505,1.5,480
234,10,1,37,726,95,821,1.2,480
234,10,2,26,455,54,509,1.0,480
234,10,3,6,609,84,693,1.5,480
234,11,1,17,368,10,378,1.2,480
234,11,2,31,759,16,775,1.2,480
234,11,3,15,622,79,701,1.2,480
234,12,1,23,339,10,349,1.2,480
234,12,2,6,323,5,328,1.5,480
234,12,3,25,402,2,404,1.5,480
234,13,1,8,314,32,346,1.0,480
234,13,3,30,290,27,317,1.5,480
234,14,1,6,328,13,341,1.5,480
234,15,2,4,542,54,596,0.8,480
234,15,3,33,746,82,828,0.8,480
235,1,1,32,712,51,763,0.8,480
235,1,2,18,321,41,362,1.2,480
235,1,3,25,346,33,379,1.5,480
235,2,1,30,344,45,389,1.5,480
235,2,2,33,530,55,585,0.8,480
235,2,3,38,716,57,773,1.5,480
235,3,2,31,540,65,605,1.2,480
235,4,1,10,785,89,874,1.2,480
235,4,2,6,364,26,390,1.5,480
235,4,3,28,588,79,667,1.5,480
235,5,1,37,430,22,452,1.2,480
235,5,2,2,790,52,842,0.8,480
235,5,3,26,607,30,637,1.0,480
235,6,1,12,454,9,463,1.5,480
235,6,2,39,253,10,263,1.0,480
235,6,3,12,630,8,638,1.5,480
235,7,1,18,339,31,370,1.2,480
235,7,2,25,305,44,349,1.5,480
235,7,3,33,222,31,253,0.8,480
235,8,2,14,341,24,365,1.0,480
235,8,3,20,424,51,475,1.5,480
235,9,1,31,702,96,798,1.2,480
235,9,2,34,626,67,693,1.0,480
235,10,1,10,354,14,368,1.2,480
235,10,2,20,362,35,397,1.5,480
235,11,1,10,401,43,444,1.2,480
235,11,2,25,775,3,778,1.5,480
235,11,3,14,363,50,413,1.0,480
235,12,1,12,609,71,680,1.5,480
235,12,2,21,329,15,344,1.5,480
235,12,3,17,752,53,805,1.2,480
235,13,1,6,464,37,501,1.5,480
235,13,2,32,439,47,486,0.8,480
235,13,3,16,496,67,563,1.2,480
235,14,1,24,236,21,257,1.0,480
235,14,2,24,558,65,623,1.0,480
235,14,3,38,200,22,222,1.5,480
235,15,1,20,655,61,716,1.5,480
235,15,2,19,527,65,592,1.5,480
236,1,1,17,389,44,433,1.2,480
236,1,2,8,425,17,442,1.0,480
236,1,3,14,375,34,409,1.0,480
236,2,1,7,395,35,430,1.0,480
236,2,2,39,621,13,634,1.0,480
236,2,3,12,451,7,458,1.5,480
236,3,1,7,547,23,570,1.0,480
236,3,3,33,408,1,409,0.8,480
236,4,1,2,605,46,651,0.8,480
236,4,2,37,689,55,744,1.2,480
236,4,3,38,343,31,374,1.5,480
236,5,1,37,733,96,829,1.2,480
236,5,2,8,328,43,371,1.0,480
236,5,3,14,725,47,772,1.0,480
236,6,1,15,570,31,601,1.2,480
236,6,2,12,327,27,354,1.5,480
236,6,3,24,790,90,880,1.0,480
236,7,3,22,279,39,318,1.2,480
236,8,1,33,379,35,414,0.8,480
236,8,2,30,503,12,515,1.5,480
236,8,3,13,729,77,806,1.0,480
236,9,1,17,516,65,581,1.2,480
236,9,2,36,349,16,365,0.8,480
236,9,3,9,298,42,340,1.0,480
236,10,1,40,202,13,215,1.5,480
236,10,2,37,450,9,459,1.2,480
236,10,3,32,371,3,374,0.8,480
236,11,1,8,378,54,432,1.0,480
236,11,2,27,345,43,388,0.8,480
236,12,1,12,337,45,382,1.5,480
236,12,2,24,358,29,387,1.0,480
236,12,3,10,312,41,353,1.2,480
236,13,1,5,357,27,384,1.0,480
236,13,2,13,354,11,365,1.0,480
236,13,3,26,501,26,527,1.0,480
236,14,1,36,673,49,722,0.8,480
236,14,2,39,433,19,452,1.0,480
236,14,3,4,225,23,248,0.8,480
237,1,2,16,745,87,832,1.2,480
237,1,3,10,610,67,677,1.2,480
237,2,1,2,491,65,556,0.8,480
237,2,2,17,476,61,537,1.2,480
237,2,3,17,487,15,502,1.2,480
237,3,1,8,688,101,789,1.0,480
237,3,2,9,663,86,749,1.0,480
237,4,1,33,352,32,384,0.8,480
237,4,2,19,460,67,527,1.5,480
237,4,3,25,263,12,275,1.5,480
237,5,2,2,756,108,864,0.8,480
237,5,3,29,722,53,775,0.8,480
237,6,1,23,581,61,642,1.2,480
237,6,3,17,467,2,469,1.2,480
237,7,1,36,360,21,381,0.8,480
237,7,2,5,337,42,379,1.0,480
237,7,3,36,250,1,251,0.8,480
237,8,1,4,540,37,577,0.8,480
237,8,2,27,662,41,703,0.8,480
237,8,3,20,330,35,365,1.5,480
237,9,1,34,349,47,396,1.0,480
237,9,2,35,702,66,768,0.8,480
237,9,3,23,273,23,296,1.2,480
237,10,1,10,242,21,263,1.2,480
237,10,2,1,763,24,787,1.5,480
237,10,3,32,779,47,826,0.8,480
237,11,1,4,790,39,829,0.8,480
237,11,2,18,648,12,660,1.2,480
237,11,3,20,664,61,725,1.5,480
237,12,1,23,450,54,504,1.2,480
237,12,2,23,359,39,398,1.2,480
237,12,3,26,484,51,535,1.0,480
237,13,1,38,452,45,497,1.5,480
237,13,2,25,222,12,234,1.5,480
237,15,1,11,353,37,390,1.0,480
237,15,2,35,599,26,625,0.8,480
237,15,3,21,452,14,466,1.5,480
238,1,2,19,508,27,535,1.5,480
238,1,3,4,712,93,805,0.8,480
238,2,1,29,366,17,383,0.8,480
238,2,3,34,251,13,264,1.0,480
238,3,1,29,509,19,528,0.8,480
238,3,2,24,336,29,365,1.0,480
238,3,3,39,519,11,530,1.0,480
238,4,1,27,713,97,810,0.8,480
238,5,1,7,382,48,430,1.0,480
238,5,2,15,572,22,594,1.2,480
238,6,1,24,582,39,621,1.0,480
238,6,2,27,631,65,696,0.8,480
238,6,3,35,497,70,567,0.8,480
238,7,1,13,443,48,491,1.0,480
238,7,2,9,700,56,756,1.0,480
238,7,3,9,772,114,886,1.0,480
238,8,1,16,203,18,221,1.2,480
238,8,2,24,292,39,331,1.0,480
238,8,3,15,564,70,634,1.2,480
238,9,1,13,412,13,425,1.0,480
238,9,2,8,432,24,456,1.0,480
238,9,3,34,416,36,452,1.0,480
238,10,1,8,517,54,571,1.0,480
238,10,2,30,301,27,328,1.5,480
238,10,3,29,732,6,738,0.8,480
238,11,1,33,359,29,388,0.8,480
238,11,2,14,672,16,688,1.0,480
238,12,1,3,735,48,783,1.5,480
238,12,2,12,742,49,791,1.5,480
238,12,3,18,268,23,291,1.2,480
238,13,1,18,597,3,600,1.2,480
238,13,2,27,216,26,242,0.8,480
238,13,3,3,457,61,518,1.5,480
238,14,1,14,469,2,471,1.0,480
238,14,2,37,474,12,486,1.2,480
238,14,3,3,346,28,374,1.5,480
238,15,1,20,799,46,845,1.5,480
238,15,2,15,210,20,230,1.2,480
239,1,1,16,486,63,549,1.2,480
239,1,2,8,209,20,229,1.0,480
239,1,3,9,701,93,794,1.0,480
239,2,2,26,351,15,366,1.0,480
239,2,3,18,762,93,855,1.2,480
239,3,1,9,761,10,771,1.0,480
239,3,3,17,246,8,254,1.2,480
239,4,1,9,611,59,670,1.0,480
239,4,2,18,344,2,346,1.2,480
239,4,3,30,210,15,225,1.5,480
239,5,2,21,790,35,825,1.5,480
239,5,3,1,254,13,267,1.5,480
239,6,1,22,461,42,503,1.2,480
239,6,2,36,339,42,381,0.8,480
239,6,3,20,468,26,494,1.5,480
239,7,2,7,796,101,897,1.0,480
239,7,3,33,372,49,421,0.8,480
239,8,1,26,766,100,866,1.0,480
239,8,2,16,745,81,826,1.2,480
239,8,3,17,241,17,258,1.2,480
239,9,1,7,350,47,397,1.0,480
239,9,2,1,751,78,829,1.5,480
239,10,1,34,535,51,586,1.0,480
239,10,2,29,773,39,812,0.8,480
239,10,3,35,414,38,452,0.8,480
239,11,1,10,611,32,643,1.2,480
239,11,2,34,288,26,314,1.0,480
239,11,3,16,264,38,302,1.2,480
239,12,1,7,287,15,302,1.0,480
239,12,2,1,792,107,899,1.5,480
239,12,3,29,539,7,546,0.8,480
239,13,1,5,622,13,635,1.0,480
239,13,2,10,610,74,684,1.2,480
239,13,3,37,435,23,458,1.2,480
239,14,1,30,759,30,789,1.5,480
239,14,2,25,366,24,390,1.5,480
239,14,3,1,390,40,430,1.5,480
239,15,3,33,393,3,396,0.8,480
240,1,1,10,244,24,268,1.2,480
240,1,3,32,736,74,810,0.8,480
240,2,1,35,522,9,531,0.8,480
240,2,2,32,440,37,477,0.8,480
240,2,3,37,474,39,513,1.2,480
240,3,1,37,390,21,411,1.2,480
240,3,2,9,532,7,539,1.0,480
240,3,3,7,531,4,535,1.0,480
240,4,1,38,345,12,357,1.5,480
240,4,2,19,754,88,842,1.5,480
240,5,1,20,428,13,441,1.5,480
240,5,2,1,581,46,627,1.5,480
240,5,3,38,308,43,351,1.5,480
240,6,1,25,204,17,221,1.5,480
240,6,2,37,247,13,260,1.2,480
240,7,1,24,303,12,315,1.0,480
240,7,2,15,706,99,805,1.2,480
240,7,3,16,446,59,505,1.2,480
240,8,1,37,337,12,349,1.2,480
240,8,2,27,234,16,250,0.8,480
240,8,3,8,723,18,741,1.0,480
240,9,1,12,425,32,457,1.5,480
240,9,2,2,650,59,709,0.8,480
240,9,3,36,569,7,576,0.8,480
240,10,1,27,775,20,795,0.8,480
240,10,2,27,686,32,718,0.8,480
240,10,3,29,623,10,633,0.8,480
240,11,1,15,486,15,501,1.2,480
240,11,2,14,593,23,616,1.0,480
240,11,3,20,681,37,718,1.5,480
240,12,2,4,346,42,388,0.8,480
240,12,3,18,354,12,366,1.2,480
240,13,2,36,528,58,586,0.8,480
240,13,3,2,257,24,281,0.8,480
240,14,1,14,647,31,678,1.0,480
240,14,2,13,314,4,318,1.0,480
240,14,3,15,307,44,351,1.2,480
240,15,1,3,618,50,668,1.5,480
240,15,2,20,538,3,541,1.5,480
240,15,3,19,325,36,361,1.5,480
241,1,1,15,658,68,726,1.2,480
241,1,2,1,596,52,648,1.5,480
241,1,3,18,457,15,472,1.2,480
241,2,1,29,348,32,380,0.8,480
241,2,3,18,763,12,775,1.2,480
241,3,2,27,266,19,285,0.8,480
241,3,3,36,704,19,723,0.8,480
241,4,1,29,456,54,510,0.8,480
241,4,3,37,262,33,295,1.2,480
241,5,1,22,739,74,813,1.2,480
241,5,2,20,445,26,471,1.5,480
241,5,3,4,617,83,700,0.8,480
241,6,1,29,283,29,312,0.8,480
241,6,2,21,339,12,351,1.5,480
241,6,3,5,208,9,217,1.0,480
241,7,1,27,510,34,544,0.8,480
241,7,3,39,432,51,483,1.0,480
241,8,1,22,250,10,260,1.2,480
241,8,2,27,732,20,752,0.8,480
241,8,3,33,383,7,390,0.8,480
241,9,1,18,360,21,381,1.2,480
241,9,2,19,723,61,784,1.5,480
241,9,3,30,269,5,274,1.5,480
241,10,1,16,655,24,679,1.2,480
241,10,2,39,315,25,340,1.0,480
241,10,3,28,467,29,496,1.5,480
241,11,1,10,308,13,321,1.2,480
241,11,2,10,591,83,674,1.2,480
241,11,3,4,518,9,527,0.8,480
241,12,1,4,470,53,523,0.8,480
241,12,2,2,745,105,850,0.8,480
241,13,1,13,379,24,403,1.0,480
241,13,2,22,642,0,642,1.2,480
241,13,3,35,517,2,519,0.8,480
241,14,1,25,528,26,554,1.5,480
241,14,3,19,693,95,788,1.5,480
241,15,2,24,719,42,761,1.0,480
242,1,1,20,557,45,602,1.5,480
242,1,2,34,223,19,242,1.0,480
242,1,3,13,331,47,378,1.0,480
242,2,1,10,353,44,397,1.2,480
242,2,2,28,584,12,596,1.5,480
242,2,3,6,474,69,543,1.5,480
242,3,2,28,275,3,278,1.5,480
242,4,1,18,683,15,698,1.2,480
242,4,3,22,657,29,686,1.2,480
242,5,1,5,610,72,682,1.0,480
242,5,2,29,365,33,398,0.8,480
242,5,3,35,738,85,823,0.8,480
242,6,1,20,515,40,555,1.5,480
242,6,2,17,503,28,531,1.2,480
242,6,3,16,255,29,284,1.2,480
242,7,1,30,515,63,578,1.5,480
242,7,2,10,690,94,784,1.2,480
242,7,3,9,640,85,725,1.0,480
242,8,1,38,337,34,371,1.5,480
242,8,2,12,709,24,733,1.5,480
242,8,3,37,301,12,313,1.2,480
242,9,1,37,548,23,571,1.2,480
242,9,2,16,521,36,557,1.2,480
242,9,3,4,433,10,443,0.8,480
242,10,1,5,431,48,479,1.0,480
242,10,3,15,466,35,501,1.2,480
242,11,1,13,491,41,532,1.0,480
242,11,3,40,212,29,241,1.5,480
242,12,2,22,653,31,684,1.2,480
242,12,3,14,706,55,761,1.0,480
242,13,1,3,674,64,738,1.5,480
242,13,2,39,353,51,404,1.0,480
242,14,1,17,478,49,527,1.2,480
242,14,2,26,786,24,810,1.0,480
242,14,3,8,415,8,423,1.0,480
242,15,1,21,668,95,763,1.5,480
242,15,2,38,343,36,379,1.5,480
242,15,3,2,790,48,838,0.8,480
243,1,1,18,617,54,671,1.2,480
243,1,2,3,667,45,712,1.5,480
243,1,3,33,453,12,465,0.8,480
243,2,1,22,564,70,634,1.2,480
243,2,2,9,378,19,397,1.0,480
243,2,3,17,753,63,816,1.2,480
243,3,2,16,752,1,753,1.2,480
243,3,3,31,231,28,259,1.2,480
243,4,1,13,208,21,229,1.0,480
243,4,2,26,501,58,559,1.0,480
243,4,3,2,307,12,319,0.8,480
243,5,1,1,553,15,568,1.5,480
243,5,2,19,259,37,296,1.5,480
243,5,3,8,233,8,241,1.0,480
243,6,1,38,688,8,696,1.5,480
243,6,2,37,719,54,773,1.2,480
243,6,3,27,765,95,860,0.8,480
243,7,1,36,254,13,267,0.8,480
243,7,2,39,769,27,796,1.0,480
243,7,3,20,476,34,510,1.5,480
243,8,1,29,244,23,267,0.8,480
243,8,2,26,374,32,406,1.0,480
243,8,3,12,601,29,630,1.5,480
243,9,1,17,664,32,696,1.2,480
243,9,2,3,520,66,586,1.5,480
243,9,3,33,586,3,589,0.8,480
243,10,1,23,626,59,685,1.2,480
243,10,2,15,604,85,689,1.2,480
243,10,3,13,309,9,318,1.0,480
243,11,1,38,609,6,615,1.5,480
243,11,2,27,316,15,331,0.8,480
243,12,1,24,755,103,858,1.0,480
243,12,2,5,393,29,422,1.0,480
243,12,3,22,397,40,437,1.2,480
243,13,1,2,373,4,377,0.8,480
243,13,3,14,625,16,641,1.0,480
243,14,1,24,436,10,446,1.0,480
243,14,2,39,606,79,685,1.0,480
243,15,1,9,637,71,708,1.0,480
243,15,2,6,511,8,519,1.5,480
243,15,3,6,493,58,551,1.5,480
244,1,1,34,295,1,296,1.0,480
244,1,2,22,468,50,518,1.2,480
244,2,1,5,742,83,825,1.0,480
244,2,3,10,292,37,329,1.2,480
244,3,1,38,323,28,351,1.5,480
244,3,2,4,330,17,347,0.8,480
244,3,3,12,440,33,473,1.5,480
244,4,1,16,209,26,235,1.2,480
244,4,2,33,420,33,453,0.8,480
244,4,3,4,398,3,401,0.8,480
244,5,1,4,443,21,464,0.8,480
244,5,3,3,525,69,594,1.5,480
244,6,1,39,645,83,728,1.0,480
244,6,3,39,523,40,563,1.0,480
244,7,1,17,201,24,225,1.2,480
244,7,2,34,355,3,358,1.0,480
244,8,1,24,388,11,399,1.0,480
244,8,2,14,440,56,496,1.0,480
244,8,3,12,679,96,775,1.5,480
244,9,1,34,274,27,301,1.0,480
244,9,2,19,648,85,733,1.5,480
244,10,1,33,589,74,663,0.8,480
244,10,2,23,336,28,364,1.2,480
244,10,3,15,409,51,460,1.2,480
244,11,1,25,587,80,667,1.5,480
244,11,2,38,538,21,559,1.5,480
244,11,3,7,450,30,480,1.0,480
244,12,1,6,507,73,580,1.5,480
244,12,2,9,783,32,815,1.0,480
244,12,3,25,541,73,614,1.5,480
244,13,1,32,622,81,703,0.8,480
244,13,2,32,226,19,245,0.8,480
244,13,3,14,678,87,765,1.0,480
244,14,1,18,344,45,389,1.2,480
244,14,2,24,297,41,338,1.0,480
244,14,3,36,265,20,285,0.8,480
244,15,1,5,258,18,276,1.0,480
244,15,2,23,259,34,293,1.2,480
244,15,3,7,357,3,360,1.0,480
245,1,1,22,406,4,410,1.2,480
245,1,2,15,440,64,504,1.2,480
245,1,3,11,647,87,734,1.0,480
245,2,1,2,599,5,604,0.8,480
245,2,2,6,304,28,332,1.5,480
245,2,3,22,779,104,883,1.2,480
245,3,2,36,705,47,752,0.8,480
245,3,3,24,570,57,627,1.0,480
245,4,1,18,762,78,840,1.2,480
245,4,2,15,547,39,586,1.2,480
245,4,3,36,539,79,618,0.8,480
245,5,2,24,391,44,435,1.0,480
245,5,3,30,532,10,542,1.5,480
245,6,2,24,364,41,405,1.0,480
245,6,3,7,598,69,667,1.0,480
245,7,1,40,334,40,374,1.5,480
245,7,2,2,348,19,367,0.8,480
245,8,2,7,245,12,257,1.0,480
245,9,1,16,497,2,499,1.2,480
245,9,2,35,491,53,544,0.8,480
245,9,3,30,671,24,695,1.5,480
245,10,1,14,519,46,565,1.0,480
245,10,2,34,434,37,471,1.0,480
245,11,1,15,452,46,498,1.2,480
245,11,2,2,794,33,827,0.8,480
245,11,3,40,355,28,383,1.5,480
245,12,1,38,283,10,293,1.5,480
245,12,2,23,214,24,238,1.2,480
245,12,3,18,306,11,317,1.2,480
245,13,1,19,624,52,676,1.5,480
245,13,2,14,203,1,204,1.0,480
245,13,3,32,583,51,634,0.8,480
245,14,1,19,718,60,778,1.5,480
245,14,2,40,548,36,584,1.5,480
245,14,3,17,627,67,694,1.2,480
245,15,2,15,210,0,210,1.2,480
245,15,3,14,594,17,611,1.0,480
246,1,1,40,716,14,730,1.5,480
246,1,2,31,793,17,810,1.2,480
246,1,3,3,404,31,435,1.5,480
246,2,1,21,419,52,471,1.5,480
246,2,2,12,421,5,426,1.5,480
246,2,3,12,458,8,466,1.5,480
246,3,2,23,540,58,598,1.2,480
246,3,3,22,598,31,629,1.2,480
246,4,1,17,684,86,770,1.2,480
246,4,2,4,666,18,684,0.8,480
246,4,3,24,268,29,297,1.0,480
246,5,1,1,700,23,723,1.5,480
246,5,2,25,581,58,639,1.5,480
246,5,3,18,337,12,349,1.2,480
246,6,1,15,724,24,748,1.2,480
246,6,2,35,690,39,729,0.8,480
246,6,3,19,223,10,233,1.5,480
246,7,1,33,563,9,572,0.8,480
246,7,2,21,262,37,299,1.5,480
246,7,3,5,363,25,388,1.0,480
246,8,1,31,587,13,600,1.2,480
246,8,2,17,352,32,384,1.2,480
246,8,3,32,223,15,238,0.8,480
246,9,1,21,318,38,356,1.5,480
246,9,2,11,499,15,514,1.0,480
246,9,3,4,492,58,550,0.8,480
246,10,1,11,734,27,761,1.0,480
246,10,3,10,660,62,722,1.2,480
246,11,1,40,341,35,376,1.5,480
246,11,2,4,657,29,686,0.8,480
246,11,3,4,256,30,286,0.8,480
246,12,1,6,402,49,451,1.5,480
246,12,2,5,579,67,646,1.0,480
246,12,3,20,351,6,357,1.5,480
246,13,1,1,434,46,480,1.5,480
246,14,1,11,232,14,246,1.0,480
246,14,2,17,416,6,422,1.2,480
246,14,3,19,413,21,434,1.5,480
246,15,1,31,423,14,437,1.2,480
246,15,2,18,594,10,604,1.2,480
246,15,3,16,217,14,231,1.2,480
247,1,1,17,431,19,450,1.2,480
247,1,2,29,416,60,476,0.8,480
247,1,3,14,454,48,502,1.0,480
247,2,1,27,337,31,368,0.8,480
247,2,2,5,790,96,886,1.0,480
247,2,3,34,450,15,465,1.0,480
247,3,1,22,578,29,607,1.2,480
247,3,3,14,560,47,607,1.0,480
247,4,1,19,765,36,801,1.5,480
247,4,3,30,350,9,359,1.5,480
247,5,1,40,406,54,460,1.5,480
247,5,2,4,722,90,812,0.8,480
247,5,3,29,213,18,231,0.8,480
247,6,1,40,768,15,783,1.5,480
247,6,2,31,578,53,631,1.2,480
247,6,3,19,729,78,807,1.5,480
247,7,1,4,304,1,305,0.8,480
247,7,3,19,748,10,758,1.5,480
247,8,1,14,782,58,840,1.0,480
247,8,2,21,628,0,628,1.5,480
247,8,3,9,788,21,809,1.0,480
247,9,3,17,524,60,584,1.2,480
247,10,1,13,547,16,563,1.0,480
247,10,2,11,742,75,817,1.0,480
247,10,3,23,382,34,416,1.2,480
247,11,1,7,507,34,541,1.0,480
247,11,2,26,520,45,565,1.0,480
247,11,3,24,288,28,316,1.0,480
247,12,1,29,337,30,367,0.8,480
247,12,2,7,407,47,454,1.0,480
247,12,3,1,628,75,703,1.5,480
247,13,1,33,556,26,582,0.8,480
247,13,2,13,486,15,501,1.0,480
247,14,1,36,570,44,614,0.8,480
247,14,3,28,384,11,395,1.5,480
247,15,1,39,764,110,874,1.0,480
247,15,2,26,215,25,240,1.0,480
247,15,3,24,785,33,818,1.0,480
248,1,1,20,708,26,734,1.5,480
248,1,2,32,523,17,540,0.8,480
248,1,3,31,570,23,593,1.2,480
248,2,1,2,654,5,659,0.8,480
248,2,2,5,400,52,452,1.0,480
248,2,3,26,471,15,486,1.0,480
248,3,1,8,705,36,741,1.0,480
248,3,2,3,577,45,622,1.5,480
248,3,3,16,416,50,466,1.2,480
248,4,2,35,401,54,455,0.8,480
248,4,3,18,559,32,591,1.2,480
248,5,1,5,204,20,224,1.0,480
248,5,2,20,459,2,461,1.5,480
248,5,3,30,425,23,448,1.5,480
248,6,1,38,767,93,860,1.5,480
248,6,2,27,621,86,707,0.8,480
248,6,3,17,495,11,506,1.2,480
248,7,1,11,370,44,414,1.0,480
248,7,2,36,749,16,765,0.8,480
248,8,1,32,632,41,673,0.8,480
248,8,2,12,440,59,499,1.5,480
248,8,3,22,636,4,640,1.2,480
248,9,1,3,511,45,556,1.5,480
248,9,2,27,450,2,452,0.8,480
248,9,3,21,703,56,759,1.5,480
248,10,3,22,584,84,668,1.2,480
248,11,1,7,550,40,590,1.0,480
248,11,2,40,421,0,421,1.5,480
248,11,3,6,557,22,579,1.5,480
248,12,2,40,436,36,472,1.5,480
248,12,3,35,400,27,427,0.8,480
248,13,1,23,562,8,570,1.2,480
248,13,2,24,229,12,241,1.0,480
248,13,3,15,347,5,352,1.2,480
248,14,1,23,301,12,313,1.2,480
248,14,2,39,666,4,670,1.0,480
248,14,3,28,436,19,455,1.5,480
248,15,1,31,433,6,439,1.2,480
248,15,2,35,694,7,701,0.8,480
248,15,3,15,467,33,500,1.2,480
249,1,2,31,521,43,564,1.2,480
249,1,3,31,405,44,449,1.2,480
249,2,1,7,680,24,704,1.0,480
249,3,1,25,500,4,504,1.5,480
249,3,3,29,568,14,582,0.8,480
249,4,1,1,207,26,233,1.5,480
249,4,3,1,484,49,533,1.5,480
249,5,1,2,688,9,697,0.8,480
249,5,3,5,239,5,244,1.0,480
249,6,1,21,351,48,399,1.5,480
249,6,2,29,643,78,721,0.8,480
249,6,3,12,517,46,563,1.5,480
249,7,1,22,636,62,698,1.2,480
249,7,2,40,399,51,450,1.5,480
249,7,3,16,223,18,241,1.2,480
249,8,1,17,687,44,731,1.2,480
249,8,2,2,239,26,265,0.8,480
249,8,3,17,428,12,440,1.2,480
249,9,1,21,670,59,729,1.5,480
249,9,2,35,414,33,447,0.8,480
249,10,1,31,278,12,290,1.2,480
249,10,2,32,417,37,454,0.8,480
249,10,3,32,438,45,483,0.8,480
249,11,1,17,413,25,438,1.2,480
249,11,2,2,721,23,744,0.8,480
249,11,3,17,642,70,712,1.2,480
249,12,1,15,235,28,263,1.2,480
249,12,2,5,725,58,783,1.0,480
249,12,3,24,789,16,805,1.0,480
249,13,1,13,614,84,698,1.0,480
249,13,2,28,566,37,603,1.5,480
249,13,3,4,329,4,333,0.8,480
249,14,1,36,306,38,344,0.8,480
249,14,2,36,305,27,332,0.8,480
249,14,3,27,750,74,824,0.8,480
249,15,1,37,370,40,410,1.2,480
249,15,3,1,490,34,524,1.5,480
250,1,1,26,386,6,392,1.0,480
250,1,2,4,445,22,467,0.8,480
250,1,3,12,219,15,234,1.5,480
250,2,1,16,727,69,796,1.2,480
250,2,3,6,733,27,760,1.5,480
250,3,1,14,654,60,714,1.0,480
250,3,2,23,662,35,697,1.2,480
250,3,3,38,611,7,618,1.5,480
250,4,1,19,373,40,413,1.5,480
250,4,2,17,655,87,742,1.2,480
250,5,1,19,647,55,702,1.5,480
250,5,2,17,276,28,304,1.2,480
250,5,3,22,689,91,780,1.2,480
250,6,1,2,655,65,720,0.8,480
250,6,2,20,644,72,716,1.5,480
250,7,1,32,276,11,287,0.8,480
250,7,2,13,744,109,853,1.0,480
250,7,3,32,686,94,780,0.8,480
250,8,2,39,770,28,798,1.0,480
250,8,3,11,754,104,858,1.0,480
250,9,2,16,708,4,712,1.2,480
250,10,1,11,251,28,279,1.0,480
250,10,2,37,655,81,736,1.2,480
250,11,1,30,413,18,431,1.5,480
250,11,2,28,620,86,706,1.5,480
250,12,1,33,695,12,707,0.8,480
250,12,2,12,614,18,632,1.5,480
250,12,3,31,555,0,555,1.2,480
250,13,1,26,534,30,564,1.0,480
250,13,3,6,501,59,560,1.5,480
250,14,1,19,459,37,496,1.5,480
250,14,2,24,369,15,384,1.0,480
250,14,3,22,786,115,901,1.2,480
250,15,2,13,237,28,265,1.0,480
250,15,3,13,432,63,495,1.0,480
251,1,2,14,320,18,338,1.0,480
251,1,3,40,262,23,285,1.5,480
251,2,1,37,526,35,561,1.2,480
251,2,2,4,673,41,714,0.8,480
251,2,3,33,393,41,434,0.8,480
251,3,1,9,657,43,700,1.0,480
251,3,2,23,624,65,689,1.2,480
251,4,3,11,522,45,567,1.0,480
251,5,1,23,219,0,219,1.2,480
251,5,2,32,254,11,265,0.8,480
251,5,3,37,732,89,821,1.2,480
251,6,1,8,590,37,627,1.0,480
251,6,2,10,761,58,819,1.2,480
251,6,3,35,543,27,570,0.8,480
251,7,1,37,497,65,562,1.2,480
251,7,3,38,735,104,839,1.5,480
251,8,1,33,310,12,322,0.8,480
251,8,2,30,339,7,346,1.5,480
251,9,1,22,567,29,596,1.2,480
251,9,3,7,477,23,500,1.0,480
251,10,1,14,229,0,229,1.0,480
251,10,2,35,556,67,623,0.8,480
251,10,3,5,491,36,527,1.0,480
251,11,1,37,248,7,255,1.2,480
251,11,2,6,590,28,618,1.5,480
251,11,3,2,490,18,508,0.8,480
251,12,1,19,348,49,397,1.5,480
251,12,2,26,614,17,631,1.0,480
251,12,3,36,669,77,746,0.8,480
251,13,1,39,544,77,621,1.0,480
251,13,2,25,368,6,374,1.5,480
251,13,3,39,210,26,236,1.0,480
251,14,2,14,216,16,232,1.0,480
251,14,3,36,566,28,594,0.8,480
251,15,1,36,763,26,789,0.8,480
251,15,2,31,647,79,726,1.2,480
251,15,3,16,448,55,503,1.2,480
252,1,1,36,665,64,729,0.8,480
252,1,2,18,625,6,631,1.2,480
252,1,3,37,560,68,628,1.2,480
252,2,2,37,440,29,469,1.2,480
252,2,3,15,368,20,388,1.2,480
252,3,1,28,398,24,422,1.5,480
252,3,2,16,549,64,613,1.2,480
252,3,3,27,655,14,669,0.8,480
252,4,2,5,544,23,567,1.0,480
252,4,3,11,683,43,726,1.0,480
252,5,1,27,500,18,518,0.8,480
252,5,2,25,366,44,410,1.5,480
252,5,3,9,391,41,432,1.0,480
252,6,1,2,349,38,387,0.8,480
252,6,3,22,368,10,378,1.2,480
252,7,1,23,380,26,406,1.2,480
252,7,2,37,510,13,523,1.2,480
252,7,3,29,381,36,417,0.8,480
252,8,2,38,335,7,342,1.5,480
252,8,3,7,718,101,819,1.0,480
252,9,1,23,489,39,528,1.2,480
252,9,3,37,358,25,383,1.2,480
252,10,1,33,310,42,352,0.8,480
252,10,2,23,509,46,555,1.2,480
252,10,3,23,575,12,587,1.2,480
252,11,1,10,768,111,879,1.2,480
252,11,3,14,705,81,786,1.0,480
252,12,1,5,694,54,748,1.0,480
252,12,2,36,297,10,307,0.8,480
252,12,3,20,303,40,343,1.5,480
252,13,2,2,306,12,318,0.8,480
252,13,3,40,321,14,335,1.5,480
252,14,2,39,635,87,722,1.0,480
252,14,3,29,624,70,694,0.8,480
252,15,2,11,270,15,285,1.0,480
252,15,3,28,308,5,313,1.5,480
253,1,1,27,593,76,669,0.8,480
253,1,3,6,313,15,328,1.5,480
253,2,1,14,447,55,502,1.0,480
253,3,1,9,503,2,505,1.0,480
253,3,2,40,715,80,795,1.5,480
253,3,3,24,327,23,350,1.0,480
253,4,1,27,314,23,337,0.8,480
253,4,3,27,728,58,786,0.8,480
253,5,1,27,691,15,706,0.8,480
253,5,2,25,610,68,678,1.5,480
253,5,3,35,412,26,438,0.8,480
253,6,2,5,541,58,599,1.0,480
253,6,3,32,791,103,894,0.8,480
253,7,1,38,343,47,390,1.5,480
253,7,2,29,253,2,255,0.8,480
253,7,3,35,264,9,273,0.8,480
253,8,1,7,766,47,813,1.0,480
253,8,2,8,581,23,604,1.0,480
253,8,3,5,616,68,684,1.0,480
253,9,1,39,248,25,273,1.0,480
253,9,2,8,415,29,444,1.0,480
253,9,3,2,613,32,645,0.8,480
253,10,2,16,235,9,244,1.2,480
253,10,3,23,512,33,545,1.2,480
253,11,1,26,207,21,228,1.0,480
253,11,2,32,758,19,777,0.8,480
253,12,1,24,608,13,621,1.0,480
253,12,2,18,623,28,651,1.2,480
253,13,1,9,755,70,825,1.0,480
253,13,2,14,580,10,590,1.0,480
253,13,3,35,718,26,744,0.8,480
253,14,2,35,704,64,768,0.8,480
253,15,1,31,503,2,505,1.2,480
253,15,3,12,390,21,411,1.5,480
254,1,1,13,453,62,515,1.0,480
254,1,2,6,761,63,824,1.5,480
254,2,1,16,688,70,758,1.2,480
254,2,2,21,724,97,821,1.5,480
254,2,3,40,517,60,577,1.5,480
254,3,1,38,328,4,332,1.5,480
254,3,2,27,684,24,708,0.8,480
254,3,3,7,260,20,280,1.0,480
254,4,1,5,640,47,687,1.0,480
254,4,2,20,551,41,592,1.5,480
254,4,3,31,446,8,454,1.2,480
254,5,1,40,666,0,666,1.5,480
254,6,1,7,735,30,765,1.0,480
254,7,2,18,514,58,572,1.2,480
254,7,3,13,455,46,501,1.0,480
254,8,1,37,640,23,663,1.2,480
254,8,2,14,227,24,251,1.0,480
254,8,3,33,259,11,270,0.8,480
254,9,1,40,227,21,248,1.5,480
254,9,2,31,571,45,616,1.2,480
254,9,3,22,518,52,570,1.2,480
254,10,3,5,269,35,304,1.0,480
254,11,1,15,454,9,463,1.2,480
254,11,2,21,360,6,366,1.5,480
254,12,1,21,385,30,415,1.5,480
254,12,2,28,575,75,650,1.5,480
254,12,3,31,573,53,626,1.2,480
254,13,1,26,412,60,472,1.0,480
254,13,2,16,571,18,589,1.2,480
254,13,3,28,716,97,813,1.5,480
254,14,1,18,615,61,676,1.2,480
254,14,2,26,653,13,666,1.0,480
254,14,3,7,296,42,338,1.0,480
254,15,1,12,210,18,228,1.5,480
255,1,2,21,576,8,584,1.5,480
255,2,2,21,361,44,405,1.5,480
255,2,3,13,450,57,507,1.0,480
255,3,1,17,223,12,235,1.2,480
255,3,2,31,359,43,402,1.2,480
255,3,3,21,784,12,796,1.5,480
255,4,1,20,534,76,610,1.5,480
255,4,2,34,430,52,482,1.0,480
255,5,1,40,497,51,548,1.5,480
255,5,2,18,731,82,813,1.2,480
255,5,3,26,633,49,682,1.0,480
255,6,1,40,426,13,439,1.5,480
255,6,2,31,625,81,706,1.2,480
255,6,3,20,548,81,629,1.5,480
255,7,1,8,775,87,862,1.0,480
255,7,2,34,489,43,532,1.0,480
255,7,3,21,576,3,579,1.5,480
255,8,1,31,618,70,688,1.2,480
255,8,2,25,492,45,537,1.5,480
255,8,3,39,367,24,391,1.0,480
255,9,2,17,265,19,284,1.2,480
255,9,3,26,602,3,605,1.0,480
255,10,2,16,769,34,803,1.2,480
255,11,1,17,638,24,662,1.2,480
255,11,2,19,613,4,617,1.5,480
255,11,3,17,785,34,819,1.2,480
255,12,1,20,224,11,235,1.5,480
255,12,2,32,361,53,414,0.8,480
255,12,3,16,705,52,757,1.2,480
255,13,1,35,218,15,233,0.8,480
255,13,2,13,682,43,725,1.0,480
255,13,3,22,754,96,850,1.2,480
255,14,1,33,211,12,223,0.8,480
255,14,2,17,405,3,408,1.2,480
255,15,1,12,784,101,885,1.5,480
255,15,2,22,603,4,607,1.2,480
255,15,3,40,285,11,296,1.5,480
256,1,1,13,752,101,853,1.0,480
256,1,2,9,568,48,616,1.0,480
256,1,3,38,477,23,500,1.5,480
256,2,1,13,713,80,793,1.0,480
256,2,2,33,748,37,785,0.8,480
256,2,3,33,771,31,802,0.8,480
256,3,1,19,362,30,392,1.5,480
256,3,2,17,388,23,411,1.2,480
256,3,3,17,557,7,564,1.2,480
256,4,1,31,797,45,842,1.2,480
256,4,3,14,332,41,373,1.0,480
256,5,1,16,617,23,640,1.2,480
256,5,2,34,728,22,750,1.0,480
256,6,3,10,451,1,452,1.2,480
256,7,1,5,674,15,689,1.0,480
256,7,2,37,637,80,717,1.2,480
256,7,3,23,234,10,244,1.2,480
256,8,2,10,603,13,616,1.2,480
256,8,3,1,483,52,535,1.5,480
256,9,1,37,715,24,739,1.2,480
256,9,2,40,747,70,817,1.5,480
256,9,3,31,740,43,783,1.2,480
256,10,2,32,219,8,227,0.8,480
256,10,3,38,410,0,410,1.5,480
256,11,1,17,485,5,490,1.2,480
256,11,2,38,642,60,702,1.5,480
256,11,3,36,518,41,559,0.8,480
256,12,1,11,414,30,444,1.0,480
256,12,2,38,581,27,608,1.5,480
256,12,3,5,782,12,794,1.0,480
256,13,1,12,356,5,361,1.5,480
256,13,2,5,205,16,221,1.0,480
256,13,3,25,371,11,382,1.5,480
256,14,3,2,257,23,280,0.8,480
256,15,1,19,589,36,625,1.5,480
256,15,2,8,208,29,237,1.0,480
256,15,3,28,371,40,411,1.5,480
257,1,1,35,549,56,605,0.8,480
257,1,2,36,722,61,783,0.8,480
257,1,3,6,563,54,617,1.5,480
257,2,1,15,646,11,657,1.2,480
257,2,2,14,281,11,292,1.0,480
257,2,3,1,512,61,573,1.5,480
257,3,1,33,661,3,664,0.8,480
257,3,3,9,710,86,796,1.0,480
257,4,1,14,708,29,737,1.0,480
257,4,2,10,296,36,332,1.2,480
257,4,3,28,466,37,503,1.5,480
257,5,1,3,207,17,224,1.5,480
257,5,2,28,461,17,478,1.5,480
257,5,3,13,739,57,796,1.0,480
257,6,2,24,573,33,606,1.0,480
257,6,3,4,774,12,786,0.8,480
257,7,2,8,430,30,460,1.0,480
257,7,3,29,277,33,310,0.8,480
257,8,1,11,517,23,540,1.0,480
257,8,2,11,645,0,645,1.0,480
257,8,3,36,245,0,245,0.8,480
257,9,1,14,481,66,547,1.0,480
257,9,3,5,565,67,632,1.0,480
257,10,1,39,453,40,493,1.0,480
257,10,2,26,676,83,759,1.0,480
257,11,1,29,419,21,440,0.8,480
257,11,2,16,678,13,691,1.2,480
257,11,3,19,648,69,717,1.5,480
257,12,1,4,241,22,263,0.8,480
257,12,2,24,290,36,326,1.0,480
257,12,3,29,258,16,274,0.8,480
257,13,2,2,436,53,489,0.8,480
257,13,3,37,498,9,507,1.2,480
257,14,1,17,419,58,477,1.2,480
257,14,2,31,736,8,744,1.2,480
257,14,3,22,446,34,480,1.2,480
257,15,1,27,746,100,846,0.8,480
257,15,2,32,455,33,488,0.8,480
257,15,3,27,598,79,677,0.8,480
258,1,1,38,456,14,470,1.5,480
258,1,2,25,515,36,551,1.5,480
258,1,3,25,229,17,246,1.5,480
258,2,1,9,215,10,225,1.0,480
258,2,2,28,738,91,829,1.5,480
258,2,3,7,789,52,841,1.0,480
258,3,1,14,750,30,780,1.0,480
258,3,2,32,307,7,314,0.8,480
258,3,3,10,782,65,847,1.2,480
258,4,1,38,203,25,228,1.5,480
258,4,2,20,763,83,846,1.5,480
258,4,3,30,254,13,267,1.5,480
258,5,1,32,752,45,797,0.8,480
258,5,2,1,312,32,344,1.5,480
258,5,3,15,750,104,854,1.2,480
258,6,1,14,726,25,751,1.0,480
258,6,3,26,641,84,725,1.0,480
258,7,1,24,475,0,475,1.0,480
258,7,2,9,773,100,873,1.0,480
258,7,3,9,406,37,443,1.0,480
258,8,1,19,529,68,597,1.5,480
258,8,2,27,269,21,290,0.8,480
258,8,3,23,515,30,545,1.2,480
258,9,1,38,254,24,278,1.5,480
258,9,2,32,695,10,705,0.8,480
258,9,3,15,547,71,618,1.2,480
258,10,1,39,730,78,808,1.0,480
258,10,2,14,349,50,399,1.0,480
258,10,3,1,473,63,536,1.5,480
258,11,2,26,772,52,824,1.0,480
258,11,3,15,376,43,419,1.2,480
258,12,1,11,366,3,369,1.0,480
258,12,2,9,742,76,818,1.0,480
258,12,3,16,399,57,456,1.2,480
258,13,1,35,493,44,537,0.8,480
258,13,2,4,279,10,289,0.8,480
258,13,3,33,267,3,270,0.8,480
258,14,1,21,319,1,320,1.5,480
258,14,2,36,246,3,249,0.8,480
258,14,3,29,343,10,353,0.8,480
258,15,1,11,482,52,534,1.0,480
258,15,3,35,446,47,493,0.8,480
259,1,2,27,606,57,663,0.8,480
259,1,3,3,207,22,229,1.5,480
259,2,1,1,279,22,301,1.5,480
259,2,2,39,520,13,533,1.0,480
259,2,3,24,383,1,384,1.0,480
259,3,1,34,436,2,438,1.0,480
259,3,2,29,491,68,559,0.8,480
259,3,3,31,226,7,233,1.2,480
259,4,1,21,545,55,600,1.5,480
259,4,2,4,518,50,568,0.8,480
259,5,1,15,675,66,741,1.2,480
259,5,2,14,456,1,457,1.0,480
259,5,3,32,202,25,227,0.8,480
259,6,1,23,201,2,203,1.2,480
259,6,2,2,335,0,335,0.8,480
259,6,3,32,654,50,704,0.8,480
259,7,1,7,590,79,669,1.0,480
259,7,3,11,398,4,402,1.0,480
259,8,1,15,264,10,274,1.2,480
259,8,2,36,444,1,445,0.8,480
259,8,3,2,647,33,680,0.8,480
259,9,1,1,593,18,611,1.5,480
259,9,2,26,261,21,282,1.0,480
259,9,3,25,293,29,322,1.5,480
259,10,1,21,283,38,321,1.5,480
259,11,2,20,288,6,294,1.5,480
259,11,3,17,671,57,728,1.2,480
259,12,3,23,662,83,745,1.2,480
259,13,1,25,753,27,780,1.5,480
259,13,2,20,587,86,673,1.5,480
259,13,3,27,547,9,556,0.8,480
259,14,1,7,698,92,790,1.0,480
259,14,2,34,576,19,595,1.0,480
259,14,3,27,498,16,514,0.8,480
259,15,1,13,781,96,877,1.0,480
259,15,2,21,713,45,758,1.5,480
259,15,3,32,576,72,648,0.8,480
260,1,1,30,708,92,800,1.5,480
260,1,3,36,363,51,414,0.8,480
260,2,1,29,546,6,552,0.8,480
260,2,2,4,410,17,427,0.8,480
260,2,3,39,482,63,545,1.0,480
260,3,2,7,528,55,583,1.0,480
260,4,1,24,345,27,372,1.0,480
260,4,2,31,740,89,829,1.2,480
260,4,3,39,557,50,607,1.0,480
260,5,1,28,283,5,288,1.5,480
260,5,2,20,468,18,486,1.5,480
260,5,3,24,259,17,276,1.0,480
260,6,1,11,533,2,535,1.0,480
260,7,1,31,661,97,758,1.2,480
260,7,2,8,427,2,429,1.0,480
260,7,3,15,246,5,251,1.2,480
260,8,2,33,577,8,585,0.8,480
260,8,3,2,760,94,854,0.8,480
260,9,1,11,396,52,448,1.0,480
260,9,2,11,553,7,560,1.0,480
260,9,3,21,235,21,256,1.5,480
260,10,2,20,290,33,323,1.5,480
260,10,3,23,403,48,451,1.2,480
260,11,3,21,498,30,528,1.5,480
260,12,1,23,612,74,686,1.2,480
260,12,2,25,647,22,669,1.5,480
260,12,3,6,233,16,249,1.5,480
260,13,3,34,525,39,564,1.0,480
260,14,1,27,608,57,665,0.8,480
260,14,3,29,494,30,524,0.8,480
260,15,1,15,417,24,441,1.2,480
260,15,2,18,761,18,779,1.2,480
260,15,3,16,682,75,757,1.2,480
261,1,1,33,565,10,575,0.8,480
261,1,2,23,386,40,426,1.2,480
261,1,3,3,373,42,415,1.5,480
261,2,1,1,264,26,290,1.5,480
261,2,2,9,701,88,789,1.0,480
261,2,3,36,336,42,378,0.8,480
261,3,1,38,757,26,783,1.5,480
261,3,2,3,254,25,279,1.5,480
261,3,3,34,599,16,615,1.0,480
261,4,2,6,437,1,438,1.5,480
261,4,3,28,494,41,535,1.5,480
261,5,1,29,266,27,293,0.8,480
261,5,2,32,728,105,833,0.8,480
261,5,3,16,382,12,394,1.2,480
261,6,1,29,493,26,519,0.8,480
261,6,2,23,358,43,401,1.2,480
261,6,3,36,796,99,895,0.8,480
261,7,1,31,319,32,351,1.2,480
261,7,2,27,368,13,381,0.8,480
261,7,3,24,347,41,388,1.0,480
261,8,1,19,201,16,217,1.5,480
261,8,2,7,654,70,724,1.0,480
261,8,3,14,772,26,798,1.0,480
261,9,1,22,778,80,858,1.2,480
261,9,2,38,455,0,455,1.5,480
261,9,3,28,451,36,487,1.5,480
261,10,1,27,429,26,455,0.8,480
261,10,2,17,395,45,440,1.2,480
261,10,3,30,623,82,705,1.5,480
261,11,1,19,390,28,418,1.5,480
261,11,2,24,413,40,453,1.0,480
261,11,3,35,317,3,320,0.8,480
261,12,1,7,367,51,418,1.0,480
261,12,2,2,618,14,632,0.8,480
261,12,3,32,619,54,673,0.8,480
261,13,1,35,752,71,823,0.8,480
261,13,2,11,393,56,449,1.0,480
261,13,3,39,675,67,742,1.0,480
261,14,1,32,454,18,472,0.8,480
261,14,3,9,408,48,456,1.0,480
261,15,1,16,402,26,428,1.2,480
261,15,2,22,584,31,615,1.2,480
261,15,3,18,720,85,805,1.2,480
262,2,1,13,398,34,432,1.0,480
262,2,2,9,275,31,306,1.0,480
262,3,1,26,748,111,859,1.0,480
262,3,2,21,293,10,303,1.5,480
262,3,3,23,488,50,538,1.2,480
262,4,1,29,640,22,662,0.8,480
262,4,2,40,435,55,490,1.5,480
262,4,3,25,598,6,604,1.5,480
262,5,1,5,663,79,742,1.0,480
262,5,2,35,578,48,626,0.8,480
262,5,3,24,236,12,248,1.0,480
262,6,1,7,289,17,306,1.0,480
262,6,2,19,512,49,561,1.5,480
262,6,3,30,448,43,491,1.5,480
262,7,1,29,450,51,501,0.8,480
262,7,2,25,651,90,741,1.5,480
262,7,3,14,339,38,377,1.0,480
262,8,1,11,276,27,303,1.0,480
262,8,2,33,270,22,292,0.8,480
262,8,3,31,592,62,654,1.2,480
262,9,2,9,691,91,782,1.0,480
262,9,3,28,720,101,821,1.5,480
262,10,1,9,619,17,636,1.0,480
262,10,2,7,653,82,735,1.0,480
262,10,3,5,682,23,705,1.0,480
262,11,1,32,571,37,608,0.8,480
262,11,2,37,734,64,798,1.2,480
262,12,1,34,256,35,291,1.0,480
262,12,2,15,561,20,581,1.2,480
262,12,3,38,372,18,390,1.5,480
262,13,2,6,277,6,283,1.5,480
262,13,3,16,659,73,732,1.2,480
262,14,1,22,675,98,773,1.2,480
262,14,2,11,580,24,604,1.0,480
262,14,3,9,702,39,741,1.0,480
262,15,1,28,354,7,361,1.5,480
262,15,2,30,746,97,843,1.5,480
262,15,3,26,473,46,519,1.0,480
263,1,1,23,491,9,500,1.2,480
263,1,2,14,506,56,562,1.0,480
263,1,3,19,519,41,560,1.5,480
263,2,1,34,749,33,782,1.0,480
263,2,2,39,734,42,776,1.0,480
263,3,1,8,549,30,579,1.0,480
263,3,2,35,611,13,624,0.8,480
263,3,3,25,444,48,492,1.5,480
263,4,1,10,777,25,802,1.2,480
263,4,3,15,277,9,286,1.2,480
263,5,1,13,424,58,482,1.0,480
263,5,2,15,418,17,435,1.2,480
263,5,3,16,284,25,309,1.2,480
263,6,1,3,709,42,751,1.5,480
263,6,2,16,706,21,727,1.2,480
263,6,3,9,756,46,802,1.0,480
263,7,1,40,388,47,435,1.5,480
263,7,2,1,727,0,727,1.5,480
263,7,3,24,750,81,831,1.0,480
263,8,1,18,458,17,475,1.2,480
263,8,3,23,339,11,350,1.2,480
263,9,1,37,571,4,575,1.2,480
263,9,2,9,427,25,452,1.0,480
263,9,3,2,200,29,229,0.8,480
263,10,1,2,372,50,422,0.8,480
263,10,2,37,747,89,836,1.2,480
263,10,3,21,634,38,672,1.5,480
263,11,1,11,588,16,604,1.0,480
263,11,2,3,248,19,267,1.5,480
263,11,3,10,228,10,238,1.2,480
263,12,1,13,393,24,417,1.0,480
263,12,2,21,358,47,405,1.5,480
263,12,3,28,330,37,367,1.5,480
263,13,1,7,791,15,806,1.0,480
263,13,2,24,253,5,258,1.0,480
263,14,1,24,448,2,450,1.0,480
263,14,2,39,583,74,657,1.0,480
263,14,3,4,278,36,314,0.8,480
263,15,1,27,637,90,727,0.8,480
263,15,3,11,792,100,892,1.0,480
264,1,1,6,498,31,529,1.5,480
264,1,3,27,227,23,250,0.8,480
264,2,1,37,361,38,399,1.2,480
264,2,3,20,620,40,660,1.5,480
264,3,1,14,623,91,714,1.0,480
264,3,2,30,689,59,748,1.5,480
264,3,3,39,268,4,272,1.0,480
264,4,1,37,618,61,679,1.2,480
264,4,2,12,492,43,535,1.5,480
264,4,3,24,427,41,468,1.0,480
264,5,1,30,735,57,792,1.5,480
264,5,2,23,591,53,644,1.2,480
264,5,3,18,500,19,519,1.2,480
264,6,1,20,273,35,308,1.5,480
264,6,2,24,260,26,286,1.0,480
264,7,1,34,487,47,534,1.0,480
264,7,2,37,281,38,319,1.2,480
264,7,3,20,730,84,814,1.5,480
264,8,1,39,392,55,447,1.0,480
264,8,3,11,312,28,340,1.0,480
264,9,2,21,621,66,687,1.5,480
264,9,3,23,693,17,710,1.2,480
264,10,1,2,410,18,428,0.8,480
264,10,2,7,245,9,254,1.0,480
264,11,1,40,231,15,246,1.5,480
264,11,3,2,496,48,544,0.8,480
264,12,1,5,395,37,432,1.0,480
264,12,3,28,591,22,613,1.5,480
264,13,2,16,208,1,209,1.2,480
264,13,3,1,264,28,292,1.5,480
264,14,2,34,230,31,261,1.0,480
264,14,3,20,759,1,760,1.5,480
264,15,1,38,760,9,769,1.5,480
264,15,2,37,621,15,636,1.2,480
265,1,1,40,793,116,909,1.5,480
265,1,3,27,343,50,393,0.8,480
265,2,1,5,314,41,355,1.0,480
265,2,2,36,758,37,795,0.8,480
265,2,3,16,535,54,589,1.2,480
265,3,1,31,738,41,779,1.2,480
265,3,3,12,644,29,673,1.5,480
265,4,1,34,460,40,500,1.0,480
265,4,2,23,747,93,840,1.2,480
265,5,1,40,581,66,647,1.5,480
265,5,3,3,421,26,447,1.5,480
265,6,1,2,381,45,426,0.8,480
265,6,2,35,300,10,310,0.8,480
265,6,3,29,496,66,562,0.8,480
265,7,1,30,417,4,421,1.5,480
265,7,2,15,222,13,235,1.2,480
265,7,3,27,424,39,463,0.8,480
265,8,1,17,660,77,737,1.2,480
265,8,2,36,600,66,666,0.8,480
265,8,3,32,473,4,477,0.8,480
265,9,2,36,590,83,673,0.8,480
265,9,3,31,645,86,731,1.2,480
265,10,1,2,770,21,791,0.8,480
265,10,3,34,562,47,609,1.0,480
265,11,1,1,695,46,741,1.5,480
265,12,1,19,551,30,581,1.5,480
265,12,2,36,404,27,431,0.8,480
265,12,3,11,715,74,789,1.0,480
265,13,1,19,365,8,373,1.5,480
265,13,2,13,548,44,592,1.0,480
265,13,3,33,482,68,550,0.8,480
265,14,1,37,457,21,478,1.2,480
265,14,2,6,766,10,776,1.5,480
265,15,1,25,510,36,546,1.5,480
265,15,2,8,400,52,452,1.0,480
265,15,3,13,325,12,337,1.0,480
266,1,2,9,781,87,868,1.0,480
266,1,3,24,443,57,500,1.0,480
266,2,1,9,422,1,423,1.0,480
266,2,2,31,219,23,242,1.2,480
266,2,3,11,631,64,695,1.0,480
266,3,1,27,574,64,638,0.8,480
266,3,2,25,232,17,249,1.5,480
266,3,3,32,646,68,714,0.8,480
266,4,1,17,233,25,258,1.2,480
266,4,2,11,520,76,596,1.0,480
266,4,3,2,405,35,440,0.8,480
266,5,2,12,666,28,694,1.5,480
266,5,3,13,621,22,643,1.0,480
266,6,1,5,368,34,402,1.0,480
266,6,2,25,250,24,274,1.5,480
266,6,3,28,651,96,747,1.5,480
266,7,1,3,348,10,358,1.5,480
266,7,2,2,605,54,659,0.8,480
266,7,3,11,765,55,820,1.0,480
266,8,1,33,455,63,518,0.8,480
266,8,2,29,482,22,504,0.8,480
266,8,3,2,676,67,743,0.8,480
266,9,1,13,359,36,395,1.0,480
266,9,2,8,685,60,745,1.0,480
266,9,3,5,317,46,363,1.0,480
266,10,1,19,244,24,268,1.5,480
266,10,2,28,652,9,661,1.5,480
266,10,3,32,499,50,549,0.8,480
266,11,2,3,396,36,432,1.5,480
266,11,3,15,465,44,509,1.2,480
266,12,1,38,477,3,480,1.5,480
266,12,2,39,583,14,597,1.0,480
266,12,3,12,750,42,792,1.5,480
266,13,1,23,324,40,364,1.2,480
266,13,2,5,467,49,516,1.0,480
266,13,3,37,316,4,320,1.2,480
266,14,1,9,212,7,219,1.0,480
266,14,2,27,757,46,803,0.8,480
266,14,3,21,536,59,595,1.5,480
266,15,1,21,298,28,326,1.5,480
266,15,2,4,359,51,410,0.8,480
267,1,1,1,278,29,307,1.5,480
267,1,2,38,304,27,331,1.5,480
267,1,3,32,672,73,745,0.8,480
267,2,1,6,333,33,366,1.5,480
267,2,3,35,438,52,490,0.8,480
267,3,2,16,210,17,227,1.2,480
267,3,3,30,776,97,873,1.5,480
267,4,1,13,759,81,840,1.0,480
267,4,2,17,713,90,803,1.2,480
267,4,3,2,237,9,246,0.8,480
267,5,1,36,426,19,445,0.8,480
267,5,2,39,269,39,308,1.0,480
267,6,1,29,636,38,674,0.8,480
267,6,2,21,336,2,338,1.5,480
267,6,3,38,417,9,426,1.5,480
267,7,1,20,602,40,642,1.5,480
267,8,1,37,368,23,391,1.2,480
267,8,2,39,364,8,372,1.0,480
267,8,3,28,535,38,573,1.5,480
267,9,1,15,352,11,363,1.2,480
267,9,2,30,286,6,292,1.5,480
267,9,3,27,248,35,283,0.8,480
267,10,1,27,281,30,311,0.8,480
267,10,2,1,640,94,734,1.5,480
267,10,3,20,486,43,529,1.5,480
267,11,1,5,689,78,767,1.0,480
267,11,2,37,682,14,696,1.2,480
267,11,3,1,506,7,513,1.5,480
267,12,1,15,295,41,336,1.2,480
267,12,2,18,799,6,805,1.2,480
267,12,3,33,597,30,627,0.8,480
267,13,1,35,594,76,670,0.8,480
267,13,3,29,638,10,648,0.8,480
267,14,1,18,710,80,790,1.2,480
267,14,3,1,354,5,359,1.5,480
267,15,1,32,658,14,672,0.8,480
267,15,2,23,526,19,545,1.2,480
267,15,3,31,230,16,246,1.2,480
268,1,1,31,397,40,437,1.2,480
268,1,2,30,711,16,727,1.5,480
268,1,3,34,778,100,878,1.0,480
268,2,2,3,474,64,538,1.5,480
268,2,3,18,442,11,453,1.2,480
268,3,1,19,239,2,241,1.5,480
268,3,3,17,412,14,426,1.2,480
268,4,1,19,272,1,273,1.5,480
268,4,2,34,625,0,625,1.0,480
268,5,1,11,600,14,614,1.0,480
268,5,2,30,510,39,549,1.5,480
268,5,3,16,437,32,469,1.2,480
268,6,1,37,581,4,585,1.2,480
268,6,2,22,685,72,757,1.2,480
268,6,3,38,638,24,662,1.5,480
268,7,1,25,454,54,508,1.5,480
268,7,2,5,368,4,372,1.0,480
268,7,3,2,565,35,600,0.8,480
268,8,1,19,521,9,530,1.5,480
268,8,2,34,442,46,488,1.0,480
268,8,3,19,444,43,487,1.5,480
268,9,1,17,232,28,260,1.2,480
268,9,2,31,463,23,486,1.2,480
268,10,1,37,302,15,317,1.2,480
268,10,2,10,565,39,604,1.2,480
268,10,3,15,552,69,621,1.2,480
268,11,1,7,362,9,371,1.0,480
268,11,2,1,552,80,632,1.5,480
268,12,1,30,519,37,556,1.5,480
268,12,3,34,329,47,376,1.0,480
268,14,1,35,778,99,877,0.8,480
268,14,2,16,284,4,288,1.2,480
268,14,3,10,619,10,629,1.2,480
268,15,2,38,577,57,634,1.5,480
268,15,3,31,524,21,545,1.2,480
269,1,1,23,612,37,649,1.2,480
269,1,2,17,416,1,417,1.2,480
269,2,1,4,273,31,304,0.8,480
269,2,2,29,284,5,289,0.8,480
269,2,3,7,287,15,302,1.0,480
269,3,2,26,213,29,242,1.0,480
269,3,3,7,699,64,763,1.0,480
269,4,1,30,414,37,451,1.5,480
269,4,2,6,249,5,254,1.5,480
269,4,3,22,232,31,263,1.2,480
269,5,1,6,681,69,750,1.5,480
269,5,2,33,207,10,217,0.8,480
269,5,3,2,227,2,229,0.8,480
269,6,2,8,478,47,525,1.0,480
269,6,3,9,639,72,711,1.0,480
269,7,1,27,364,46,410,0.8,480
269,7,2,15,311,31,342,1.2,480
269,7,3,23,260,33,293,1.2,480
269,8,1,12,719,50,769,1.5,480
269,8,3,15,468,8,476,1.2,480
269,9,1,11,364,37,401,1.0,480
269,9,2,9,272,22,294,1.0,480
269,9,3,29,269,0,269,0.8,480
269,10,2,40,799,6,805,1.5,480
269,10,3,28,254,31,285,1.5,480
269,11,1,2,435,2,437,0.8,480
269,11,2,23,245,23,268,1.2,480
269,11,3,33,278,11,289,0.8,480
269,12,1,2,502,36,538,0.8,480
269,12,2,38,427,11,438,1.5,480
269,12,3,28,785,55,840,1.5,480
269,13,1,25,492,28,520,1.5,480
269,13,2,29,356,49,405,0.8,480
269,13,3,13,681,10,691,1.0,480
269,14,1,9,750,17,767,1.0,480
269,14,2,9,374,50,424,1.0,480
269,14,3,17,685,56,741,1.2,480
269,15,2,9,353,2,355,1.0,480
269,15,3,21,717,63,780,1.5,480
270,1,1,26,207,11,218,1.0,480
270,1,2,36,623,8,631,0.8,480
270,1,3,35,583,81,664,0.8,480
270,2,1,35,654,90,744,0.8,480
270,2,2,13,482,50,532,1.0,480
270,2,3,3,797,100,897,1.5,480
270,3,2,10,493,43,536,1.2,480
270,3,3,36,605,48,653,0.8,480
270,4,1,7,485,9,494,1.0,480
270,4,3,3,585,6,591,1.5,480
270,5,1,32,672,44,716,0.8,480
270,5,3,37,630,4,634,1.2,480
270,6,1,12,482,11,493,1.5,480
270,6,2,23,755,0,755,1.2,480
270,6,3,32,486,46,532,0.8,480
270,7,1,25,612,17,629,1.5,480
270,7,2,34,763,88,851,1.0,480
270,7,3,18,770,36,806,1.2,480
270,8,1,10,729,79,808,1.2,480
270,8,2,14,577,32,609,1.0,480
270,9,1,23,366,46,412,1.2,480
270,9,2,22,492,10,502,1.2,480
270,9,3,13,375,20,395,1.0,480
270,10,2,27,760,2,762,0.8,480
270,10,3,14,248,7,255,1.0,480
270,11,1,20,260,12,272,1.5,480
270,11,2,28,566,54,620,1.5,480
270,11,3,38,468,37,505,1.5,480
270,12,1,36,516,53,569,0.8,480
270,12,2,30,359,50,409,1.5,480
270,13,1,3,510,4,514,1.5,480
270,13,2,1,666,23,689,1.5,480
270,13,3,18,275,17,292,1.2,480
270,14,2,39,674,25,699,1.0,480
270,15,1,35,491,57,548,0.8,480
270,15,2,38,318,16,334,1.5,480
271,1,1,39,377,33,410,1.0,480
271,1,2,6,450,14,464,1.5,480
271,1,3,39,632,34,666,1.0,480
271,2,1,5,438,64,502,1.0,480
271,2,2,36,743,34,777,0.8,480
271,2,3,20,353,10,363,1.5,480
271,3,1,9,435,63,498,1.0,480
271,3,2,7,254,12,266,1.0,480
271,3,3,1,523,75,598,1.5,480
271,4,1,21,425,3,428,1.5,480
271,4,3,19,379,24,403,1.5,480
271,5,1,22,498,69,567,1.2,480
271,5,2,8,327,9,336,1.0,480
271,5,3,8,204,2,206,1.0,480
271,6,3,22,211,14,225,1.2,480
271,7,1,34,521,16,537,1.0,480
271,7,3,4,607,42,649,0.8,480
271,8,1,11,441,54,495,1.0,480
271,8,3,20,572,57,629,1.5,480
271,9,1,1,246,28,274,1.5,480
271,9,2,13,760,0,760,1.0,480
271,9,3,36,515,71,586,0.8,480
271,10,1,13,397,15,412,1.0,480
271,10,2,2,654,0,654,0.8,480
271,11,1,25,441,26,467,1.5,480
271,11,2,9,658,93,751,1.0,480
271,12,1,40,489,29,518,1.5,480
271,12,2,34,648,85,733,1.0,480
271,12,3,20,711,13,724,1.5,480
271,13,1,33,523,10,533,0.8,480
271,13,2,10,234,19,253,1.2,480
271,13,3,19,566,75,641,1.5,480
271,14,1,34,501,66,567,1.0,480
271,14,3,18,456,57,513,1.2,480
271,15,1,31,489,8,497,1.2,480
271,15,2,11,570,7,577,1.0,480
272,1,1,1,780,45,825,1.5,480
272,1,2,31,790,17,807,1.2,480
272,2,1,23,430,63,493,1.2,480
272,2,2,36,729,25,754,0.8,480
272,2,3,20,547,53,600,1.5,480
272,3,1,37,648,15,663,1.2,480
272,4,1,13,475,52,527,1.0,480
272,4,2,9,415,33,448,1.0,480
272,4,3,40,749,38,787,1.5,480
272,5,2,11,597,87,684,1.0,480
272,6,2,27,787,68,855,0.8,480
272,6,3,35,493,5,498,0.8,480
272,7,1,4,668,68,736,0.8,480
272,7,2,12,318,10,328,1.5,480
272,7,3,2,397,4,401,0.8,480
272,8,1,40,408,10,418,1.5,480
272,8,2,21,752,26,778,1.5,480
272,8,3,8,735,25,760,1.0,480
272,9,1,16,335,25,360,1.2,480
272,9,2,28,292,7,299,1.5,480
272,9,3,35,794,41,835,0.8,480
272,10,1,10,355,44,399,1.2,480
272,10,3,16,392,0,392,1.2,480
272,11,1,36,733,63,796,0.8,480
272,11,2,18,765,20,785,1.2,480
272,11,3,23,450,33,483,1.2,480
272,12,1,29,760,113,873,0.8,480
272,12,2,3,318,34,352,1.5,480
272,12,3,13,477,65,542,1.0,480
272,13,1,13,441,10,451,1.0,480
272,13,2,15,286,10,296,1.2,480
272,13,3,33,523,39,562,0.8,480
272,14,1,31,379,7,386,1.2,480
272,14,2,33,383,43,426,0.8,480
272,14,3,13,780,39,819,1.0,480
272,15,3,14,324,6,330,1.0,480
273,1,1,15,561,38,599,1.2,480
273,1,2,38,279,14,293,1.5,480
273,1,3,27,755,13,768,0.8,480
273,2,1,33,725,11,736,0.8,480
273,2,3,30,226,20,246,1.5,480
273,3,1,36,767,64,831,0.8,480
273,3,2,9,331,2,333,1.0,480
273,3,3,16,454,10,464,1.2,480
273,4,1,24,310,32,342,1.0,480
273,4,2,7,333,1,334,1.0,480
273,4,3,19,670,7,677,1.5,480
273,5,1,4,324,18,342,0.8,480
273,5,3,9,526,64,590,1.0,480
273,6,1,5,448,64,512,1.0,480
273,6,2,37,312,23,335,1.2,480
273,6,3,21,660,26,686,1.5,480
273,7,1,10,664,58,722,1.2,480
273,7,3,28,656,46,702,1.5,480
273,8,1,33,377,25,402,0.8,480
273,8,2,31,505,42,547,1.2,480
273,8,3,27,743,66,809,0.8,480
273,9,1,38,264,14,278,1.5,480
273,9,3,16,551,3,554,1.2,480
273,10,1,35,402,35,437,0.8,480
273,11,3,36,324,43,367,0.8,480
273,12,1,34,439,59,498,1.0,480
273,12,2,23,382,6,388,1.2,480
273,12,3,5,494,56,550,1.0,480
273,13,1,11,261,13,274,1.0,480
273,13,2,30,636,1,637,1.5,480
273,13,3,24,547,22,569,1.0,480
273,14,1,28,271,3,274,1.5,480
273,14,2,35,278,32,310,0.8,480
273,14,3,18,583,21,604,1.2,480
273,15,1,13,611,67,678,1.0,480
273,15,2,15,737,31,768,1.2,480
273,15,3,16,759,107,866,1.2,480
