prod_date,machine_id,shift_id,sku,units_good,units_scrap,units_total
2025-01-01,1,1,SKU037,464,35,499
2025-01-01,1,2,SKU016,348,51,399
2025-01-01,1,3,SKU001,781,80,861
2025-01-01,2,1,SKU029,421,30,451
2025-01-01,2,2,SKU001,598,13,611
2025-01-01,2,3,SKU039,728,20,748
2025-01-01,3,1,SKU021,624,59,683
2025-01-01,3,2,SKU019,254,9,263
2025-01-01,3,3,SKU022,567,74,641
2025-01-01,4,1,SKU026,558,8,566
2025-01-01,4,2,SKU003,558,26,584
2025-01-01,4,3,SKU016,689,41,730
2025-01-01,5,2,SKU016,463,41,504
2025-01-01,5,3,SKU022,605,86,691
2025-01-01,6,1,SKU007,414,14,428
2025-01-01,6,2,SKU034,258,15,273
2025-01-01,6,3,SKU039,204,20,224
2025-01-01,7,1,SKU020,724,10,734
2025-01-01,7,2,SKU027,707,89,796
2025-01-01,8,2,SKU012,287,24,311
2025-01-01,9,1,SKU008,229,6,235
2025-01-01,9,3,SKU024,541,4,545
2025-01-01,10,1,SKU016,327,11,338
2025-01-01,10,2,SKU039,725,61,786
2025-01-01,10,3,SKU019,486,23,509
2025-01-01,11,1,SKU003,215,23,238
2025-01-01,11,2,SKU015,744,13,757
2025-01-01,12,1,SKU030,456,5,461
2025-01-01,12,3,SKU021,234,20,254
2025-01-01,13,1,SKU035,413,55,468
2025-01-01,13,2,SKU021,673,90,763
2025-01-01,13,3,SKU017,760,35,795
2025-01-01,14,1,SKU001,645,77,722
2025-01-01,14,2,SKU034,451,56,507
2025-01-01,14,3,SKU033,719,67,786
2025-01-01,15,1,SKU039,507,6,513
2025-01-01,15,2,SKU030,315,9,324
2025-01-01,15,3,SKU005,307,18,325
2025-01-02,1,2,SKU014,791,40,831
2025-01-02,1,3,SKU004,771,25,796
2025-01-02,2,2,SKU018,770,59,829
2025-01-02,3,1,SKU024,548,68,616
2025-01-02,3,3,SKU018,628,86,714
2025-01-02,4,1,SKU010,457,11,468
2025-01-02,4,3,SKU021,671,80,751
2025-01-02,5,1,SKU013,630,12,642
2025-01-02,5,3,SKU026,571,33,604
2025-01-02,6,1,SKU007,230,15,245
2025-01-02,6,3,SKU009,555,9,564
2025-01-02,7,1,SKU037,487,12,499
2025-01-02,7,2,SKU024,425,19,444
2025-01-02,8,1,SKU010,576,35,611
2025-01-02,8,2,SKU026,640,5,645
2025-01-02,8,3,SKU001,658,68,726
2025-01-02,9,1,SKU033,704,11,715
2025-01-02,9,3,SKU030,726,96,822
2025-01-02,10,2,SKU021,302,1,303
2025-01-02,10,3,SKU011,351,36,387
2025-01-02,11,1,SKU010,783,66,849
2025-01-02,11,2,SKU013,554,9,563
2025-01-02,11,3,SKU007,252,0,252
2025-01-02,12,1,SKU023,763,97,860
2025-01-02,12,2,SKU022,462,45,507
2025-01-02,12,3,SKU010,314,35,349
2025-01-02,13,1,SKU023,342,40,382
2025-01-02,14,1,SKU024,403,50,453
2025-01-02,14,2,SKU013,380,35,415
2025-01-02,14,3,SKU013,388,38,426
2025-01-02,15,1,SKU035,382,7,389
2025-01-02,15,2,SKU031,729,54,783
2025-01-02,15,3,SKU008,431,40,471
2025-01-03,1,1,SKU032,257,17,274
2025-01-03,1,2,SKU027,747,92,839
2025-01-03,1,3,SKU015,396,4,400
2025-01-03,2,3,SKU029,408,1,409
2025-01-03,3,1,SKU027,328,8,336
2025-01-03,3,3,SKU023,297,11,308
2025-01-03,4,1,SKU040,594,52,646
2025-01-03,4,2,SKU005,706,14,720
2025-01-03,4,3,SKU028,698,54,752
2025-01-03,5,1,SKU016,597,48,645
2025-01-03,5,2,SKU029,348,10,358
2025-01-03,5,3,SKU014,556,6,562
2025-01-03,6,1,SKU031,547,71,618
2025-01-03,6,2,SKU012,319,35,354
2025-01-03,6,3,SKU021,279,34,313
2025-01-03,7,1,SKU006,642,87,729
2025-01-03,7,2,SKU034,383,42,425
2025-01-03,7,3,SKU034,713,19,732
2025-01-03,8,1,SKU008,730,94,824
2025-01-03,8,2,SKU016,471,6,477
2025-01-03,8,3,SKU003,665,52,717
2025-01-03,9,1,SKU034,400,22,422
2025-01-03,9,2,SKU010,511,71,582
2025-01-03,9,3,SKU031,368,14,382
2025-01-03,10,1,SKU009,648,61,709
2025-01-03,10,2,SKU036,733,20,753
2025-01-03,10,3,SKU019,586,11,597
2025-01-03,11,3,SKU029,252,28,280
2025-01-03,12,1,SKU013,584,17,601
2025-01-03,12,2,SKU008,554,62,616
2025-01-03,12,3,SKU009,466,10,476
2025-01-03,13,1,SKU016,485,2,487
2025-01-03,13,2,SKU018,525,8,533
2025-01-03,13,3,SKU016,212,22,234
2025-01-03,14,1,SKU002,698,26,724
2025-01-03,14,2,SKU037,676,13,689
2025-01-03,14,3,SKU038,795,15,810
2025-01-03,15,1,SKU006,747,92,839
2025-01-03,15,3,SKU018,255,25,280
2025-01-04,1,1,SKU040,307,8,315
2025-01-04,1,2,SKU039,467,64,531
2025-01-04,1,3,SKU031,472,64,536
2025-01-04,2,1,SKU034,661,14,675
2025-01-04,2,2,SKU003,292,1,293
2025-01-04,2,3,SKU016,387,25,412
2025-01-04,3,1,SKU029,637,5,642
2025-01-04,4,2,SKU003,436,48,484
2025-01-04,4,3,SKU010,454,2,456
2025-01-04,5,1,SKU034,273,6,279
2025-01-04,5,3,SKU008,765,20,785
2025-01-04,6,1,SKU035,359,13,372
2025-01-04,6,2,SKU022,694,53,747
2025-01-04,6,3,SKU020,521,77,598
2025-01-04,7,1,SKU016,309,40,349
2025-01-04,7,2,SKU011,281,14,295
2025-01-04,8,2,SKU005,606,87,693
2025-01-04,8,3,SKU030,503,33,536
2025-01-04,9,2,SKU020,657,30,687
2025-01-04,9,3,SKU040,239,17,256
2025-01-04,10,1,SKU010,713,93,806
2025-01-04,10,2,SKU032,697,102,799
2025-01-04,10,3,SKU031,377,47,424
2025-01-04,11,1,SKU039,641,32,673
2025-01-04,11,2,SKU013,248,27,275
2025-01-04,11,3,SKU016,751,93,844
2025-01-04,12,1,SKU024,706,98,804
2025-01-04,12,2,SKU012,508,21,529
2025-01-04,13,1,SKU004,463,55,518
2025-01-04,13,2,SKU024,681,47,728
2025-01-04,13,3,SKU029,691,97,788
2025-01-04,14,1,SKU010,449,0,449
2025-01-04,14,2,SKU028,631,31,662
2025-01-04,14,3,SKU017,325,2,327
2025-01-04,15,1,SKU023,277,2,279
2025-01-04,15,2,SKU032,209,20,229
2025-01-04,15,3,SKU039,485,29,514
2025-01-05,1,1,SKU022,513,70,583
2025-01-05,1,2,SKU030,771,64,835
2025-01-05,1,3,SKU002,759,71,830
2025-01-05,2,1,SKU002,271,25,296
2025-01-05,2,2,SKU031,244,28,272
2025-01-05,2,3,SKU024,206,5,211
2025-01-05,3,2,SKU030,472,58,530
2025-01-05,3,3,SKU031,265,21,286
2025-01-05,4,1,SKU007,479,58,537
2025-01-05,4,2,SKU025,420,42,462
2025-01-05,4,3,SKU017,443,6,449
2025-01-05,5,1,SKU023,300,33,333
2025-01-05,5,2,SKU017,479,5,484
2025-01-05,5,3,SKU031,237,11,248
2025-01-05,6,1,SKU033,428,24,452
2025-01-05,6,2,SKU034,777,51,828
2025-01-05,6,3,SKU036,220,23,243
2025-01-05,7,2,SKU016,496,41,537
2025-01-05,7,3,SKU031,606,22,628
2025-01-05,8,1,SKU024,267,7,274
2025-01-05,8,2,SKU026,375,13,388
2025-01-05,9,1,SKU018,393,25,418
2025-01-05,9,2,SKU010,548,63,611
2025-01-05,10,1,SKU038,401,16,417
2025-01-05,10,3,SKU038,611,11,622
2025-01-05,11,2,SKU003,524,38,562
2025-01-05,11,3,SKU040,452,18,470
2025-01-05,12,1,SKU034,295,20,315
2025-01-05,12,2,SKU028,474,58,532
2025-01-05,12,3,SKU015,380,11,391
2025-01-05,13,1,SKU021,623,74,697
2025-01-05,13,2,SKU031,308,33,341
2025-01-05,13,3,SKU020,467,17,484
2025-01-05,14,1,SKU003,547,20,567
2025-01-05,14,2,SKU016,425,17,442
2025-01-05,14,3,SKU026,374,26,400
2025-01-05,15,1,SKU036,578,14,592
2025-01-05,15,3,SKU009,715,32,747
2025-01-06,1,1,SKU016,240,23,263
2025-01-06,1,2,SKU017,430,45,475
2025-01-06,1,3,SKU007,282,1,283
2025-01-06,2,1,SKU013,426,30,456
2025-01-06,2,3,SKU024,572,68,640
2025-01-06,3,1,SKU031,232,11,243
2025-01-06,3,2,SKU037,462,5,467
2025-01-06,3,3,SKU020,430,28,458
2025-01-06,4,1,SKU020,281,34,315
2025-01-06,4,2,SKU006,766,32,798
2025-01-06,5,1,SKU001,310,18,328
2025-01-06,5,2,SKU007,708,1,709
2025-01-06,5,3,SKU007,297,1,298
2025-01-06,6,1,SKU011,505,13,518
2025-01-06,6,2,SKU006,443,54,497
2025-01-06,6,3,SKU017,602,14,616
2025-01-06,7,3,SKU014,229,0,229
2025-01-06,8,1,SKU027,414,47,461
2025-01-06,8,2,SKU005,772,5,777
2025-01-06,8,3,SKU036,365,17,382
2025-01-06,9,1,SKU035,698,70,768
2025-01-06,9,3,SKU037,657,65,722
2025-01-06,10,1,SKU016,542,16,558
2025-01-06,10,2,SKU039,660,33,693
2025-01-06,10,3,SKU011,211,12,223
2025-01-06,11,1,SKU029,559,34,593
2025-01-06,11,3,SKU004,402,31,433
2025-01-06,12,1,SKU004,532,14,546
2025-01-06,12,2,SKU039,468,38,506
2025-01-06,12,3,SKU038,454,61,515
2025-01-06,13,1,SKU016,712,19,731
2025-01-06,13,2,SKU017,254,29,283
2025-01-06,13,3,SKU004,285,2,287
2025-01-06,14,1,SKU032,676,21,697
2025-01-06,14,2,SKU031,763,86,849
2025-01-06,14,3,SKU011,453,8,461
2025-01-06,15,1,SKU021,270,36,306
2025-01-06,15,2,SKU021,543,44,587
2025-01-06,15,3,SKU021,250,7,257
2025-01-07,1,1,SKU011,692,62,754
2025-01-07,1,2,SKU024,577,31,608
2025-01-07,2,1,SKU019,630,71,701
2025-01-07,2,2,SKU009,644,16,660
2025-01-07,2,3,SKU016,300,31,331
2025-01-07,3,1,SKU005,215,10,225
2025-01-07,3,2,SKU039,337,10,347
2025-01-07,3,3,SKU020,367,47,414
2025-01-07,4,2,SKU019,429,18,447
2025-01-07,4,3,SKU021,246,30,276
2025-01-07,5,1,SKU009,311,7,318
2025-01-07,5,2,SKU032,479,32,511
2025-01-07,5,3,SKU009,734,101,835
2025-01-07,6,1,SKU004,543,44,587
2025-01-07,6,2,SKU021,436,8,444
2025-01-07,7,1,SKU033,682,35,717
2025-01-07,7,2,SKU003,469,60,529
2025-01-07,8,1,SKU020,513,17,530
2025-01-07,8,2,SKU015,654,7,661
2025-01-07,8,3,SKU012,687,44,731
2025-01-07,9,1,SKU019,650,93,743
2025-01-07,9,2,SKU017,225,24,249
2025-01-07,9,3,SKU016,306,3,309
2025-01-07,10,1,SKU010,772,65,837
2025-01-07,10,2,SKU024,669,32,701
2025-01-07,10,3,SKU028,651,74,725
2025-01-07,11,1,SKU024,781,64,845
2025-01-07,11,2,SKU019,549,63,612
2025-01-07,11,3,SKU020,520,48,568
2025-01-07,12,1,SKU024,281,34,315
2025-01-07,12,2,SKU022,389,23,412
2025-01-07,12,3,SKU031,423,43,466
2025-01-07,13,1,SKU022,304,25,329
2025-01-07,13,2,SKU034,690,69,759
2025-01-07,13,3,SKU037,430,15,445
2025-01-07,14,1,SKU025,709,19,728
2025-01-07,14,2,SKU037,520,25,545
2025-01-07,14,3,SKU020,481,35,516
2025-01-07,15,1,SKU037,671,17,688
2025-01-07,15,2,SKU040,514,45,559
2025-01-07,15,3,SKU030,617,12,629
2025-01-08,1,1,SKU024,789,89,878
2025-01-08,1,2,SKU031,464,55,519
2025-01-08,1,3,SKU036,668,25,693
2025-01-08,2,2,SKU001,489,33,522
2025-01-08,2,3,SKU010,504,36,540
2025-01-08,3,1,SKU007,317,13,330
2025-01-08,3,2,SKU035,329,46,375
2025-01-08,3,3,SKU006,335,17,352
2025-01-08,4,1,SKU030,368,20,388
2025-01-08,4,2,SKU002,684,77,761
2025-01-08,4,3,SKU009,442,28,470
2025-01-08,5,1,SKU031,329,43,372
2025-01-08,5,3,SKU003,641,47,688
2025-01-08,6,1,SKU011,782,51,833
2025-01-08,6,2,SKU032,761,77,838
2025-01-08,6,3,SKU006,694,49,743
2025-01-08,7,1,SKU014,783,22,805
2025-01-08,7,2,SKU028,295,39,334
2025-01-08,7,3,SKU029,255,31,286
2025-01-08,8,2,SKU014,433,58,491
2025-01-08,8,3,SKU035,240,17,257
2025-01-08,9,1,SKU023,702,59,761
2025-01-08,9,2,SKU034,607,56,663
2025-01-08,9,3,SKU040,751,91,842
2025-01-08,10,1,SKU027,669,70,739
2025-01-08,10,3,SKU036,329,22,351
2025-01-08,11,3,SKU017,764,75,839
2025-01-08,12,1,SKU017,330,37,367
2025-01-08,12,2,SKU017,468,14,482
2025-01-08,12,3,SKU016,641,13,654
2025-01-08,13,1,SKU034,652,4,656
2025-01-08,13,2,SKU023,424,50,474
2025-01-08,13,3,SKU021,340,25,365
2025-01-08,14,1,SKU012,513,57,570
2025-01-08,14,2,SKU020,393,18,411
2025-01-08,14,3,SKU026,353,5,358
2025-01-08,15,1,SKU007,653,29,682
2025-01-08,15,2,SKU012,595,3,598
2025-01-08,15,3,SKU037,546,75,621
2025-01-09,1,1,SKU011,715,65,780
2025-01-09,1,2,SKU031,292,9,301
2025-01-09,1,3,SKU029,535,77,612
2025-01-09,2,1,SKU030,352,40,392
2025-01-09,2,3,SKU009,470,42,512
2025-01-09,3,3,SKU033,512,67,579
2025-01-09,4,1,SKU025,371,18,389
2025-01-09,4,2,SKU038,202,11,213
2025-01-09,4,3,SKU002,289,3,292
2025-01-09,5,1,SKU034,399,32,431
2025-01-09,5,2,SKU003,333,45,378
2025-01-09,5,3,SKU037,322,28,350
2025-01-09,6,1,SKU029,556,20,576
2025-01-09,7,1,SKU038,255,33,288
2025-01-09,7,2,SKU013,702,23,725
2025-01-09,7,3,SKU005,275,27,302
2025-01-09,8,1,SKU026,357,8,365
2025-01-09,8,3,SKU021,399,10,409
2025-01-09,9,1,SKU004,511,51,562
2025-01-09,9,2,SKU027,570,2,572
2025-01-09,9,3,SKU005,338,29,367
2025-01-09,10,2,SKU037,584,52,636
2025-01-09,10,3,SKU021,273,35,308
2025-01-09,11,1,SKU006,277,15,292
2025-01-09,11,2,SKU028,775,91,866
2025-01-09,11,3,SKU026,306,30,336
2025-01-09,12,3,SKU002,752,97,849
2025-01-09,13,1,SKU037,386,20,406
2025-01-09,13,2,SKU021,630,41,671
2025-01-09,13,3,SKU010,627,65,692
2025-01-09,14,3,SKU021,678,28,706
2025-01-09,15,2,SKU005,257,7,264
2025-01-10,1,1,SKU002,637,5,642
2025-01-10,1,2,SKU005,502,49,551
2025-01-10,2,2,SKU018,589,13,602
2025-01-10,2,3,SKU028,700,93,793
2025-01-10,3,1,SKU025,724,62,786
2025-01-10,3,2,SKU017,690,42,732
2025-01-10,3,3,SKU001,794,23,817
2025-01-10,4,1,SKU020,785,46,831
2025-01-10,4,2,SKU022,435,27,462
2025-01-10,4,3,SKU014,234,18,252
2025-01-10,5,1,SKU011,661,53,714
2025-01-10,5,2,SKU036,502,74,576
2025-01-10,5,3,SKU012,755,19,774
2025-01-10,6,3,SKU030,479,46,525
2025-01-10,7,1,SKU035,547,65,612
2025-01-10,7,2,SKU031,631,59,690
2025-01-10,7,3,SKU014,328,45,373
2025-01-10,8,1,SKU011,684,70,754
2025-01-10,8,2,SKU022,765,39,804
2025-01-10,8,3,SKU022,355,22,377
2025-01-10,9,1,SKU025,547,54,601
2025-01-10,10,2,SKU033,306,7,313
2025-01-10,10,3,SKU039,578,74,652
2025-01-10,11,2,SKU016,512,46,558
2025-01-10,11,3,SKU009,772,33,805
2025-01-10,12,1,SKU014,276,4,280
2025-01-10,12,3,SKU033,755,1,756
2025-01-10,13,1,SKU030,280,40,320
2025-01-10,13,2,SKU008,350,21,371
2025-01-10,13,3,SKU028,323,46,369
2025-01-10,14,1,SKU027,665,39,704
2025-01-10,14,2,SKU029,742,105,847
2025-01-10,14,3,SKU010,446,20,466
2025-01-10,15,2,SKU031,503,23,526
2025-01-10,15,3,SKU036,687,9,696
2025-01-11,1,1,SKU001,794,33,827
2025-01-11,1,2,SKU002,450,64,514
2025-01-11,1,3,SKU028,296,14,310
2025-01-11,2,1,SKU009,524,36,560
2025-01-11,2,2,SKU005,390,32,422
2025-01-11,2,3,SKU005,517,61,578
2025-01-11,3,1,SKU019,282,7,289
2025-01-11,3,2,SKU022,393,24,417
2025-01-11,4,1,SKU033,506,55,561
2025-01-11,4,2,SKU005,326,36,362
2025-01-11,4,3,SKU034,354,42,396
2025-01-11,5,1,SKU040,662,41,703
2025-01-11,5,2,SKU036,667,53,720
2025-01-11,5,3,SKU008,542,58,600
2025-01-11,6,1,SKU016,723,70,793
2025-01-11,6,2,SKU019,761,32,793
2025-01-11,7,1,SKU032,617,82,699
2025-01-11,8,1,SKU017,256,37,293
2025-01-11,8,2,SKU017,244,32,276
2025-01-11,8,3,SKU020,269,21,290
2025-01-11,9,1,SKU022,420,41,461
2025-01-11,9,2,SKU013,305,37,342
2025-01-11,10,1,SKU028,541,35,576
2025-01-11,10,2,SKU001,241,34,275
2025-01-11,10,3,SKU018,721,80,801
2025-01-11,11,1,SKU027,357,41,398
2025-01-11,11,2,SKU013,736,107,843
2025-01-11,11,3,SKU004,414,46,460
2025-01-11,12,1,SKU009,288,32,320
2025-01-11,12,2,SKU021,607,49,656
2025-01-11,12,3,SKU005,714,63,777
2025-01-11,13,1,SKU003,342,50,392
2025-01-11,13,2,SKU002,661,76,737
2025-01-11,14,1,SKU004,526,69,595
2025-01-11,14,2,SKU004,721,48,769
2025-01-11,14,3,SKU003,733,21,754
2025-01-11,15,1,SKU036,394,38,432
2025-01-11,15,2,SKU024,323,44,367
2025-01-11,15,3,SKU020,316,21,337
2025-01-12,1,1,SKU015,372,30,402
2025-01-12,1,2,SKU037,656,5,661
2025-01-12,1,3,SKU027,644,8,652
2025-01-12,2,1,SKU017,728,89,817
2025-01-12,2,2,SKU024,313,20,333
2025-01-12,2,3,SKU021,549,32,581
2025-01-12,3,2,SKU024,466,28,494
2025-01-12,3,3,SKU036,731,18,749
2025-01-12,4,1,SKU029,612,74,686
2025-01-12,4,2,SKU002,778,61,839
2025-01-12,4,3,SKU012,369,45,414
2025-01-12,5,1,SKU014,708,10,718
2025-01-12,5,2,SKU025,701,9,710
2025-01-12,5,3,SKU013,239,16,255
2025-01-12,6,2,SKU039,292,5,297
2025-01-12,7,1,SKU019,274,20,294
2025-01-12,7,2,SKU020,718,43,761
2025-01-12,7,3,SKU025,749,61,810
2025-01-12,8,1,SKU033,585,41,626
2025-01-12,8,2,SKU032,793,114,907
2025-01-12,8,3,SKU004,424,57,481
2025-01-12,9,1,SKU034,357,49,406
2025-01-12,9,2,SKU023,275,38,313
2025-01-12,9,3,SKU004,324,35,359
2025-01-12,10,1,SKU004,220,9,229
2025-01-12,11,2,SKU027,200,7,207
2025-01-12,12,1,SKU016,526,4,530
2025-01-12,12,2,SKU029,750,70,820
2025-01-12,12,3,SKU039,571,73,644
2025-01-12,13,1,SKU039,415,61,476
2025-01-12,13,2,SKU004,571,11,582
2025-01-12,13,3,SKU032,797,24,821
2025-01-12,14,1,SKU023,705,99,804
2025-01-12,14,2,SKU016,799,94,893
2025-01-12,14,3,SKU037,694,34,728
2025-01-12,15,1,SKU003,749,33,782
2025-01-12,15,2,SKU008,656,87,743
2025-01-12,15,3,SKU015,603,63,666
2025-01-13,1,1,SKU030,767,10,777
2025-01-13,1,2,SKU016,230,5,235
2025-01-13,1,3,SKU021,716,70,786
2025-01-13,2,1,SKU028,227,18,245
2025-01-13,2,3,SKU010,791,62,853
2025-01-13,3,1,SKU036,763,87,850
2025-01-13,3,2,SKU007,435,35,470
2025-01-13,3,3,SKU010,762,49,811
2025-01-13,4,1,SKU030,714,8,722
2025-01-13,4,2,SKU031,783,49,832
2025-01-13,4,3,SKU001,269,7,276
2025-01-13,5,1,SKU018,513,46,559
2025-01-13,5,3,SKU025,599,34,633
2025-01-13,6,1,SKU020,480,43,523
2025-01-13,6,2,SKU017,256,18,274
2025-01-13,6,3,SKU013,345,47,392
2025-01-13,7,1,SKU006,538,23,561
2025-01-13,7,2,SKU018,708,12,720
2025-01-13,7,3,SKU014,302,40,342
2025-01-13,8,1,SKU008,532,46,578
2025-01-13,8,2,SKU018,671,95,766
2025-01-13,8,3,SKU001,779,93,872
2025-01-13,9,1,SKU027,265,24,289
2025-01-13,9,3,SKU032,624,23,647
2025-01-13,10,1,SKU011,366,36,402
2025-01-13,10,2,SKU029,236,32,268
2025-01-13,10,3,SKU032,399,39,438
2025-01-13,11,1,SKU001,594,52,646
2025-01-13,11,2,SKU004,678,58,736
2025-01-13,11,3,SKU009,468,33,501
2025-01-13,12,1,SKU010,265,18,283
2025-01-13,12,2,SKU016,418,15,433
2025-01-13,12,3,SKU004,635,59,694
2025-01-13,13,3,SKU003,663,36,699
2025-01-13,14,1,SKU011,468,26,494
2025-01-13,14,2,SKU016,492,23,515
2025-01-13,14,3,SKU022,205,19,224
2025-01-13,15,1,SKU039,430,7,437
2025-01-13,15,2,SKU028,569,51,620
2025-01-13,15,3,SKU016,537,50,587
2025-01-14,1,1,SKU001,704,23,727
2025-01-14,1,2,SKU011,244,33,277
2025-01-14,2,1,SKU027,200,3,203
2025-01-14,2,2,SKU027,276,10,286
2025-01-14,2,3,SKU036,347,18,365
2025-01-14,3,1,SKU005,270,8,278
2025-01-14,3,2,SKU013,412,43,455
2025-01-14,4,1,SKU031,674,66,740
2025-01-14,4,2,SKU006,421,27,448
2025-01-14,4,3,SKU020,693,37,730
2025-01-14,5,1,SKU030,755,33,788
2025-01-14,5,2,SKU001,795,24,819
2025-01-14,6,2,SKU025,766,73,839
2025-01-14,6,3,SKU027,422,47,469
2025-01-14,7,2,SKU025,370,21,391
2025-01-14,7,3,SKU008,618,38,656
2025-01-14,8,1,SKU018,266,9,275
2025-01-14,8,2,SKU018,603,20,623
2025-01-14,8,3,SKU019,322,19,341
2025-01-14,9,1,SKU031,313,26,339
2025-01-14,9,2,SKU004,619,21,640
2025-01-14,9,3,SKU024,690,9,699
2025-01-14,10,1,SKU038,261,25,286
2025-01-14,10,2,SKU037,693,85,778
2025-01-14,10,3,SKU030,476,49,525
2025-01-14,11,1,SKU021,378,37,415
2025-01-14,11,2,SKU027,599,30,629
2025-01-14,11,3,SKU034,293,16,309
2025-01-14,12,1,SKU020,796,50,846
2025-01-14,12,3,SKU015,608,54,662
2025-01-14,13,1,SKU040,283,21,304
2025-01-14,13,2,SKU001,435,2,437
2025-01-14,13,3,SKU039,667,75,742
2025-01-14,14,2,SKU030,678,58,736
2025-01-14,14,3,SKU018,442,33,475
2025-01-14,15,1,SKU018,384,8,392
2025-01-14,15,3,SKU013,437,14,451
2025-01-15,1,2,SKU001,779,96,875
2025-01-15,1,3,SKU035,660,42,702
2025-01-15,2,1,SKU018,263,30,293
2025-01-15,2,2,SKU005,796,48,844
2025-01-15,3,1,SKU026,794,3,797
2025-01-15,3,2,SKU029,743,61,804
2025-01-15,3,3,SKU028,223,32,255
2025-01-15,4,1,SKU038,618,17,635
2025-01-15,4,2,SKU030,591,25,616
2025-01-15,4,3,SKU019,231,24,255
2025-01-15,5,1,SKU018,668,67,735
2025-01-15,5,2,SKU020,203,13,216
2025-01-15,5,3,SKU005,794,72,866
2025-01-15,6,1,SKU032,461,34,495
2025-01-15,6,2,SKU009,261,19,280
2025-01-15,6,3,SKU008,461,66,527
2025-01-15,7,1,SKU028,711,5,716
2025-01-15,7,2,SKU028,743,43,786
2025-01-15,7,3,SKU005,376,8,384
2025-01-15,8,1,SKU017,521,5,526
2025-01-15,8,2,SKU014,487,39,526
2025-01-15,8,3,SKU028,385,41,426
2025-01-15,9,1,SKU005,308,15,323
2025-01-15,9,2,SKU013,732,82,814
2025-01-15,10,1,SKU035,219,5,224
2025-01-15,10,2,SKU012,279,37,316
2025-01-15,10,3,SKU017,409,52,461
2025-01-15,11,1,SKU015,415,53,468
2025-01-15,11,2,SKU036,314,41,355
2025-01-15,11,3,SKU001,569,72,641
2025-01-15,12,1,SKU026,794,112,906
2025-01-15,12,2,SKU003,280,33,313
2025-01-15,12,3,SKU021,240,31,271
2025-01-15,13,1,SKU017,382,39,421
2025-01-15,13,2,SKU004,312,39,351
2025-01-15,13,3,SKU039,307,32,339
2025-01-15,14,1,SKU011,248,35,283
2025-01-15,14,2,SKU010,609,17,626
2025-01-15,14,3,SKU020,448,34,482
2025-01-15,15,1,SKU013,582,71,653
2025-01-15,15,2,SKU008,262,24,286
2025-01-15,15,3,SKU033,486,31,517
2025-01-16,1,1,SKU025,525,68,593
2025-01-16,1,3,SKU009,588,28,616
2025-01-16,2,1,SKU006,732,86,818
2025-01-16,2,2,SKU012,345,43,388
2025-01-16,2,3,SKU025,717,86,803
2025-01-16,3,1,SKU020,219,14,233
2025-01-16,3,2,SKU025,488,42,530
2025-01-16,3,3,SKU014,642,79,721
2025-01-16,4,1,SKU022,298,27,325
2025-01-16,4,2,SKU016,537,76,613
2025-01-16,5,2,SKU002,606,79,685
2025-01-16,5,3,SKU011,240,0,240
2025-01-16,6,1,SKU017,365,12,377
2025-01-16,6,2,SKU004,469,22,491
2025-01-16,6,3,SKU001,203,8,211
2025-01-16,7,3,SKU010,429,35,464
2025-01-16,8,1,SKU005,725,78,803
2025-01-16,8,2,SKU031,710,17,727
2025-01-16,8,3,SKU027,427,27,454
2025-01-16,9,1,SKU014,663,40,703
2025-01-16,9,2,SKU005,372,25,397
2025-01-16,9,3,SKU016,639,35,674
2025-01-16,10,1,SKU030,498,53,551
2025-01-16,10,2,SKU008,673,51,724
2025-01-16,10,3,SKU009,628,35,663
2025-01-16,11,1,SKU031,708,85,793
2025-01-16,11,2,SKU031,632,82,714
2025-01-16,11,3,SKU007,414,15,429
2025-01-16,12,1,SKU024,272,15,287
2025-01-16,12,2,SKU016,418,40,458
2025-01-16,12,3,SKU035,665,33,698
2025-01-16,13,1,SKU006,275,34,309
2025-01-16,13,2,SKU032,316,46,362
2025-01-16,13,3,SKU011,411,10,421
2025-01-16,14,1,SKU040,406,18,424
2025-01-16,14,2,SKU027,781,80,861
2025-01-16,14,3,SKU023,624,33,657
2025-01-16,15,1,SKU030,472,4,476
2025-01-16,15,3,SKU031,363,19,382
2025-01-17,1,1,SKU018,363,27,390
2025-01-17,1,2,SKU008,358,28,386
2025-01-17,1,3,SKU015,616,40,656
2025-01-17,2,1,SKU017,471,20,491
2025-01-17,2,2,SKU009,786,114,900
2025-01-17,2,3,SKU012,522,52,574
2025-01-17,3,1,SKU015,731,98,829
2025-01-17,3,3,SKU007,450,46,496
2025-01-17,4,1,SKU015,755,74,829
2025-01-17,4,2,SKU017,655,68,723
2025-01-17,4,3,SKU028,619,21,640
2025-01-17,5,1,SKU038,621,27,648
2025-01-17,5,2,SKU016,535,67,602
2025-01-17,5,3,SKU036,361,44,405
2025-01-17,6,2,SKU012,510,3,513
2025-01-17,6,3,SKU002,589,16,605
2025-01-17,7,1,SKU007,798,23,821
2025-01-17,7,2,SKU033,297,21,318
2025-01-17,7,3,SKU036,200,21,221
2025-01-17,8,1,SKU027,352,11,363
2025-01-17,8,2,SKU004,383,28,411
2025-01-17,8,3,SKU010,668,71,739
2025-01-17,9,1,SKU019,416,30,446
2025-01-17,9,2,SKU003,443,46,489
2025-01-17,9,3,SKU007,743,29,772
2025-01-17,10,1,SKU003,669,11,680
2025-01-17,10,2,SKU005,562,44,606
2025-01-17,10,3,SKU012,344,38,382
2025-01-17,11,1,SKU015,676,68,744
2025-01-17,12,1,SKU028,470,46,516
2025-01-17,12,2,SKU017,581,82,663
2025-01-17,12,3,SKU029,322,33,355
2025-01-17,13,1,SKU027,272,11,283
2025-01-17,13,3,SKU036,557,26,583
2025-01-17,14,2,SKU004,534,31,565
2025-01-17,15,3,SKU039,339,9,348
2025-01-18,1,1,SKU002,375,3,378
2025-01-18,1,3,SKU011,395,11,406
2025-01-18,2,1,SKU009,788,58,846
2025-01-18,2,2,SKU008,739,36,775
2025-01-18,2,3,SKU028,395,49,444
2025-01-18,3,1,SKU037,395,12,407
2025-01-18,3,3,SKU034,269,14,283
2025-01-18,4,3,SKU035,251,7,258
2025-01-18,5,1,SKU035,734,25,759
2025-01-18,5,2,SKU029,384,6,390
2025-01-18,5,3,SKU037,200,5,205
2025-01-18,6,1,SKU009,405,19,424
2025-01-18,6,2,SKU040,655,44,699
2025-01-18,7,1,SKU036,377,17,394
2025-01-18,7,2,SKU033,735,102,837
2025-01-18,7,3,SKU008,285,32,317
2025-01-18,8,1,SKU024,320,33,353
2025-01-18,8,2,SKU023,430,4,434
2025-01-18,8,3,SKU010,437,11,448
2025-01-18,9,3,SKU020,615,71,686
2025-01-18,10,1,SKU020,386,19,405
2025-01-18,10,3,SKU011,547,66,613
2025-01-18,11,1,SKU038,330,39,369
2025-01-18,11,2,SKU003,639,81,720
2025-01-18,11,3,SKU033,202,29,231
2025-01-18,12,1,SKU004,786,45,831
2025-01-18,12,2,SKU012,279,8,287
2025-01-18,12,3,SKU021,463,44,507
2025-01-18,13,1,SKU029,693,1,694
2025-01-18,13,3,SKU023,375,11,386
2025-01-18,14,2,SKU034,671,33,704
2025-01-18,14,3,SKU039,700,75,775
2025-01-18,15,1,SKU015,463,53,516
2025-01-18,15,2,SKU032,737,4,741
2025-01-18,15,3,SKU016,667,63,730
2025-01-19,1,1,SKU003,519,1,520
2025-01-19,1,2,SKU025,707,11,718
2025-01-19,2,2,SKU009,766,73,839
2025-01-19,2,3,SKU022,714,87,801
2025-01-19,3,1,SKU022,627,0,627
2025-01-19,3,2,SKU034,415,3,418
2025-01-19,3,3,SKU034,616,44,660
2025-01-19,4,1,SKU037,468,54,522
2025-01-19,4,3,SKU013,446,53,499
2025-01-19,5,1,SKU014,532,18,550
2025-01-19,5,2,SKU016,265,17,282
2025-01-19,5,3,SKU031,707,60,767
2025-01-19,6,1,SKU028,416,12,428
2025-01-19,6,2,SKU031,628,56,684
2025-01-19,6,3,SKU040,534,37,571
2025-01-19,7,1,SKU036,339,25,364
2025-01-19,7,2,SKU028,252,9,261
2025-01-19,7,3,SKU039,608,22,630
2025-01-19,8,1,SKU017,689,6,695
2025-01-19,8,3,SKU026,701,55,756
2025-01-19,9,1,SKU024,750,78,828
2025-01-19,9,2,SKU026,302,17,319
2025-01-19,9,3,SKU009,532,25,557
2025-01-19,10,1,SKU037,341,37,378
2025-01-19,10,3,SKU007,661,30,691
2025-01-19,11,1,SKU019,644,28,672
2025-01-19,11,2,SKU024,694,29,723
2025-01-19,11,3,SKU002,355,25,380
2025-01-19,12,2,SKU038,693,3,696
2025-01-19,12,3,SKU010,606,49,655
2025-01-19,13,1,SKU024,728,33,761
2025-01-19,13,2,SKU036,393,43,436
2025-01-19,13,3,SKU017,431,35,466
2025-01-19,14,2,SKU032,385,52,437
2025-01-19,14,3,SKU028,299,43,342
2025-01-19,15,1,SKU031,647,56,703
2025-01-19,15,2,SKU001,287,5,292
2025-01-19,15,3,SKU031,626,13,639
2025-01-20,1,1,SKU005,680,37,717
2025-01-20,1,3,SKU037,455,24,479
2025-01-20,2,1,SKU035,305,16,321
2025-01-20,2,2,SKU020,536,12,548
2025-01-20,2,3,SKU031,238,27,265
2025-01-20,3,1,SKU019,682,66,748
2025-01-20,4,1,SKU008,738,87,825
2025-01-20,4,2,SKU018,299,12,311
2025-01-20,4,3,SKU015,787,105,892
2025-01-20,5,1,SKU024,455,53,508
2025-01-20,5,2,SKU006,698,82,780
2025-01-20,5,3,SKU001,732,19,751
2025-01-20,6,1,SKU038,767,75,842
2025-01-20,6,2,SKU001,638,54,692
2025-01-20,6,3,SKU013,664,23,687
2025-01-20,7,1,SKU016,441,56,497
2025-01-20,7,2,SKU031,239,19,258
2025-01-20,7,3,SKU010,448,63,511
2025-01-20,8,1,SKU018,538,39,577
2025-01-20,8,2,SKU021,485,45,530
2025-01-20,8,3,SKU007,255,22,277
2025-01-20,9,1,SKU009,476,45,521
2025-01-20,9,2,SKU024,226,15,241
2025-01-20,9,3,SKU037,216,29,245
2025-01-20,10,1,SKU018,528,9,537
2025-01-20,10,2,SKU033,353,35,388
2025-01-20,10,3,SKU037,562,68,630
2025-01-20,11,1,SKU015,630,12,642
2025-01-20,11,2,SKU026,357,5,362
2025-01-20,11,3,SKU031,451,0,451
2025-01-20,12,2,SKU026,505,56,561
2025-01-20,12,3,SKU009,769,46,815
2025-01-20,13,1,SKU025,223,32,255
2025-01-20,13,3,SKU034,459,24,483
2025-01-20,14,1,SKU005,309,45,354
2025-01-20,14,3,SKU013,351,40,391
2025-01-20,15,1,SKU024,211,3,214
2025-01-20,15,2,SKU003,277,27,304
2025-01-20,15,3,SKU028,716,31,747
2025-01-21,1,1,SKU009,540,9,549
2025-01-21,1,2,SKU007,252,7,259
2025-01-21,1,3,SKU008,335,25,360
2025-01-21,2,1,SKU017,640,1,641
2025-01-21,2,2,SKU025,306,31,337
2025-01-21,2,3,SKU013,361,26,387
2025-01-21,3,1,SKU018,503,7,510
2025-01-21,3,2,SKU036,645,65,710
2025-01-21,3,3,SKU015,346,10,356
2025-01-21,4,1,SKU011,548,16,564
2025-01-21,4,2,SKU038,396,53,449
2025-01-21,5,1,SKU005,635,82,717
2025-01-21,5,2,SKU033,469,20,489
2025-01-21,5,3,SKU035,726,92,818
2025-01-21,6,1,SKU005,305,1,306
2025-01-21,6,2,SKU028,667,90,757
2025-01-21,6,3,SKU002,641,66,707
2025-01-21,7,1,SKU018,515,24,539
2025-01-21,7,2,SKU028,260,19,279
2025-01-21,8,1,SKU003,501,66,567
2025-01-21,8,2,SKU003,518,65,583
2025-01-21,8,3,SKU013,701,24,725
2025-01-21,9,1,SKU024,362,28,390
2025-01-21,9,2,SKU010,398,0,398
2025-01-21,9,3,SKU020,714,70,784
2025-01-21,10,1,SKU035,215,6,221
2025-01-21,10,2,SKU004,291,36,327
2025-01-21,10,3,SKU022,649,73,722
2025-01-21,11,1,SKU018,764,53,817
2025-01-21,11,3,SKU011,579,69,648
2025-01-21,12,1,SKU015,675,63,738
2025-01-21,12,2,SKU007,407,49,456
2025-01-21,12,3,SKU011,233,10,243
2025-01-21,13,1,SKU040,355,9,364
2025-01-21,13,2,SKU031,618,44,662
2025-01-21,14,1,SKU021,641,35,676
2025-01-21,14,2,SKU014,510,29,539
2025-01-21,15,2,SKU021,698,75,773
2025-01-21,15,3,SKU022,500,9,509
2025-01-22,1,2,SKU005,285,1,286
2025-01-22,1,3,SKU010,205,22,227
2025-01-22,2,1,SKU023,776,38,814
2025-01-22,2,3,SKU014,369,26,395
2025-01-22,3,1,SKU039,257,4,261
2025-01-22,3,2,SKU004,424,48,472
2025-01-22,4,1,SKU002,762,95,857
2025-01-22,5,1,SKU012,552,70,622
2025-01-22,5,2,SKU002,621,81,702
2025-01-22,5,3,SKU034,278,20,298
2025-01-22,6,1,SKU012,719,57,776
2025-01-22,6,2,SKU037,605,69,674
2025-01-22,6,3,SKU011,310,34,344
2025-01-22,7,1,SKU008,604,25,629
2025-01-22,7,2,SKU007,259,5,264
2025-01-22,7,3,SKU013,410,1,411
2025-01-22,8,1,SKU027,561,66,627
2025-01-22,8,2,SKU002,542,73,615
2025-01-22,9,2,SKU010,658,41,699
2025-01-22,9,3,SKU019,704,50,754
2025-01-22,10,3,SKU016,238,13,251
2025-01-22,11,2,SKU037,683,22,705
2025-01-22,11,3,SKU018,617,54,671
2025-01-22,12,1,SKU020,707,26,733
2025-01-22,12,2,SKU008,229,19,248
2025-01-22,13,1,SKU011,647,70,717
2025-01-22,13,2,SKU005,442,13,455
2025-01-22,13,3,SKU024,295,29,324
2025-01-22,14,1,SKU006,640,55,695
2025-01-22,15,1,SKU020,617,62,679
2025-01-22,15,2,SKU014,766,28,794
2025-01-23,1,1,SKU026,243,35,278
2025-01-23,1,2,SKU003,518,35,553
2025-01-23,1,3,SKU005,426,48,474
2025-01-23,2,1,SKU027,429,46,475
2025-01-23,2,3,SKU008,488,24,512
2025-01-23,3,2,SKU038,621,87,708
2025-01-23,3,3,SKU040,202,19,221
2025-01-23,4,1,SKU035,648,39,687
2025-01-23,4,2,SKU029,227,2,229
2025-01-23,4,3,SKU034,567,80,647
2025-01-23,5,1,SKU011,281,22,303
2025-01-23,5,2,SKU034,649,12,661
2025-01-23,5,3,SKU014,691,9,700
2025-01-23,6,1,SKU010,259,17,276
2025-01-23,6,2,SKU032,566,19,585
2025-01-23,7,1,SKU017,401,8,409
2025-01-23,7,2,SKU035,782,110,892
2025-01-23,7,3,SKU012,790,3,793
2025-01-23,8,1,SKU003,452,19,471
2025-01-23,8,2,SKU023,581,29,610
2025-01-23,8,3,SKU002,779,12,791
2025-01-23,9,1,SKU019,332,4,336
2025-01-23,9,2,SKU020,669,23,692
2025-01-23,10,1,SKU023,590,50,640
2025-01-23,10,2,SKU029,205,7,212
2025-01-23,10,3,SKU033,480,51,531
2025-01-23,11,1,SKU007,585,80,665
2025-01-23,11,2,SKU040,448,23,471
2025-01-23,11,3,SKU006,235,18,253
2025-01-23,12,1,SKU021,789,93,882
2025-01-23,12,3,SKU039,463,36,499
2025-01-23,13,1,SKU023,591,73,664
2025-01-23,13,2,SKU007,567,5,572
2025-01-23,13,3,SKU026,629,28,657
2025-01-23,14,1,SKU014,326,37,363
2025-01-23,14,2,SKU039,569,1,570
2025-01-23,14,3,SKU034,741,102,843
2025-01-23,15,2,SKU021,360,39,399
2025-01-23,15,3,SKU016,706,18,724
2025-01-24,1,2,SKU018,309,40,349
2025-01-24,1,3,SKU031,633,24,657
2025-01-24,2,2,SKU007,469,40,509
2025-01-24,2,3,SKU006,796,116,912
2025-01-24,3,1,SKU039,241,7,248
2025-01-24,3,2,SKU029,734,79,813
2025-01-24,3,3,SKU017,278,34,312
2025-01-24,4,1,SKU001,437,55,492
2025-01-24,4,3,SKU009,648,41,689
2025-01-24,5,1,SKU008,781,105,886
2025-01-24,5,3,SKU008,665,39,704
2025-01-24,6,2,SKU038,775,75,850
2025-01-24,6,3,SKU012,479,15,494
2025-01-24,7,1,SKU019,413,1,414
2025-01-24,7,2,SKU040,617,91,708
2025-01-24,7,3,SKU034,593,20,613
2025-01-24,8,1,SKU040,761,94,855
2025-01-24,8,2,SKU019,751,66,817
2025-01-24,9,3,SKU025,357,19,376
2025-01-24,10,1,SKU035,340,43,383
2025-01-24,10,2,SKU004,371,42,413
2025-01-24,11,2,SKU010,578,75,653
2025-01-24,11,3,SKU004,468,23,491
2025-01-24,12,1,SKU023,403,16,419
2025-01-24,12,2,SKU028,356,22,378
2025-01-24,12,3,SKU021,229,26,255
2025-01-24,13,1,SKU007,466,7,473
2025-01-24,13,2,SKU026,791,48,839
2025-01-24,13,3,SKU035,530,25,555
2025-01-24,14,1,SKU036,602,10,612
2025-01-24,14,2,SKU026,529,52,581
2025-01-24,14,3,SKU028,367,25,392
2025-01-24,15,1,SKU025,678,21,699
2025-01-24,15,2,SKU033,749,93,842
2025-01-24,15,3,SKU039,601,50,651
2025-01-25,1,1,SKU035,748,102,850
2025-01-25,1,3,SKU013,427,37,464
2025-01-25,2,1,SKU022,559,63,622
2025-01-25,2,3,SKU007,646,36,682
2025-01-25,3,1,SKU028,623,85,708
2025-01-25,3,2,SKU020,361,26,387
2025-01-25,3,3,SKU002,387,19,406
2025-01-25,4,1,SKU018,316,15,331
2025-01-25,4,2,SKU025,608,73,681
2025-01-25,4,3,SKU029,633,26,659
2025-01-25,5,1,SKU011,382,50,432
2025-01-25,5,3,SKU003,753,57,810
2025-01-25,6,1,SKU029,706,44,750
2025-01-25,6,2,SKU010,493,49,542
2025-01-25,6,3,SKU009,715,54,769
2025-01-25,7,1,SKU021,436,4,440
2025-01-25,7,2,SKU012,324,38,362
2025-01-25,7,3,SKU029,598,8,606
2025-01-25,8,1,SKU025,674,38,712
2025-01-25,8,2,SKU010,767,51,818
2025-01-25,8,3,SKU008,302,43,345
2025-01-25,9,2,SKU036,690,53,743
2025-01-25,10,1,SKU024,221,14,235
2025-01-25,10,2,SKU040,329,24,353
2025-01-25,10,3,SKU029,641,68,709
2025-01-25,11,1,SKU035,454,22,476
2025-01-25,11,2,SKU040,417,46,463
2025-01-25,11,3,SKU003,267,39,306
2025-01-25,12,2,SKU029,490,66,556
2025-01-25,12,3,SKU016,734,43,777
2025-01-25,13,1,SKU036,289,18,307
2025-01-25,13,2,SKU030,346,35,381
2025-01-25,13,3,SKU027,759,61,820
2025-01-25,14,1,SKU031,201,5,206
2025-01-25,14,2,SKU008,273,8,281
2025-01-25,14,3,SKU012,347,41,388
2025-01-25,15,1,SKU021,743,97,840
2025-01-26,1,2,SKU014,285,2,287
2025-01-26,1,3,SKU039,401,37,438
2025-01-26,2,1,SKU004,690,39,729
2025-01-26,2,2,SKU009,613,19,632
2025-01-26,3,1,SKU001,578,23,601
2025-01-26,3,2,SKU013,638,81,719
2025-01-26,3,3,SKU031,640,73,713
2025-01-26,4,1,SKU040,770,20,790
2025-01-26,4,2,SKU004,372,17,389
2025-01-26,4,3,SKU021,688,58,746
2025-01-26,5,2,SKU019,449,3,452
2025-01-26,6,1,SKU033,788,65,853
2025-01-26,6,3,SKU037,263,3,266
2025-01-26,7,1,SKU011,312,17,329
2025-01-26,7,2,SKU025,441,33,474
2025-01-26,7,3,SKU008,607,4,611
2025-01-26,8,1,SKU032,394,28,422
2025-01-26,8,3,SKU019,649,78,727
2025-01-26,9,1,SKU029,772,42,814
2025-01-26,9,2,SKU003,224,31,255
2025-01-26,9,3,SKU030,768,54,822
2025-01-26,10,1,SKU008,239,31,270
2025-01-26,10,2,SKU039,504,28,532
2025-01-26,10,3,SKU038,618,89,707
2025-01-26,11,1,SKU022,348,48,396
2025-01-26,11,2,SKU010,594,41,635
2025-01-26,12,1,SKU030,226,18,244
2025-01-26,12,2,SKU007,586,67,653
2025-01-26,12,3,SKU008,568,34,602
2025-01-26,13,1,SKU026,322,11,333
2025-01-26,13,3,SKU034,767,33,800
2025-01-26,14,1,SKU020,519,0,519
2025-01-26,14,2,SKU021,392,14,406
2025-01-26,14,3,SKU018,620,50,670
2025-01-26,15,1,SKU024,219,5,224
2025-01-26,15,3,SKU011,586,63,649
2025-01-27,1,1,SKU031,624,2,626
2025-01-27,1,2,SKU014,552,42,594
2025-01-27,2,1,SKU019,251,29,280
2025-01-27,2,3,SKU002,774,13,787
2025-01-27,3,1,SKU033,706,45,751
2025-01-27,3,2,SKU024,567,34,601
2025-01-27,3,3,SKU019,209,18,227
2025-01-27,4,1,SKU039,476,9,485
2025-01-27,5,1,SKU021,352,39,391
2025-01-27,5,2,SKU008,533,46,579
2025-01-27,6,3,SKU032,551,80,631
2025-01-27,7,1,SKU005,759,7,766
2025-01-27,7,2,SKU031,273,38,311
2025-01-27,7,3,SKU013,402,42,444
2025-01-27,8,1,SKU007,266,38,304
2025-01-27,8,2,SKU027,614,65,679
2025-01-27,8,3,SKU019,597,35,632
2025-01-27,9,1,SKU023,218,2,220
2025-01-27,9,2,SKU031,644,22,666
2025-01-27,9,3,SKU008,628,24,652
2025-01-27,10,1,SKU004,700,34,734
2025-01-27,10,2,SKU027,590,24,614
2025-01-27,10,3,SKU004,594,53,647
2025-01-27,11,2,SKU018,706,102,808
2025-01-27,11,3,SKU039,739,3,742
2025-01-27,12,1,SKU023,275,34,309
2025-01-27,12,2,SKU031,484,71,555
2025-01-27,12,3,SKU025,562,66,628
2025-01-27,13,1,SKU034,761,61,822
2025-01-27,13,2,SKU015,392,52,444
2025-01-27,13,3,SKU002,700,23,723
2025-01-27,14,1,SKU017,743,30,773
2025-01-27,14,2,SKU008,458,10,468
2025-01-27,14,3,SKU007,368,53,421
2025-01-27,15,1,SKU016,232,6,238
2025-01-27,15,3,SKU001,392,39,431
2025-01-28,1,1,SKU020,318,24,342
2025-01-28,1,2,SKU010,291,0,291
2025-01-28,2,1,SKU008,341,8,349
2025-01-28,2,2,SKU009,392,36,428
2025-01-28,2,3,SKU007,400,19,419
2025-01-28,3,2,SKU019,271,33,304
2025-01-28,3,3,SKU037,537,72,609
2025-01-28,4,1,SKU020,576,42,618
2025-01-28,4,2,SKU024,309,38,347
2025-01-28,5,1,SKU013,522,65,587
2025-01-28,5,3,SKU029,261,11,272
2025-01-28,6,1,SKU031,600,26,626
2025-01-28,6,3,SKU035,234,25,259
2025-01-28,7,1,SKU003,416,37,453
2025-01-28,7,2,SKU004,259,8,267
2025-01-28,7,3,SKU001,604,36,640
2025-01-28,8,1,SKU023,692,15,707
2025-01-28,8,3,SKU037,478,0,478
2025-01-28,9,1,SKU024,552,13,565
2025-01-28,9,2,SKU039,536,41,577
2025-01-28,9,3,SKU026,444,24,468
2025-01-28,10,1,SKU011,315,11,326
2025-01-28,10,2,SKU012,532,6,538
2025-01-28,10,3,SKU018,482,46,528
2025-01-28,11,2,SKU003,729,0,729
2025-01-28,11,3,SKU016,211,24,235
2025-01-28,12,1,SKU001,467,38,505
2025-01-28,12,2,SKU026,309,24,333
2025-01-28,12,3,SKU016,334,19,353
2025-01-28,13,3,SKU025,624,13,637
2025-01-28,14,1,SKU034,464,16,480
2025-01-28,14,2,SKU016,285,29,314
2025-01-28,14,3,SKU017,572,64,636
2025-01-28,15,1,SKU024,473,64,537
2025-01-29,1,2,SKU006,471,1,472
2025-01-29,1,3,SKU032,365,32,397
2025-01-29,2,1,SKU021,322,23,345
2025-01-29,2,2,SKU017,737,46,783
2025-01-29,2,3,SKU034,717,82,799
2025-01-29,3,1,SKU013,781,93,874
2025-01-29,3,2,SKU037,230,7,237
2025-01-29,3,3,SKU009,610,18,628
2025-01-29,4,1,SKU036,573,40,613
2025-01-29,4,2,SKU020,396,32,428
2025-01-29,4,3,SKU032,223,27,250
2025-01-29,5,1,SKU011,660,86,746
2025-01-29,5,2,SKU005,408,0,408
2025-01-29,5,3,SKU008,564,68,632
2025-01-29,6,1,SKU029,717,68,785
2025-01-29,6,2,SKU028,643,87,730
2025-01-29,6,3,SKU002,673,13,686
2025-01-29,7,1,SKU003,637,48,685
2025-01-29,7,3,SKU026,527,21,548
2025-01-29,8,1,SKU003,483,27,510
2025-01-29,8,3,SKU030,443,25,468
2025-01-29,9,1,SKU015,737,10,747
2025-01-29,9,2,SKU006,602,5,607
2025-01-29,9,3,SKU018,537,31,568
2025-01-29,10,1,SKU026,450,28,478
2025-01-29,10,2,SKU003,385,25,410
2025-01-29,10,3,SKU004,322,17,339
2025-01-29,11,2,SKU021,663,89,752
2025-01-29,11,3,SKU013,553,14,567
2025-01-29,12,1,SKU024,643,44,687
2025-01-29,12,2,SKU022,343,18,361
2025-01-29,12,3,SKU003,606,69,675
2025-01-29,13,1,SKU033,298,4,302
2025-01-29,13,2,SKU033,522,72,594
2025-01-29,13,3,SKU015,533,26,559
2025-01-29,14,1,SKU017,329,0,329
2025-01-29,14,2,SKU021,512,47,559
2025-01-29,14,3,SKU012,782,62,844
2025-01-29,15,1,SKU038,789,6,795
2025-01-29,15,2,SKU028,418,45,463
2025-01-29,15,3,SKU012,612,30,642
2025-01-30,1,2,SKU030,269,39,308
2025-01-30,1,3,SKU031,320,44,364
2025-01-30,2,1,SKU015,262,34,296
2025-01-30,2,2,SKU040,240,15,255
2025-01-30,2,3,SKU029,306,36,342
2025-01-30,3,1,SKU007,719,54,773
2025-01-30,3,2,SKU036,681,48,729
2025-01-30,3,3,SKU003,517,52,569
2025-01-30,4,2,SKU004,360,36,396
2025-01-30,4,3,SKU024,392,53,445
2025-01-30,5,2,SKU009,317,11,328
2025-01-30,5,3,SKU010,550,36,586
2025-01-30,6,1,SKU015,377,31,408
2025-01-30,6,2,SKU011,622,60,682
2025-01-30,6,3,SKU020,315,0,315
2025-01-30,7,1,SKU005,577,19,596
2025-01-30,7,3,SKU018,387,47,434
2025-01-30,8,1,SKU017,739,45,784
2025-01-30,8,2,SKU037,463,63,526
2025-01-30,8,3,SKU035,607,89,696
2025-01-30,9,1,SKU039,424,36,460
2025-01-30,9,2,SKU015,557,62,619
2025-01-30,9,3,SKU010,654,37,691
2025-01-30,10,2,SKU016,634,72,706
2025-01-30,10,3,SKU007,251,32,283
2025-01-30,11,1,SKU012,771,68,839
2025-01-30,11,2,SKU018,406,30,436
2025-01-30,11,3,SKU009,482,43,525
2025-01-30,12,1,SKU017,737,30,767
2025-01-30,12,2,SKU038,460,56,516
2025-01-30,12,3,SKU004,732,53,785
2025-01-30,13,1,SKU029,265,5,270
2025-01-30,13,2,SKU016,218,10,228
2025-01-30,13,3,SKU003,631,78,709
2025-01-30,14,1,SKU002,668,76,744
2025-01-30,14,2,SKU005,603,43,646
2025-01-30,14,3,SKU040,509,41,550
2025-01-30,15,1,SKU016,458,23,481
2025-01-30,15,2,SKU001,518,45,563
2025-01-31,1,1,SKU012,370,27,397
2025-01-31,1,2,SKU040,545,18,563
2025-01-31,1,3,SKU013,406,50,456
2025-01-31,2,1,SKU005,466,47,513
2025-01-31,2,3,SKU024,746,13,759
2025-01-31,3,1,SKU032,790,56,846
2025-01-31,3,2,SKU024,388,42,430
2025-01-31,3,3,SKU005,655,16,671
2025-01-31,4,1,SKU004,462,19,481
2025-01-31,4,2,SKU037,582,36,618
2025-01-31,5,1,SKU014,635,7,642
2025-01-31,5,2,SKU010,543,60,603
2025-01-31,5,3,SKU033,490,51,541
2025-01-31,6,1,SKU009,224,30,254
2025-01-31,6,2,SKU011,212,10,222
2025-01-31,7,1,SKU008,335,2,337
2025-01-31,7,2,SKU009,735,81,816
2025-01-31,7,3,SKU016,381,40,421
2025-01-31,8,1,SKU006,639,81,720
2025-01-31,8,2,SKU019,728,33,761
2025-01-31,8,3,SKU002,555,80,635
2025-01-31,9,1,SKU011,385,50,435
2025-01-31,9,2,SKU019,261,8,269
2025-01-31,9,3,SKU026,517,4,521
2025-01-31,10,1,SKU006,566,72,638
2025-01-31,10,3,SKU012,422,31,453
2025-01-31,11,2,SKU002,334,44,378
2025-01-31,11,3,SKU037,399,10,409
2025-01-31,12,1,SKU020,638,25,663
2025-01-31,12,2,SKU025,449,2,451
2025-01-31,12,3,SKU018,209,2,211
2025-01-31,13,1,SKU004,393,25,418
2025-01-31,13,2,SKU011,725,19,744
2025-01-31,14,1,SKU015,622,57,679
2025-01-31,14,2,SKU015,603,21,624
2025-01-31,14,3,SKU010,476,62,538
2025-01-31,15,1,SKU039,431,30,461
2025-01-31,15,2,SKU030,498,27,525
2025-02-01,1,1,SKU026,344,7,351
2025-02-01,1,2,SKU036,569,28,597
2025-02-01,2,1,SKU003,798,63,861
2025-02-01,2,2,SKU033,544,18,562
2025-02-01,2,3,SKU040,651,85,736
2025-02-01,3,1,SKU034,440,13,453
2025-02-01,3,2,SKU033,282,16,298
2025-02-01,3,3,SKU017,699,65,764
2025-02-01,4,1,SKU017,315,10,325
2025-02-01,4,2,SKU005,609,16,625
2025-02-01,5,1,SKU008,283,2,285
2025-02-01,5,3,SKU027,386,36,422
2025-02-01,6,1,SKU009,441,21,462
2025-02-01,6,2,SKU013,413,49,462
2025-02-01,6,3,SKU029,717,15,732
2025-02-01,7,1,SKU027,499,19,518
2025-02-01,7,2,SKU028,336,43,379
2025-02-01,7,3,SKU037,492,65,557
2025-02-01,8,1,SKU037,682,40,722
2025-02-01,8,2,SKU018,244,5,249
2025-02-01,8,3,SKU019,225,13,238
2025-02-01,9,2,SKU039,229,26,255
2025-02-01,9,3,SKU027,225,19,244
2025-02-01,10,1,SKU023,429,39,468
2025-02-01,10,3,SKU010,326,16,342
2025-02-01,11,1,SKU023,691,1,692
2025-02-01,11,2,SKU034,415,22,437
2025-02-01,11,3,SKU008,318,31,349
2025-02-01,12,2,SKU028,587,80,667
2025-02-01,12,3,SKU031,756,74,830
2025-02-01,13,1,SKU012,721,71,792
2025-02-01,13,2,SKU007,317,23,340
2025-02-01,13,3,SKU030,653,75,728
2025-02-01,14,2,SKU012,450,56,506
2025-02-01,14,3,SKU015,242,12,254
2025-02-01,15,1,SKU001,525,33,558
2025-02-01,15,2,SKU037,395,26,421
2025-02-01,15,3,SKU008,367,14,381
2025-02-02,1,2,SKU024,780,69,849
2025-02-02,1,3,SKU035,370,42,412
2025-02-02,2,1,SKU002,479,54,533
2025-02-02,2,2,SKU033,682,20,702
2025-02-02,3,1,SKU040,203,2,205
2025-02-02,3,2,SKU020,761,48,809
2025-02-02,3,3,SKU011,480,60,540
2025-02-02,4,2,SKU037,674,29,703
2025-02-02,4,3,SKU013,319,0,319
2025-02-02,5,1,SKU017,637,0,637
2025-02-02,5,2,SKU039,640,27,667
2025-02-02,5,3,SKU016,203,16,219
2025-02-02,6,1,SKU015,692,74,766
2025-02-02,6,2,SKU024,429,51,480
2025-02-02,6,3,SKU009,279,9,288
2025-02-02,7,1,SKU017,361,51,412
2025-02-02,7,2,SKU030,469,55,524
2025-02-02,7,3,SKU040,497,61,558
2025-02-02,8,1,SKU016,436,5,441
2025-02-02,8,3,SKU008,380,12,392
2025-02-02,9,1,SKU003,452,38,490
2025-02-02,9,2,SKU004,725,78,803
2025-02-02,9,3,SKU011,300,22,322
2025-02-02,10,1,SKU015,608,76,684
2025-02-02,10,2,SKU007,644,29,673
2025-02-02,10,3,SKU014,461,53,514
2025-02-02,11,1,SKU019,653,27,680
2025-02-02,11,2,SKU038,311,29,340
2025-02-02,11,3,SKU003,304,5,309
2025-02-02,12,1,SKU030,387,11,398
2025-02-02,12,2,SKU004,411,8,419
2025-02-02,12,3,SKU026,270,38,308
2025-02-02,13,1,SKU037,749,67,816
2025-02-02,13,2,SKU024,600,85,685
2025-02-02,13,3,SKU023,544,68,612
2025-02-02,14,1,SKU008,763,26,789
2025-02-02,14,2,SKU026,399,36,435
2025-02-02,14,3,SKU027,574,78,652
2025-02-02,15,2,SKU001,613,90,703
2025-02-02,15,3,SKU008,331,34,365
2025-02-03,1,2,SKU001,510,15,525
2025-02-03,1,3,SKU026,606,51,657
2025-02-03,2,1,SKU036,710,8,718
2025-02-03,2,3,SKU015,253,29,282
2025-02-03,3,1,SKU030,792,99,891
2025-02-03,3,2,SKU040,348,19,367
2025-02-03,3,3,SKU020,780,113,893
2025-02-03,4,1,SKU026,467,2,469
2025-02-03,4,2,SKU032,672,71,743
2025-02-03,4,3,SKU036,282,21,303
2025-02-03,5,1,SKU039,256,18,274
2025-02-03,5,2,SKU001,355,26,381
2025-02-03,6,1,SKU002,711,59,770
2025-02-03,6,2,SKU011,611,64,675
2025-02-03,6,3,SKU035,767,51,818
2025-02-03,7,2,SKU039,300,28,328
2025-02-03,7,3,SKU028,727,32,759
2025-02-03,8,1,SKU009,387,46,433
2025-02-03,8,2,SKU036,239,24,263
2025-02-03,8,3,SKU004,530,42,572
2025-02-03,9,1,SKU007,684,57,741
2025-02-03,10,2,SKU001,235,13,248
2025-02-03,10,3,SKU039,747,39,786
2025-02-03,11,1,SKU017,753,78,831
2025-02-03,11,2,SKU022,616,34,650
2025-02-03,11,3,SKU025,519,59,578
2025-02-03,12,1,SKU025,357,42,399
2025-02-03,12,2,SKU037,226,23,249
2025-02-03,12,3,SKU035,227,33,260
2025-02-03,13,2,SKU037,718,67,785
2025-02-03,13,3,SKU016,436,20,456
2025-02-03,14,1,SKU029,364,43,407
2025-02-03,14,3,SKU015,612,1,613
2025-02-03,15,1,SKU016,709,37,746
2025-02-03,15,2,SKU035,737,81,818
2025-02-03,15,3,SKU031,725,6,731
2025-02-04,1,2,SKU002,566,21,587
2025-02-04,1,3,SKU015,791,65,856
2025-02-04,2,1,SKU008,349,39,388
2025-02-04,2,2,SKU032,750,15,765
2025-02-04,2,3,SKU002,699,74,773
2025-02-04,3,1,SKU012,663,14,677
2025-02-04,3,2,SKU033,662,63,725
2025-02-04,3,3,SKU006,762,61,823
2025-02-04,4,1,SKU014,518,64,582
2025-02-04,4,2,SKU011,718,105,823
2025-02-04,4,3,SKU028,406,32,438
2025-02-04,5,1,SKU025,531,1,532
2025-02-04,5,3,SKU005,447,21,468
2025-02-04,6,3,SKU037,216,23,239
2025-02-04,7,1,SKU012,318,29,347
2025-02-04,7,2,SKU039,381,37,418
2025-02-04,7,3,SKU020,329,26,355
2025-02-04,8,2,SKU006,387,52,439
2025-02-04,8,3,SKU037,397,8,405
2025-02-04,9,2,SKU009,420,54,474
2025-02-04,9,3,SKU010,771,43,814
2025-02-04,10,1,SKU031,734,56,790
2025-02-04,10,2,SKU011,444,33,477
2025-02-04,10,3,SKU002,546,48,594
2025-02-04,11,1,SKU002,207,27,234
2025-02-04,11,2,SKU038,241,11,252
2025-02-04,11,3,SKU011,429,53,482
2025-02-04,12,1,SKU017,700,33,733
2025-02-04,12,2,SKU005,671,55,726
2025-02-04,12,3,SKU012,581,42,623
2025-02-04,13,1,SKU021,635,54,689
2025-02-04,13,2,SKU004,621,39,660
2025-02-04,13,3,SKU024,703,24,727
2025-02-04,14,1,SKU015,475,33,508
2025-02-04,14,2,SKU023,331,20,351
2025-02-04,15,1,SKU034,286,7,293
2025-02-04,15,2,SKU027,387,16,403
2025-02-04,15,3,SKU010,301,27,328
2025-02-05,1,3,SKU012,463,43,506
2025-02-05,2,1,SKU040,701,100,801
2025-02-05,2,2,SKU021,618,31,649
2025-02-05,2,3,SKU029,729,27,756
2025-02-05,3,1,SKU021,759,18,777
2025-02-05,3,2,SKU040,560,13,573
2025-02-05,3,3,SKU007,467,25,492
2025-02-05,4,1,SKU016,563,7,570
2025-02-05,4,2,SKU017,675,63,738
2025-02-05,4,3,SKU003,388,17,405
2025-02-05,5,1,SKU009,562,33,595
2025-02-05,5,3,SKU017,384,17,401
2025-02-05,6,1,SKU036,705,67,772
2025-02-05,6,2,SKU036,389,11,400
2025-02-05,6,3,SKU009,780,30,810
2025-02-05,7,1,SKU025,709,34,743
2025-02-05,7,3,SKU003,535,12,547
2025-02-05,8,1,SKU027,238,28,266
2025-02-05,8,2,SKU024,362,30,392
2025-02-05,8,3,SKU040,578,24,602
2025-02-05,9,1,SKU005,681,55,736
2025-02-05,9,2,SKU034,766,43,809
2025-02-05,9,3,SKU026,788,97,885
2025-02-05,10,1,SKU024,652,85,737
2025-02-05,10,2,SKU007,491,3,494
2025-02-05,10,3,SKU008,422,52,474
2025-02-05,11,2,SKU033,268,11,279
2025-02-05,11,3,SKU026,271,3,274
2025-02-05,12,1,SKU006,359,9,368
2025-02-05,12,2,SKU040,799,9,808
2025-02-05,12,3,SKU005,380,51,431
2025-02-05,13,1,SKU017,666,32,698
2025-02-05,13,2,SKU032,354,31,385
2025-02-05,13,3,SKU024,208,20,228
2025-02-05,14,2,SKU002,217,14,231
2025-02-05,14,3,SKU039,728,37,765
2025-02-05,15,1,SKU036,571,30,601
2025-02-05,15,2,SKU014,785,73,858
2025-02-05,15,3,SKU008,370,31,401
2025-02-06,1,1,SKU017,519,22,541
2025-02-06,1,2,SKU012,507,24,531
2025-02-06,1,3,SKU017,243,29,272
2025-02-06,2,1,SKU008,404,44,448
2025-02-06,2,2,SKU038,609,73,682
2025-02-06,2,3,SKU029,438,8,446
2025-02-06,3,1,SKU034,427,62,489
2025-02-06,3,3,SKU016,501,74,575
2025-02-06,4,1,SKU031,425,34,459
2025-02-06,4,3,SKU012,270,4,274
2025-02-06,5,1,SKU012,651,27,678
2025-02-06,5,2,SKU006,700,24,724
2025-02-06,5,3,SKU021,629,10,639
2025-02-06,6,1,SKU026,770,78,848
2025-02-06,6,3,SKU014,292,27,319
2025-02-06,7,1,SKU037,253,4,257
2025-02-06,7,2,SKU003,581,11,592
2025-02-06,7,3,SKU033,317,38,355
2025-02-06,8,1,SKU013,392,18,410
2025-02-06,8,2,SKU021,491,48,539
2025-02-06,8,3,SKU028,521,77,598
2025-02-06,9,1,SKU038,753,41,794
2025-02-06,9,2,SKU001,655,9,664
2025-02-06,10,1,SKU006,707,52,759
2025-02-06,10,2,SKU028,615,33,648
2025-02-06,10,3,SKU011,471,7,478
2025-02-06,11,1,SKU031,758,104,862
2025-02-06,11,2,SKU019,419,37,456
2025-02-06,11,3,SKU028,678,71,749
2025-02-06,12,1,SKU039,486,28,514
2025-02-06,12,2,SKU008,373,47,420
2025-02-06,12,3,SKU039,453,26,479
2025-02-06,13,2,SKU031,540,80,620
2025-02-06,13,3,SKU035,568,32,600
2025-02-06,14,1,SKU011,201,14,215
2025-02-06,14,2,SKU030,462,31,493
2025-02-06,15,1,SKU029,517,18,535
2025-02-06,15,2,SKU009,446,1,447
2025-02-06,15,3,SKU013,518,53,571
2025-02-07,1,3,SKU004,407,19,426
2025-02-07,2,1,SKU036,435,11,446
2025-02-07,2,3,SKU034,609,45,654
2025-02-07,3,2,SKU028,295,43,338
2025-02-07,3,3,SKU032,222,5,227
2025-02-07,4,1,SKU008,547,34,581
2025-02-07,4,2,SKU008,321,7,328
2025-02-07,4,3,SKU024,500,57,557
2025-02-07,5,1,SKU030,726,49,775
2025-02-07,5,2,SKU031,497,26,523
2025-02-07,5,3,SKU012,375,10,385
2025-02-07,6,1,SKU015,288,7,295
2025-02-07,6,2,SKU016,267,19,286
2025-02-07,6,3,SKU035,622,8,630
2025-02-07,7,1,SKU018,353,6,359
2025-02-07,7,2,SKU007,254,6,260
2025-02-07,7,3,SKU035,621,61,682
2025-02-07,8,1,SKU018,472,32,504
2025-02-07,8,2,SKU003,386,35,421
2025-02-07,8,3,SKU018,411,20,431
2025-02-07,9,1,SKU024,347,39,386
2025-02-07,9,2,SKU009,773,90,863
2025-02-07,9,3,SKU035,539,70,609
2025-02-07,10,1,SKU015,780,96,876
2025-02-07,10,2,SKU018,600,84,684
2025-02-07,10,3,SKU029,574,12,586
2025-02-07,11,1,SKU010,326,5,331
2025-02-07,11,2,SKU015,547,78,625
2025-02-07,11,3,SKU017,244,19,263
2025-02-07,12,2,SKU022,225,21,246
2025-02-07,12,3,SKU033,530,44,574
2025-02-07,13,1,SKU005,623,33,656
2025-02-07,13,2,SKU029,354,49,403
2025-02-07,13,3,SKU003,240,9,249
2025-02-07,14,1,SKU013,319,40,359
2025-02-07,14,2,SKU022,533,65,598
2025-02-07,14,3,SKU019,523,40,563
2025-02-07,15,2,SKU029,783,4,787
2025-02-07,15,3,SKU034,219,27,246
2025-02-08,1,1,SKU025,438,35,473
2025-02-08,1,2,SKU027,713,20,733
2025-02-08,1,3,SKU004,497,52,549
2025-02-08,2,1,SKU027,555,71,626
2025-02-08,2,2,SKU014,206,7,213
2025-02-08,2,3,SKU008,603,21,624
2025-02-08,3,1,SKU003,605,7,612
2025-02-08,3,2,SKU025,517,45,562
2025-02-08,3,3,SKU019,267,32,299
2025-02-08,4,1,SKU040,507,68,575
2025-02-08,4,2,SKU013,710,104,814
2025-02-08,4,3,SKU036,486,61,547
2025-02-08,5,1,SKU036,350,3,353
2025-02-08,5,2,SKU037,765,7,772
2025-02-08,5,3,SKU003,682,0,682
2025-02-08,6,1,SKU018,282,33,315
2025-02-08,6,2,SKU023,515,1,516
2025-02-08,7,1,SKU036,532,48,580
2025-02-08,7,2,SKU015,780,47,827
2025-02-08,7,3,SKU035,457,51,508
2025-02-08,8,1,SKU011,390,9,399
2025-02-08,8,2,SKU005,619,63,682
2025-02-08,8,3,SKU040,230,29,259
2025-02-08,9,1,SKU025,260,21,281
2025-02-08,9,3,SKU001,791,12,803
2025-02-08,10,1,SKU026,623,26,649
2025-02-08,10,2,SKU036,648,30,678
2025-02-08,10,3,SKU026,322,37,359
2025-02-08,11,2,SKU026,406,23,429
2025-02-08,11,3,SKU040,248,34,282
2025-02-08,12,2,SKU024,673,72,745
2025-02-08,13,1,SKU006,751,2,753
2025-02-08,13,2,SKU030,489,14,503
2025-02-08,13,3,SKU035,260,14,274
2025-02-08,14,1,SKU036,284,3,287
2025-02-08,14,2,SKU033,327,27,354
2025-02-08,14,3,SKU031,765,107,872
2025-02-08,15,1,SKU024,260,13,273
2025-02-08,15,2,SKU015,341,46,387
2025-02-08,15,3,SKU024,312,5,317
2025-02-09,1,1,SKU012,389,8,397
2025-02-09,1,2,SKU017,349,37,386
2025-02-09,2,2,SKU021,690,58,748
2025-02-09,2,3,SKU034,291,3,294
2025-02-09,3,1,SKU022,726,39,765
2025-02-09,3,2,SKU021,688,46,734
2025-02-09,3,3,SKU010,314,27,341
2025-02-09,4,1,SKU006,757,80,837
2025-02-09,4,2,SKU014,770,79,849
2025-02-09,4,3,SKU017,634,92,726
2025-02-09,5,1,SKU007,764,83,847
2025-02-09,5,2,SKU024,714,6,720
2025-02-09,5,3,SKU010,781,101,882
2025-02-09,6,1,SKU004,265,21,286
2025-02-09,6,2,SKU009,339,13,352
2025-02-09,6,3,SKU003,700,86,786
2025-02-09,7,1,SKU025,442,64,506
2025-02-09,7,2,SKU036,725,26,751
2025-02-09,7,3,SKU023,711,13,724
2025-02-09,8,1,SKU039,282,14,296
2025-02-09,8,2,SKU031,365,2,367
2025-02-09,9,1,SKU028,465,36,501
2025-02-09,9,2,SKU006,793,108,901
2025-02-09,9,3,SKU034,475,26,501
2025-02-09,10,1,SKU025,220,20,240
2025-02-09,10,2,SKU032,289,7,296
2025-02-09,10,3,SKU001,433,0,433
2025-02-09,11,1,SKU010,551,58,609
2025-02-09,11,3,SKU020,686,11,697
2025-02-09,12,1,SKU023,498,71,569
2025-02-09,12,2,SKU012,388,39,427
2025-02-09,12,3,SKU036,599,10,609
2025-02-09,13,1,SKU001,314,42,356
2025-02-09,13,3,SKU040,789,112,901
2025-02-09,14,1,SKU010,386,25,411
2025-02-09,14,2,SKU005,691,35,726
2025-02-09,14,3,SKU018,565,58,623
2025-02-09,15,1,SKU006,729,55,784
2025-02-09,15,2,SKU009,363,7,370
2025-02-09,15,3,SKU029,560,52,612
2025-02-10,1,1,SKU011,405,35,440
2025-02-10,1,2,SKU006,265,37,302
2025-02-10,1,3,SKU017,238,0,238
2025-02-10,2,1,SKU020,371,25,396
2025-02-10,2,2,SKU036,228,21,249
2025-02-10,2,3,SKU003,450,58,508
2025-02-10,3,1,SKU021,250,9,259
2025-02-10,3,2,SKU009,743,56,799
2025-02-10,3,3,SKU002,727,78,805
2025-02-10,4,1,SKU003,507,40,547
2025-02-10,4,2,SKU012,781,93,874
2025-02-10,4,3,SKU035,377,17,394
2025-02-10,5,1,SKU031,347,49,396
2025-02-10,5,2,SKU019,516,14,530
2025-02-10,5,3,SKU022,258,29,287
2025-02-10,6,1,SKU012,527,32,559
2025-02-10,6,2,SKU032,665,54,719
2025-02-10,6,3,SKU016,442,27,469
2025-02-10,7,1,SKU022,635,66,701
2025-02-10,7,3,SKU038,799,58,857
2025-02-10,8,1,SKU027,527,11,538
2025-02-10,8,2,SKU012,360,38,398
2025-02-10,8,3,SKU005,366,37,403
2025-02-10,9,1,SKU004,429,20,449
2025-02-10,9,2,SKU019,402,55,457
2025-02-10,9,3,SKU030,392,38,430
2025-02-10,10,1,SKU023,739,93,832
2025-02-10,10,2,SKU027,422,37,459
2025-02-10,10,3,SKU003,474,41,515
2025-02-10,11,1,SKU020,227,11,238
2025-02-10,11,2,SKU024,777,98,875
2025-02-10,11,3,SKU024,632,20,652
2025-02-10,12,1,SKU036,656,32,688
2025-02-10,12,2,SKU015,355,7,362
2025-02-10,12,3,SKU009,650,10,660
2025-02-10,13,1,SKU033,334,10,344
2025-02-10,13,2,SKU027,569,3,572
2025-02-10,13,3,SKU025,320,26,346
2025-02-10,14,1,SKU028,352,28,380
2025-02-10,14,2,SKU005,489,59,548
2025-02-10,14,3,SKU035,228,17,245
2025-02-10,15,1,SKU024,242,3,245
2025-02-10,15,2,SKU001,314,15,329
2025-02-10,15,3,SKU016,447,47,494
2025-02-11,1,1,SKU034,648,46,694
2025-02-11,1,2,SKU003,676,35,711
2025-02-11,1,3,SKU002,683,48,731
2025-02-11,2,1,SKU004,284,39,323
2025-02-11,2,2,SKU022,545,59,604
2025-02-11,2,3,SKU016,464,12,476
2025-02-11,3,1,SKU012,401,21,422
2025-02-11,3,3,SKU032,768,94,862
2025-02-11,4,1,SKU002,205,6,211
2025-02-11,4,2,SKU023,714,101,815
2025-02-11,5,1,SKU034,607,1,608
2025-02-11,5,2,SKU006,739,11,750
2025-02-11,5,3,SKU005,444,0,444
2025-02-11,6,1,SKU017,495,68,563
2025-02-11,6,3,SKU037,593,43,636
2025-02-11,7,1,SKU015,463,49,512
2025-02-11,7,2,SKU003,692,42,734
2025-02-11,7,3,SKU038,484,55,539
2025-02-11,8,1,SKU036,219,30,249
2025-02-11,8,2,SKU003,326,10,336
2025-02-11,8,3,SKU039,547,35,582
2025-02-11,9,1,SKU031,728,88,816
2025-02-11,9,2,SKU006,205,8,213
2025-02-11,9,3,SKU025,706,90,796
2025-02-11,10,1,SKU020,351,46,397
2025-02-11,10,2,SKU024,365,53,418
2025-02-11,10,3,SKU022,431,19,450
2025-02-11,11,1,SKU024,414,35,449
2025-02-11,11,2,SKU030,593,87,680
2025-02-11,11,3,SKU034,363,6,369
2025-02-11,12,1,SKU005,749,41,790
2025-02-11,12,2,SKU024,737,105,842
2025-02-11,12,3,SKU010,427,19,446
2025-02-11,13,1,SKU014,276,7,283
2025-02-11,13,2,SKU036,433,44,477
2025-02-11,13,3,SKU025,618,50,668
2025-02-11,14,1,SKU010,591,59,650
2025-02-11,14,2,SKU004,516,29,545
2025-02-11,14,3,SKU034,589,41,630
2025-02-11,15,1,SKU033,285,18,303
2025-02-11,15,2,SKU020,524,50,574
2025-02-12,1,1,SKU038,401,43,444
2025-02-12,1,2,SKU020,289,36,325
2025-02-12,1,3,SKU016,501,21,522
2025-02-12,2,2,SKU006,791,47,838
2025-02-12,3,1,SKU030,748,96,844
2025-02-12,3,2,SKU010,554,42,596
2025-02-12,3,3,SKU002,441,4,445
2025-02-12,4,1,SKU034,598,72,670
2025-02-12,4,2,SKU011,370,15,385
2025-02-12,4,3,SKU005,476,33,509
2025-02-12,5,1,SKU007,343,25,368
2025-02-12,5,3,SKU030,548,26,574
2025-02-12,7,1,SKU023,537,37,574
2025-02-12,7,2,SKU004,361,31,392
2025-02-12,7,3,SKU017,453,64,517
2025-02-12,8,1,SKU015,426,4,430
2025-02-12,8,2,SKU001,201,26,227
2025-02-12,9,2,SKU040,247,0,247
2025-02-12,9,3,SKU036,391,20,411
2025-02-12,10,1,SKU008,336,45,381
2025-02-12,10,3,SKU004,351,15,366
2025-02-12,11,1,SKU035,415,20,435
2025-02-12,11,2,SKU019,281,24,305
2025-02-12,11,3,SKU017,326,3,329
2025-02-12,12,1,SKU032,412,47,459
2025-02-12,12,2,SKU036,568,55,623
2025-02-12,12,3,SKU016,587,43,630
2025-02-12,13,1,SKU033,569,71,640
2025-02-12,13,2,SKU038,365,24,389
2025-02-12,13,3,SKU005,760,13,773
2025-02-12,14,1,SKU001,228,20,248
2025-02-12,14,2,SKU008,556,63,619
2025-02-12,15,1,SKU031,227,10,237
2025-02-12,15,2,SKU033,596,68,664
2025-02-12,15,3,SKU017,220,13,233
2025-02-13,1,1,SKU024,360,30,390
2025-02-13,1,2,SKU001,558,28,586
2025-02-13,1,3,SKU006,313,16,329
2025-02-13,2,1,SKU030,349,49,398
2025-02-13,2,2,SKU008,658,40,698
2025-02-13,2,3,SKU002,756,70,826
2025-02-13,3,1,SKU038,464,33,497
2025-02-13,3,2,SKU035,401,27,428
2025-02-13,3,3,SKU002,520,2,522
2025-02-13,4,1,SKU004,589,87,676
2025-02-13,4,3,SKU004,206,8,214
2025-02-13,5,1,SKU016,771,26,797
2025-02-13,5,2,SKU005,461,32,493
2025-02-13,5,3,SKU004,372,26,398
2025-02-13,6,1,SKU004,253,7,260
2025-02-13,6,2,SKU009,756,19,775
2025-02-13,6,3,SKU014,282,39,321
2025-02-13,7,1,SKU009,542,18,560
2025-02-13,7,2,SKU009,421,23,444
2025-02-13,7,3,SKU002,438,34,472
2025-02-13,8,2,SKU004,712,101,813
2025-02-13,8,3,SKU016,368,43,411
2025-02-13,9,1,SKU006,666,32,698
2025-02-13,9,2,SKU017,358,17,375
2025-02-13,10,1,SKU012,625,76,701
2025-02-13,10,2,SKU002,313,15,328
2025-02-13,10,3,SKU039,371,3,374
2025-02-13,11,1,SKU027,373,54,427
2025-02-13,11,2,SKU008,731,66,797
2025-02-13,11,3,SKU009,523,25,548
2025-02-13,12,1,SKU019,776,7,783
2025-02-13,12,2,SKU011,539,26,565
2025-02-13,12,3,SKU002,671,96,767
2025-02-13,13,1,SKU028,664,34,698
2025-02-13,13,3,SKU010,353,0,353
2025-02-13,14,1,SKU005,475,16,491
2025-02-13,14,3,SKU002,466,39,505
2025-02-13,15,1,SKU018,450,0,450
2025-02-13,15,2,SKU036,405,25,430
2025-02-13,15,3,SKU035,286,9,295
2025-02-14,1,1,SKU013,445,5,450
2025-02-14,1,3,SKU008,524,40,564
2025-02-14,2,1,SKU003,598,57,655
2025-02-14,2,2,SKU001,785,10,795
2025-02-14,2,3,SKU007,503,55,558
2025-02-14,3,1,SKU025,726,5,731
2025-02-14,3,2,SKU010,667,69,736
2025-02-14,4,2,SKU015,518,27,545
2025-02-14,4,3,SKU017,643,21,664
2025-02-14,5,1,SKU025,627,24,651
2025-02-14,5,2,SKU007,222,11,233
2025-02-14,6,1,SKU037,569,65,634
2025-02-14,6,2,SKU038,394,55,449
2025-02-14,6,3,SKU017,207,23,230
2025-02-14,7,1,SKU005,462,26,488
2025-02-14,7,2,SKU034,519,59,578
2025-02-14,7,3,SKU028,501,44,545
2025-02-14,8,1,SKU003,426,29,455
2025-02-14,8,2,SKU020,259,35,294
2025-02-14,8,3,SKU027,240,32,272
2025-02-14,9,1,SKU034,227,32,259
2025-02-14,9,2,SKU022,420,13,433
2025-02-14,9,3,SKU035,705,74,779
2025-02-14,10,2,SKU030,768,113,881
2025-02-14,10,3,SKU016,391,37,428
2025-02-14,11,1,SKU004,624,45,669
2025-02-14,11,2,SKU022,550,67,617
2025-02-14,11,3,SKU012,748,37,785
2025-02-14,12,2,SKU032,672,1,673
2025-02-14,12,3,SKU034,399,9,408
2025-02-14,13,1,SKU035,664,73,737
2025-02-14,13,2,SKU027,577,78,655
2025-02-14,14,1,SKU037,363,26,389
2025-02-14,14,2,SKU018,406,37,443
2025-02-14,15,2,SKU020,711,72,783
2025-02-15,1,1,SKU016,709,28,737
2025-02-15,1,3,SKU032,260,35,295
2025-02-15,2,2,SKU018,579,16,595
2025-02-15,2,3,SKU004,431,45,476
2025-02-15,3,1,SKU002,714,103,817
2025-02-15,3,2,SKU012,687,84,771
2025-02-15,3,3,SKU019,339,39,378
2025-02-15,4,1,SKU010,580,38,618
2025-02-15,4,2,SKU022,600,9,609
2025-02-15,4,3,SKU034,376,49,425
2025-02-15,5,1,SKU026,413,22,435
2025-02-15,5,2,SKU026,573,66,639
2025-02-15,5,3,SKU014,382,54,436
2025-02-15,6,1,SKU005,793,81,874
2025-02-15,6,2,SKU027,234,16,250
2025-02-15,6,3,SKU001,780,32,812
2025-02-15,7,1,SKU011,230,23,253
2025-02-15,7,2,SKU007,239,3,242
2025-02-15,7,3,SKU004,462,30,492
2025-02-15,8,2,SKU034,259,4,263
2025-02-15,8,3,SKU030,604,68,672
2025-02-15,9,1,SKU017,734,81,815
2025-02-15,9,2,SKU035,715,0,715
2025-02-15,9,3,SKU004,774,3,777
2025-02-15,10,1,SKU006,568,41,609
2025-02-15,10,2,SKU011,761,52,813
2025-02-15,10,3,SKU037,316,39,355
2025-02-15,11,2,SKU016,334,35,369
2025-02-15,11,3,SKU010,443,34,477
2025-02-15,12,1,SKU006,623,71,694
2025-02-15,12,2,SKU030,371,7,378
2025-02-15,13,1,SKU040,359,23,382
2025-02-15,13,2,SKU029,299,31,330
2025-02-15,13,3,SKU018,513,61,574
2025-02-15,14,1,SKU035,794,41,835
2025-02-15,14,2,SKU010,453,5,458
2025-02-15,15,1,SKU033,240,35,275
2025-02-15,15,2,SKU022,305,27,332
2025-02-15,15,3,SKU011,773,24,797
2025-02-16,1,1,SKU009,571,22,593
2025-02-16,1,2,SKU008,456,6,462
2025-02-16,1,3,SKU022,627,58,685
2025-02-16,2,1,SKU032,235,29,264
2025-02-16,2,2,SKU039,279,14,293
2025-02-16,2,3,SKU014,587,35,622
2025-02-16,3,1,SKU040,787,37,824
2025-02-16,3,2,SKU027,216,15,231
2025-02-16,3,3,SKU004,558,26,584
2025-02-16,4,2,SKU014,529,11,540
2025-02-16,4,3,SKU009,657,82,739
2025-02-16,5,1,SKU020,281,7,288
2025-02-16,5,2,SKU033,791,23,814
2025-02-16,6,1,SKU024,698,50,748
2025-02-16,6,2,SKU013,545,25,570
2025-02-16,6,3,SKU020,759,48,807
2025-02-16,7,1,SKU037,782,84,866
2025-02-16,7,2,SKU010,379,22,401
2025-02-16,7,3,SKU003,246,26,272
2025-02-16,8,1,SKU016,664,72,736
2025-02-16,8,2,SKU016,679,0,679
2025-02-16,8,3,SKU001,759,104,863
2025-02-16,9,1,SKU018,529,72,601
2025-02-16,9,3,SKU010,555,77,632
2025-02-16,10,1,SKU010,292,17,309
2025-02-16,10,2,SKU022,334,32,366
2025-02-16,10,3,SKU038,792,93,885
2025-02-16,11,2,SKU033,719,78,797
2025-02-16,11,3,SKU026,596,22,618
2025-02-16,12,1,SKU023,341,3,344
2025-02-16,12,2,SKU018,519,56,575
2025-02-16,12,3,SKU012,408,1,409
2025-02-16,13,1,SKU014,302,43,345
2025-02-16,13,2,SKU040,447,27,474
2025-02-16,14,1,SKU012,507,67,574
2025-02-16,14,2,SKU017,399,11,410
2025-02-16,14,3,SKU028,326,30,356
2025-02-16,15,1,SKU017,749,47,796
2025-02-16,15,2,SKU019,591,50,641
2025-02-16,15,3,SKU030,780,79,859
2025-02-17,1,3,SKU008,347,31,378
2025-02-17,2,1,SKU032,757,5,762
2025-02-17,2,2,SKU018,446,51,497
2025-02-17,3,1,SKU023,591,24,615
2025-02-17,3,2,SKU004,651,10,661
2025-02-17,3,3,SKU023,413,20,433
2025-02-17,4,1,SKU037,673,17,690
2025-02-17,4,2,SKU022,451,55,506
2025-02-17,4,3,SKU009,381,13,394
2025-02-17,5,2,SKU033,715,78,793
2025-02-17,6,1,SKU020,645,88,733
2025-02-17,6,2,SKU036,468,2,470
2025-02-17,6,3,SKU026,461,46,507
2025-02-17,7,1,SKU005,360,50,410
2025-02-17,7,2,SKU001,492,43,535
2025-02-17,7,3,SKU009,497,30,527
2025-02-17,8,1,SKU038,574,78,652
2025-02-17,8,2,SKU039,616,27,643
2025-02-17,8,3,SKU038,433,49,482
2025-02-17,9,1,SKU021,235,16,251
2025-02-17,9,2,SKU018,538,22,560
2025-02-17,10,1,SKU007,360,5,365
2025-02-17,10,2,SKU014,596,26,622
2025-02-17,10,3,SKU031,325,13,338
2025-02-17,11,1,SKU011,563,31,594
2025-02-17,11,2,SKU038,465,15,480
2025-02-17,11,3,SKU014,561,19,580
2025-02-17,12,2,SKU026,388,37,425
2025-02-17,13,1,SKU009,389,40,429
2025-02-17,13,2,SKU026,344,32,376
2025-02-17,13,3,SKU030,714,71,785
2025-02-17,14,1,SKU036,597,67,664
2025-02-17,14,2,SKU010,653,65,718
2025-02-17,15,1,SKU027,301,21,322
2025-02-17,15,2,SKU005,214,28,242
2025-02-17,15,3,SKU024,406,26,432
2025-02-18,1,2,SKU007,675,6,681
2025-02-18,1,3,SKU001,799,61,860
2025-02-18,2,1,SKU031,571,34,605
2025-02-18,2,2,SKU023,739,39,778
2025-02-18,2,3,SKU031,593,39,632
2025-02-18,3,1,SKU027,525,69,594
2025-02-18,4,1,SKU027,768,65,833
2025-02-18,4,2,SKU033,295,18,313
2025-02-18,4,3,SKU007,212,23,235
2025-02-18,5,3,SKU008,400,52,452
2025-02-18,6,1,SKU008,204,28,232
2025-02-18,6,2,SKU017,462,6,468
2025-02-18,6,3,SKU007,461,61,522
2025-02-18,7,1,SKU032,375,11,386
2025-02-18,7,2,SKU016,614,84,698
2025-02-18,7,3,SKU034,451,50,501
2025-02-18,8,1,SKU003,794,28,822
2025-02-18,8,2,SKU011,605,42,647
2025-02-18,8,3,SKU020,328,12,340
2025-02-18,9,1,SKU029,492,24,516
2025-02-18,9,2,SKU003,724,107,831
2025-02-18,9,3,SKU028,798,12,810
2025-02-18,10,1,SKU004,782,114,896
2025-02-18,10,3,SKU024,632,54,686
2025-02-18,11,1,SKU025,239,27,266
2025-02-18,11,2,SKU015,335,45,380
2025-02-18,11,3,SKU020,329,30,359
2025-02-18,12,1,SKU010,642,56,698
2025-02-18,12,2,SKU006,778,3,781
2025-02-18,12,3,SKU011,460,21,481
2025-02-18,13,2,SKU034,720,40,760
2025-02-18,13,3,SKU022,527,1,528
2025-02-18,14,1,SKU037,353,15,368
2025-02-18,14,2,SKU019,397,1,398
2025-02-18,14,3,SKU023,357,29,386
2025-02-18,15,1,SKU022,587,80,667
2025-02-18,15,2,SKU023,746,81,827
2025-02-18,15,3,SKU020,650,57,707
2025-02-19,1,1,SKU025,577,34,611
2025-02-19,1,2,SKU007,753,53,806
2025-02-19,2,1,SKU034,775,102,877
2025-02-19,2,3,SKU039,740,54,794
2025-02-19,3,1,SKU033,574,11,585
2025-02-19,3,2,SKU007,519,7,526
2025-02-19,3,3,SKU027,393,50,443
2025-02-19,4,1,SKU029,261,38,299
2025-02-19,4,3,SKU014,542,1,543
2025-02-19,5,1,SKU005,275,20,295
2025-02-19,5,3,SKU021,546,66,612
2025-02-19,6,1,SKU002,787,58,845
2025-02-19,6,2,SKU035,326,30,356
2025-02-19,7,1,SKU014,622,22,644
2025-02-19,7,2,SKU011,439,21,460
2025-02-19,7,3,SKU005,777,113,890
2025-02-19,8,1,SKU010,678,49,727
2025-02-19,8,2,SKU017,781,108,889
2025-02-19,9,1,SKU025,264,25,289
2025-02-19,9,2,SKU034,722,61,783
2025-02-19,9,3,SKU024,352,44,396
2025-02-19,10,1,SKU028,491,68,559
2025-02-19,10,3,SKU004,738,95,833
2025-02-19,11,1,SKU039,607,86,693
2025-02-19,11,2,SKU016,419,38,457
2025-02-19,11,3,SKU009,753,69,822
2025-02-19,12,2,SKU007,717,1,718
2025-02-19,12,3,SKU023,370,47,417
2025-02-19,13,1,SKU031,257,14,271
2025-02-19,13,2,SKU009,761,84,845
2025-02-19,13,3,SKU026,442,56,498
2025-02-19,14,1,SKU038,797,20,817
2025-02-19,14,2,SKU008,261,32,293
2025-02-19,14,3,SKU031,401,22,423
2025-02-19,15,1,SKU021,738,46,784
2025-02-19,15,2,SKU033,251,1,252
2025-02-19,15,3,SKU025,324,7,331
2025-02-20,1,1,SKU039,446,24,470
2025-02-20,1,3,SKU002,300,4,304
2025-02-20,2,1,SKU036,353,8,361
2025-02-20,2,2,SKU002,377,9,386
2025-02-20,2,3,SKU026,604,8,612
2025-02-20,3,1,SKU007,451,11,462
2025-02-20,3,2,SKU015,299,19,318
2025-02-20,4,1,SKU024,611,42,653
2025-02-20,4,2,SKU023,674,64,738
2025-02-20,4,3,SKU026,225,12,237
2025-02-20,5,1,SKU025,513,32,545
2025-02-20,5,2,SKU030,787,7,794
2025-02-20,5,3,SKU018,221,5,226
2025-02-20,6,1,SKU018,397,48,445
2025-02-20,6,2,SKU006,602,15,617
2025-02-20,6,3,SKU014,694,34,728
2025-02-20,7,1,SKU019,249,22,271
2025-02-20,7,2,SKU034,511,18,529
2025-02-20,7,3,SKU013,238,4,242
2025-02-20,8,3,SKU038,558,69,627
2025-02-20,9,1,SKU039,373,44,417
2025-02-20,9,2,SKU028,241,0,241
2025-02-20,10,1,SKU027,676,5,681
2025-02-20,10,2,SKU018,519,36,555
2025-02-20,10,3,SKU025,248,27,275
2025-02-20,11,1,SKU001,703,27,730
2025-02-20,11,2,SKU035,777,13,790
2025-02-20,11,3,SKU034,741,27,768
2025-02-20,12,1,SKU030,618,12,630
2025-02-20,12,2,SKU022,471,14,485
2025-02-20,12,3,SKU039,365,30,395
2025-02-20,13,1,SKU036,402,40,442
2025-02-20,13,3,SKU024,296,17,313
2025-02-20,14,2,SKU013,364,11,375
2025-02-20,14,3,SKU031,712,104,816
2025-02-20,15,1,SKU033,657,68,725
2025-02-20,15,2,SKU031,236,15,251
2025-02-20,15,3,SKU026,553,65,618
2025-02-21,1,1,SKU024,214,14,228
2025-02-21,1,2,SKU040,679,58,737
2025-02-21,1,3,SKU024,788,91,879
2025-02-21,2,1,SKU001,750,94,844
2025-02-21,2,2,SKU025,204,13,217
2025-02-21,2,3,SKU002,557,62,619
2025-02-21,3,1,SKU024,737,15,752
2025-02-21,3,2,SKU026,502,15,517
2025-02-21,3,3,SKU035,787,75,862
2025-02-21,4,1,SKU039,603,71,674
2025-02-21,4,2,SKU008,366,1,367
2025-02-21,4,3,SKU008,314,45,359
2025-02-21,5,2,SKU024,239,19,258
2025-02-21,5,3,SKU013,242,35,277
2025-02-21,6,1,SKU017,708,5,713
2025-02-21,6,3,SKU010,738,91,829
2025-02-21,7,1,SKU012,659,57,716
2025-02-21,7,2,SKU003,625,33,658
2025-02-21,8,2,SKU033,559,23,582
2025-02-21,9,1,SKU002,614,56,670
2025-02-21,9,2,SKU016,341,45,386
2025-02-21,9,3,SKU025,366,40,406
2025-02-21,10,1,SKU002,636,36,672
2025-02-21,10,2,SKU037,701,17,718
2025-02-21,11,1,SKU004,338,15,353
2025-02-21,11,2,SKU035,723,36,759
2025-02-21,11,3,SKU016,588,58,646
2025-02-21,12,1,SKU005,445,53,498
2025-02-21,12,2,SKU030,244,6,250
2025-02-21,12,3,SKU021,310,14,324
2025-02-21,13,1,SKU024,450,27,477
2025-02-21,13,2,SKU038,292,9,301
2025-02-21,13,3,SKU032,600,77,677
2025-02-21,14,1,SKU012,498,13,511
2025-02-21,14,2,SKU007,416,3,419
2025-02-21,15,1,SKU012,612,44,656
2025-02-21,15,3,SKU036,771,42,813
2025-02-22,1,1,SKU033,492,50,542
2025-02-22,1,2,SKU018,654,43,697
2025-02-22,1,3,SKU035,459,24,483
2025-02-22,2,1,SKU002,753,72,825
2025-02-22,2,2,SKU037,435,26,461
2025-02-22,2,3,SKU009,785,104,889
2025-02-22,3,2,SKU027,682,52,734
2025-02-22,3,3,SKU032,732,9,741
2025-02-22,4,1,SKU034,568,43,611
2025-02-22,4,3,SKU031,681,82,763
2025-02-22,5,1,SKU021,336,3,339
2025-02-22,5,2,SKU023,254,35,289
2025-02-22,5,3,SKU018,691,98,789
2025-02-22,6,2,SKU034,700,56,756
2025-02-22,6,3,SKU021,528,29,557
2025-02-22,7,1,SKU039,202,7,209
2025-02-22,7,2,SKU019,626,23,649
2025-02-22,7,3,SKU023,451,66,517
2025-02-22,8,1,SKU020,425,46,471
2025-02-22,8,2,SKU035,776,84,860
2025-02-22,8,3,SKU027,611,52,663
2025-02-22,9,1,SKU010,341,38,379
2025-02-22,9,2,SKU014,461,37,498
2025-02-22,9,3,SKU021,525,18,543
2025-02-22,10,1,SKU017,796,32,828
2025-02-22,10,3,SKU010,238,3,241
2025-02-22,11,1,SKU024,423,8,431
2025-02-22,11,2,SKU032,328,46,374
2025-02-22,11,3,SKU022,728,26,754
2025-02-22,12,1,SKU039,283,12,295
2025-02-22,12,2,SKU025,514,40,554
2025-02-22,12,3,SKU006,659,51,710
2025-02-22,13,1,SKU027,531,34,565
2025-02-22,13,2,SKU017,509,13,522
2025-02-22,13,3,SKU007,279,39,318
2025-02-22,14,2,SKU006,696,43,739
2025-02-22,14,3,SKU003,259,37,296
2025-02-22,15,2,SKU028,621,36,657
2025-02-22,15,3,SKU016,621,29,650
2025-02-23,1,1,SKU027,286,25,311
2025-02-23,1,2,SKU026,437,58,495
2025-02-23,1,3,SKU025,682,52,734
2025-02-23,2,1,SKU038,704,12,716
2025-02-23,2,2,SKU038,252,20,272
2025-02-23,2,3,SKU014,674,14,688
2025-02-23,3,1,SKU003,226,14,240
2025-02-23,3,2,SKU028,740,88,828
2025-02-23,3,3,SKU014,314,9,323
2025-02-23,4,1,SKU028,344,26,370
2025-02-23,4,2,SKU027,362,15,377
2025-02-23,4,3,SKU017,614,79,693
2025-02-23,5,1,SKU011,540,30,570
2025-02-23,5,2,SKU035,650,95,745
2025-02-23,5,3,SKU016,739,2,741
2025-02-23,6,1,SKU032,611,71,682
2025-02-23,6,3,SKU016,589,43,632
2025-02-23,7,1,SKU001,556,5,561
2025-02-23,7,2,SKU017,216,22,238
2025-02-23,8,1,SKU017,267,38,305
2025-02-23,8,2,SKU013,309,21,330
2025-02-23,8,3,SKU038,414,36,450
2025-02-23,9,3,SKU013,327,14,341
2025-02-23,10,1,SKU021,264,12,276
2025-02-23,10,2,SKU034,321,9,330
2025-02-23,10,3,SKU002,498,0,498
2025-02-23,11,1,SKU032,420,12,432
2025-02-23,11,2,SKU027,462,33,495
2025-02-23,11,3,SKU025,543,1,544
2025-02-23,12,1,SKU036,613,79,692
2025-02-23,12,3,SKU029,397,58,455
2025-02-23,13,1,SKU020,354,38,392
2025-02-23,13,2,SKU011,691,10,701
2025-02-23,13,3,SKU004,746,71,817
2025-02-23,14,1,SKU021,244,12,256
2025-02-23,14,2,SKU002,321,16,337
2025-02-23,14,3,SKU034,258,21,279
2025-02-23,15,1,SKU009,606,13,619
2025-02-23,15,2,SKU032,421,9,430
2025-02-23,15,3,SKU030,745,67,812
2025-02-24,1,1,SKU026,312,29,341
2025-02-24,1,2,SKU002,255,35,290
2025-02-24,1,3,SKU030,541,80,621
2025-02-24,2,1,SKU025,207,25,232
2025-02-24,2,2,SKU002,681,68,749
2025-02-24,2,3,SKU026,508,21,529
2025-02-24,3,1,SKU031,528,15,543
2025-02-24,3,2,SKU039,718,17,735
2025-02-24,3,3,SKU024,369,47,416
2025-02-24,4,1,SKU007,746,81,827
2025-02-24,4,2,SKU010,539,8,547
2025-02-24,5,1,SKU013,618,12,630
2025-02-24,5,2,SKU030,373,19,392
2025-02-24,5,3,SKU019,688,50,738
2025-02-24,6,1,SKU015,392,17,409
2025-02-24,6,3,SKU007,361,15,376
2025-02-24,7,1,SKU035,270,27,297
2025-02-24,7,2,SKU010,600,52,652
2025-02-24,7,3,SKU030,421,41,462
2025-02-24,8,1,SKU028,472,18,490
2025-02-24,8,2,SKU007,575,70,645
2025-02-24,8,3,SKU017,227,0,227
2025-02-24,9,1,SKU019,409,12,421
2025-02-24,9,3,SKU009,413,48,461
2025-02-24,10,3,SKU024,293,39,332
2025-02-24,11,1,SKU004,317,42,359
2025-02-24,11,2,SKU032,292,41,333
2025-02-24,11,3,SKU005,252,23,275
2025-02-24,12,1,SKU008,552,38,590
2025-02-24,12,2,SKU008,523,7,530
2025-02-24,13,1,SKU007,570,32,602
2025-02-24,13,2,SKU009,252,23,275
2025-02-24,13,3,SKU040,744,52,796
2025-02-24,14,1,SKU010,683,41,724
2025-02-24,14,2,SKU008,691,13,704
2025-02-24,14,3,SKU015,687,51,738
2025-02-24,15,1,SKU009,411,5,416
2025-02-24,15,2,SKU001,299,5,304
2025-02-25,1,1,SKU023,353,11,364
2025-02-25,1,3,SKU022,652,46,698
2025-02-25,2,1,SKU014,267,25,292
2025-02-25,3,1,SKU012,671,92,763
2025-02-25,3,2,SKU040,631,36,667
2025-02-25,3,3,SKU002,470,28,498
2025-02-25,4,1,SKU039,764,10,774
2025-02-25,4,2,SKU015,390,6,396
2025-02-25,4,3,SKU008,277,0,277
2025-02-25,5,1,SKU003,268,39,307
2025-02-25,5,2,SKU012,288,30,318
2025-02-25,5,3,SKU027,265,21,286
2025-02-25,6,2,SKU014,520,23,543
2025-02-25,6,3,SKU040,271,18,289
2025-02-25,7,3,SKU016,419,60,479
2025-02-25,8,1,SKU017,330,11,341
2025-02-25,8,2,SKU018,493,48,541
2025-02-25,8,3,SKU035,242,20,262
2025-02-25,9,1,SKU023,498,2,500
2025-02-25,9,2,SKU027,335,17,352
2025-02-25,9,3,SKU034,242,7,249
2025-02-25,10,2,SKU040,450,31,481
2025-02-25,10,3,SKU036,441,3,444
2025-02-25,11,1,SKU019,311,36,347
2025-02-25,11,3,SKU010,711,69,780
2025-02-25,12,3,SKU012,675,97,772
2025-02-25,13,1,SKU019,616,3,619
2025-02-25,13,2,SKU019,317,5,322
2025-02-25,13,3,SKU023,308,44,352
2025-02-25,14,1,SKU028,538,60,598
2025-02-25,14,3,SKU021,223,3,226
2025-02-25,15,1,SKU030,312,39,351
2025-02-25,15,2,SKU017,368,0,368
2025-02-25,15,3,SKU037,397,53,450
2025-02-26,1,1,SKU005,604,54,658
2025-02-26,1,2,SKU038,427,5,432
2025-02-26,1,3,SKU005,201,25,226
2025-02-26,2,1,SKU005,701,40,741
2025-02-26,2,2,SKU025,716,93,809
2025-02-26,2,3,SKU017,263,35,298
2025-02-26,3,3,SKU031,554,20,574
2025-02-26,4,1,SKU026,702,19,721
2025-02-26,4,3,SKU004,222,5,227
2025-02-26,5,1,SKU014,649,19,668
2025-02-26,5,2,SKU032,325,10,335
2025-02-26,5,3,SKU018,491,9,500
2025-02-26,6,2,SKU020,650,43,693
2025-02-26,6,3,SKU036,571,0,571
2025-02-26,7,1,SKU038,341,36,377
2025-02-26,7,2,SKU035,552,59,611
2025-02-26,7,3,SKU027,362,32,394
2025-02-26,8,2,SKU008,628,62,690
2025-02-26,8,3,SKU014,385,21,406
2025-02-26,9,1,SKU036,533,59,592
2025-02-26,9,2,SKU022,323,1,324
2025-02-26,9,3,SKU037,465,11,476
2025-02-26,10,1,SKU024,251,35,286
2025-02-26,10,2,SKU031,629,36,665
2025-02-26,10,3,SKU018,492,35,527
2025-02-26,11,1,SKU003,405,21,426
2025-02-26,11,2,SKU018,311,39,350
2025-02-26,11,3,SKU015,663,51,714
2025-02-26,12,1,SKU024,655,42,697
2025-02-26,12,2,SKU032,752,77,829
2025-02-26,12,3,SKU014,702,95,797
2025-02-26,13,1,SKU024,492,49,541
2025-02-26,13,2,SKU011,541,25,566
2025-02-26,13,3,SKU019,794,86,880
2025-02-26,14,1,SKU004,240,19,259
2025-02-26,14,3,SKU010,506,47,553
2025-02-26,15,1,SKU022,542,3,545
2025-02-26,15,2,SKU025,533,76,609
2025-02-26,15,3,SKU025,387,24,411
2025-02-27,1,1,SKU007,575,38,613
2025-02-27,1,3,SKU024,605,38,643
2025-02-27,2,1,SKU030,212,7,219
2025-02-27,2,2,SKU034,234,20,254
2025-02-27,2,3,SKU007,751,75,826
2025-02-27,3,1,SKU004,270,34,304
2025-02-27,3,2,SKU034,232,10,242
2025-02-27,3,3,SKU009,601,77,678
2025-02-27,4,1,SKU040,600,69,669
2025-02-27,4,2,SKU025,348,7,355
2025-02-27,4,3,SKU020,778,14,792
2025-02-27,5,1,SKU024,615,72,687
2025-02-27,5,2,SKU029,646,29,675
2025-02-27,5,3,SKU007,432,27,459
2025-02-27,6,2,SKU014,286,22,308
2025-02-27,6,3,SKU004,224,28,252
2025-02-27,7,1,SKU016,214,20,234
2025-02-27,7,3,SKU021,485,9,494
2025-02-27,8,1,SKU010,384,5,389
2025-02-27,8,2,SKU027,298,13,311
2025-02-27,8,3,SKU018,520,59,579
2025-02-27,9,1,SKU038,524,52,576
2025-02-27,9,2,SKU027,707,32,739
2025-02-27,9,3,SKU004,578,28,606
2025-02-27,10,1,SKU039,463,4,467
2025-02-27,10,2,SKU026,254,0,254
2025-02-27,10,3,SKU025,333,34,367
2025-02-27,11,1,SKU023,454,29,483
2025-02-27,11,2,SKU008,432,45,477
2025-02-27,11,3,SKU016,413,15,428
2025-02-27,12,1,SKU024,228,31,259
2025-02-27,12,3,SKU040,538,76,614
2025-02-27,13,1,SKU029,485,2,487
2025-02-27,13,2,SKU024,624,21,645
2025-02-27,13,3,SKU001,404,47,451
2025-02-27,14,1,SKU018,624,91,715
2025-02-27,14,2,SKU018,755,54,809
2025-02-27,14,3,SKU022,717,50,767
2025-02-27,15,1,SKU027,399,7,406
2025-02-27,15,2,SKU025,799,30,829
2025-02-27,15,3,SKU036,728,38,766
2025-02-28,1,1,SKU036,443,49,492
2025-02-28,1,2,SKU005,509,40,549
2025-02-28,1,3,SKU032,629,51,680
2025-02-28,2,1,SKU027,573,0,573
2025-02-28,2,2,SKU013,401,49,450
2025-02-28,2,3,SKU011,343,20,363
2025-02-28,3,1,SKU010,206,29,235
2025-02-28,3,3,SKU035,717,29,746
2025-02-28,4,1,SKU002,747,12,759
2025-02-28,4,2,SKU024,632,65,697
2025-02-28,5,1,SKU005,264,30,294
2025-02-28,5,3,SKU021,458,3,461
2025-02-28,6,1,SKU035,241,4,245
2025-02-28,6,2,SKU007,468,41,509
2025-02-28,6,3,SKU018,533,51,584
2025-02-28,7,1,SKU015,711,17,728
2025-02-28,7,2,SKU030,449,7,456
2025-02-28,7,3,SKU028,256,21,277
2025-02-28,8,1,SKU006,368,27,395
2025-02-28,8,2,SKU024,268,17,285
2025-02-28,8,3,SKU029,504,41,545
2025-02-28,9,1,SKU021,407,8,415
2025-02-28,9,2,SKU001,305,21,326
2025-02-28,9,3,SKU022,214,22,236
2025-02-28,10,1,SKU030,400,50,450
2025-02-28,10,2,SKU006,218,13,231
2025-02-28,10,3,SKU012,334,0,334
2025-02-28,11,1,SKU038,318,46,364
2025-02-28,11,2,SKU017,329,29,358
2025-02-28,12,1,SKU029,224,28,252
2025-02-28,12,2,SKU004,742,95,837
2025-02-28,12,3,SKU038,361,50,411
2025-02-28,13,1,SKU021,466,7,473
2025-02-28,13,2,SKU018,726,52,778
2025-02-28,13,3,SKU027,265,0,265
2025-02-28,14,1,SKU020,585,17,602
2025-02-28,14,2,SKU013,351,41,392
2025-02-28,14,3,SKU023,481,53,534
2025-02-28,15,3,SKU021,357,35,392
2025-03-01,1,1,SKU010,721,82,803
2025-03-01,1,2,SKU023,700,71,771
2025-03-01,2,1,SKU023,208,19,227
2025-03-01,2,2,SKU033,591,18,609
2025-03-01,3,1,SKU031,546,60,606
2025-03-01,3,2,SKU017,491,35,526
2025-03-01,4,2,SKU035,539,67,606
2025-03-01,5,1,SKU009,346,17,363
2025-03-01,5,2,SKU001,514,58,572
2025-03-01,5,3,SKU014,548,0,548
2025-03-01,6,1,SKU027,628,49,677
2025-03-01,6,2,SKU011,334,33,367
2025-03-01,6,3,SKU022,657,55,712
2025-03-01,7,1,SKU004,276,34,310
2025-03-01,7,2,SKU027,572,67,639
2025-03-01,7,3,SKU026,663,90,753
2025-03-01,8,2,SKU015,252,5,257
2025-03-01,8,3,SKU031,664,58,722
2025-03-01,9,1,SKU014,638,62,700
2025-03-01,9,2,SKU034,433,9,442
2025-03-01,9,3,SKU023,364,7,371
2025-03-01,10,2,SKU013,792,95,887
2025-03-01,10,3,SKU034,273,34,307
2025-03-01,11,1,SKU030,537,4,541
2025-03-01,11,2,SKU015,312,41,353
2025-03-01,11,3,SKU003,717,31,748
2025-03-01,12,1,SKU004,406,17,423
2025-03-01,12,2,SKU014,755,88,843
2025-03-01,12,3,SKU032,755,34,789
2025-03-01,13,1,SKU026,630,15,645
2025-03-01,13,3,SKU001,242,34,276
2025-03-01,14,1,SKU031,327,26,353
2025-03-01,14,2,SKU034,496,18,514
2025-03-01,14,3,SKU018,329,30,359
2025-03-01,15,1,SKU028,798,42,840
2025-03-01,15,3,SKU010,510,22,532
2025-03-02,1,1,SKU016,636,34,670
2025-03-02,1,2,SKU007,464,16,480
2025-03-02,1,3,SKU010,729,100,829
2025-03-02,2,1,SKU031,263,23,286
2025-03-02,2,2,SKU017,719,1,720
2025-03-02,3,2,SKU010,531,6,537
2025-03-02,3,3,SKU013,505,20,525
2025-03-02,4,1,SKU031,612,57,669
2025-03-02,4,2,SKU015,396,48,444
2025-03-02,4,3,SKU019,406,19,425
2025-03-02,5,1,SKU006,560,56,616
2025-03-02,5,2,SKU010,282,20,302
2025-03-02,6,1,SKU002,699,9,708
2025-03-02,6,2,SKU040,233,2,235
2025-03-02,6,3,SKU026,258,27,285
2025-03-02,7,1,SKU002,745,93,838
2025-03-02,7,3,SKU038,588,27,615
2025-03-02,8,2,SKU024,631,80,711
2025-03-02,8,3,SKU027,772,98,870
2025-03-02,9,1,SKU017,332,28,360
2025-03-02,9,2,SKU016,627,40,667
2025-03-02,10,1,SKU032,437,27,464
2025-03-02,10,2,SKU033,335,5,340
2025-03-02,10,3,SKU003,278,1,279
2025-03-02,11,1,SKU025,597,50,647
2025-03-02,11,2,SKU039,323,20,343
2025-03-02,12,1,SKU022,578,59,637
2025-03-02,12,2,SKU033,395,15,410
2025-03-02,12,3,SKU025,483,29,512
2025-03-02,13,1,SKU025,322,25,347
2025-03-02,13,2,SKU026,467,10,477
2025-03-02,14,1,SKU035,777,45,822
2025-03-02,14,2,SKU014,258,36,294
2025-03-02,14,3,SKU036,491,39,530
2025-03-02,15,1,SKU008,601,52,653
2025-03-02,15,2,SKU001,429,12,441
2025-03-02,15,3,SKU037,609,16,625
2025-03-03,1,1,SKU033,472,46,518
2025-03-03,1,2,SKU037,606,2,608
2025-03-03,1,3,SKU026,305,3,308
2025-03-03,2,1,SKU039,527,27,554
2025-03-03,2,3,SKU016,573,43,616
2025-03-03,3,2,SKU038,459,32,491
2025-03-03,3,3,SKU019,619,57,676
2025-03-03,4,1,SKU010,443,17,460
2025-03-03,4,2,SKU003,629,65,694
2025-03-03,4,3,SKU012,252,10,262
2025-03-03,5,1,SKU028,383,34,417
2025-03-03,5,2,SKU015,528,13,541
2025-03-03,5,3,SKU026,408,19,427
2025-03-03,6,1,SKU004,460,62,522
2025-03-03,6,2,SKU023,365,9,374
2025-03-03,6,3,SKU035,257,8,265
2025-03-03,7,1,SKU009,701,85,786
2025-03-03,7,3,SKU005,272,22,294
2025-03-03,8,1,SKU038,535,68,603
2025-03-03,8,2,SKU021,373,13,386
2025-03-03,9,1,SKU013,583,63,646
2025-03-03,9,3,SKU024,529,12,541
2025-03-03,10,2,SKU019,584,50,634
2025-03-03,10,3,SKU026,624,77,701
2025-03-03,11,1,SKU010,202,0,202
2025-03-03,11,2,SKU034,525,66,591
2025-03-03,11,3,SKU012,664,20,684
2025-03-03,12,1,SKU026,314,35,349
2025-03-03,12,2,SKU033,272,9,281
2025-03-03,12,3,SKU036,576,39,615
2025-03-03,13,2,SKU026,305,6,311
2025-03-03,13,3,SKU036,353,42,395
2025-03-03,14,1,SKU008,688,102,790
2025-03-03,14,2,SKU017,764,69,833
2025-03-03,14,3,SKU037,511,8,519
2025-03-03,15,1,SKU026,217,29,246
2025-03-03,15,2,SKU033,324,25,349
2025-03-03,15,3,SKU010,694,80,774
2025-03-04,1,1,SKU008,388,40,428
2025-03-04,1,2,SKU031,384,40,424
2025-03-04,1,3,SKU007,261,24,285
2025-03-04,2,1,SKU023,602,87,689
2025-03-04,2,2,SKU011,475,35,510
2025-03-04,2,3,SKU038,689,92,781
2025-03-04,3,1,SKU023,406,9,415
2025-03-04,3,2,SKU040,578,21,599
2025-03-04,3,3,SKU039,617,89,706
2025-03-04,4,1,SKU026,557,41,598
2025-03-04,4,2,SKU011,702,81,783
2025-03-04,4,3,SKU015,707,96,803
2025-03-04,5,1,SKU004,771,87,858
2025-03-04,5,2,SKU020,515,20,535
2025-03-04,5,3,SKU006,634,36,670
2025-03-04,6,2,SKU024,513,1,514
2025-03-04,7,1,SKU036,568,84,652
2025-03-04,7,2,SKU024,268,11,279
2025-03-04,7,3,SKU007,589,63,652
2025-03-04,8,1,SKU035,429,52,481
2025-03-04,8,2,SKU008,218,30,248
2025-03-04,8,3,SKU017,283,12,295
2025-03-04,9,1,SKU004,308,6,314
2025-03-04,9,2,SKU028,523,64,587
2025-03-04,10,1,SKU019,762,109,871
2025-03-04,10,2,SKU031,780,113,893
2025-03-04,10,3,SKU001,216,2,218
2025-03-04,11,1,SKU005,363,37,400
2025-03-04,11,2,SKU032,609,5,614
2025-03-04,11,3,SKU001,204,16,220
2025-03-04,12,1,SKU024,459,31,490
2025-03-04,12,2,SKU009,340,38,378
2025-03-04,12,3,SKU015,348,50,398
2025-03-04,13,1,SKU039,535,18,553
2025-03-04,13,2,SKU038,682,30,712
2025-03-04,13,3,SKU023,433,60,493
2025-03-04,14,1,SKU026,308,3,311
2025-03-04,14,2,SKU017,653,13,666
2025-03-04,14,3,SKU003,635,56,691
2025-03-04,15,2,SKU040,577,39,616
2025-03-04,15,3,SKU003,790,101,891
2025-03-05,1,2,SKU015,342,7,349
2025-03-05,1,3,SKU022,201,19,220
2025-03-05,2,1,SKU017,503,59,562
2025-03-05,2,2,SKU028,589,21,610
2025-03-05,2,3,SKU027,721,66,787
2025-03-05,3,1,SKU025,566,10,576
2025-03-05,3,3,SKU019,742,95,837
2025-03-05,4,1,SKU019,206,11,217
2025-03-05,4,2,SKU029,757,57,814
2025-03-05,4,3,SKU036,641,51,692
2025-03-05,5,1,SKU020,706,23,729
2025-03-05,5,2,SKU026,600,14,614
2025-03-05,5,3,SKU040,771,104,875
2025-03-05,6,1,SKU027,591,44,635
2025-03-05,6,2,SKU011,325,20,345
2025-03-05,6,3,SKU001,366,12,378
2025-03-05,7,1,SKU014,290,4,294
2025-03-05,7,3,SKU036,783,49,832
2025-03-05,8,1,SKU008,530,15,545
2025-03-05,8,2,SKU020,465,37,502
2025-03-05,8,3,SKU019,371,25,396
2025-03-05,9,1,SKU033,609,59,668
2025-03-05,9,2,SKU011,681,79,760
2025-03-05,9,3,SKU037,636,46,682
2025-03-05,10,2,SKU037,447,65,512
2025-03-05,10,3,SKU010,535,78,613
2025-03-05,11,1,SKU012,543,45,588
2025-03-05,11,2,SKU001,632,37,669
2025-03-05,11,3,SKU014,212,22,234
2025-03-05,12,1,SKU006,244,15,259
2025-03-05,12,2,SKU023,284,30,314
2025-03-05,12,3,SKU008,501,73,574
2025-03-05,13,1,SKU030,461,56,517
2025-03-05,14,1,SKU010,443,12,455
2025-03-05,14,2,SKU038,261,8,269
2025-03-05,14,3,SKU005,710,53,763
2025-03-05,15,1,SKU028,289,1,290
2025-03-06,1,1,SKU017,753,105,858
2025-03-06,1,2,SKU008,654,16,670
2025-03-06,1,3,SKU037,750,85,835
2025-03-06,2,1,SKU038,445,50,495
2025-03-06,2,2,SKU037,332,19,351
2025-03-06,2,3,SKU036,243,1,244
2025-03-06,3,1,SKU003,609,89,698
2025-03-06,3,2,SKU035,410,36,446
2025-03-06,3,3,SKU023,747,57,804
2025-03-06,4,2,SKU001,544,60,604
2025-03-06,4,3,SKU018,503,22,525
2025-03-06,5,1,SKU018,213,8,221
2025-03-06,5,2,SKU040,360,38,398
2025-03-06,5,3,SKU027,569,48,617
2025-03-06,6,1,SKU035,767,80,847
2025-03-06,6,2,SKU035,734,61,795
2025-03-06,7,1,SKU009,620,6,626
2025-03-06,7,2,SKU026,379,31,410
2025-03-06,7,3,SKU005,425,33,458
2025-03-06,8,1,SKU038,392,19,411
2025-03-06,8,2,SKU031,611,20,631
2025-03-06,8,3,SKU037,712,55,767
2025-03-06,9,1,SKU039,455,44,499
2025-03-06,9,2,SKU012,271,34,305
2025-03-06,9,3,SKU029,321,34,355
2025-03-06,10,2,SKU002,655,67,722
2025-03-06,11,2,SKU019,747,105,852
2025-03-06,12,1,SKU017,429,5,434
2025-03-06,12,2,SKU014,296,26,322
2025-03-06,12,3,SKU040,292,32,324
2025-03-06,13,1,SKU001,524,41,565
2025-03-06,13,3,SKU015,324,34,358
2025-03-06,14,2,SKU012,628,5,633
2025-03-06,14,3,SKU004,783,100,883
2025-03-06,15,1,SKU008,730,75,805
2025-03-06,15,2,SKU018,633,90,723
2025-03-06,15,3,SKU012,325,36,361
2025-03-07,1,3,SKU014,435,32,467
2025-03-07,2,1,SKU024,703,67,770
2025-03-07,2,2,SKU001,659,95,754
2025-03-07,2,3,SKU040,462,10,472
2025-03-07,3,1,SKU039,656,36,692
2025-03-07,3,3,SKU004,588,36,624
2025-03-07,4,1,SKU012,233,12,245
2025-03-07,4,2,SKU013,495,57,552
2025-03-07,4,3,SKU037,300,38,338
2025-03-07,5,1,SKU029,601,13,614
2025-03-07,5,2,SKU011,237,23,260
2025-03-07,5,3,SKU007,526,24,550
2025-03-07,6,1,SKU037,242,17,259
2025-03-07,6,2,SKU027,455,65,520
2025-03-07,6,3,SKU002,290,19,309
2025-03-07,7,2,SKU040,665,30,695
2025-03-07,8,1,SKU015,770,10,780
2025-03-07,8,2,SKU015,742,55,797
2025-03-07,9,1,SKU027,732,64,796
2025-03-07,9,2,SKU012,377,12,389
2025-03-07,9,3,SKU032,637,61,698
2025-03-07,10,1,SKU040,636,70,706
2025-03-07,10,2,SKU005,270,32,302
2025-03-07,10,3,SKU012,288,32,320
2025-03-07,11,1,SKU006,783,20,803
2025-03-07,11,3,SKU020,766,7,773
2025-03-07,12,1,SKU029,512,51,563
2025-03-07,12,2,SKU002,371,31,402
2025-03-07,12,3,SKU020,530,3,533
2025-03-07,13,3,SKU001,262,23,285
2025-03-07,14,1,SKU025,731,46,777
2025-03-07,14,2,SKU037,635,63,698
2025-03-07,14,3,SKU001,622,23,645
2025-03-07,15,1,SKU019,531,3,534
2025-03-08,1,1,SKU017,253,29,282
2025-03-08,1,2,SKU025,362,8,370
2025-03-08,1,3,SKU033,663,58,721
2025-03-08,2,1,SKU038,265,0,265
2025-03-08,2,2,SKU009,526,66,592
2025-03-08,2,3,SKU033,518,65,583
2025-03-08,3,1,SKU029,334,23,357
2025-03-08,3,2,SKU004,625,84,709
2025-03-08,3,3,SKU033,583,57,640
2025-03-08,4,1,SKU007,296,0,296
2025-03-08,4,2,SKU033,701,45,746
2025-03-08,5,1,SKU006,607,55,662
2025-03-08,5,2,SKU010,731,89,820
2025-03-08,5,3,SKU025,666,91,757
2025-03-08,6,1,SKU021,734,18,752
2025-03-08,6,2,SKU033,648,39,687
2025-03-08,7,1,SKU003,731,78,809
2025-03-08,7,2,SKU027,567,12,579
2025-03-08,7,3,SKU031,702,86,788
2025-03-08,8,1,SKU009,548,7,555
2025-03-08,8,2,SKU023,571,82,653
2025-03-08,8,3,SKU019,344,26,370
2025-03-08,9,3,SKU023,253,14,267
2025-03-08,10,1,SKU032,535,1,536
2025-03-08,10,2,SKU033,392,40,432
2025-03-08,11,1,SKU004,784,31,815
2025-03-08,11,2,SKU027,742,69,811
2025-03-08,11,3,SKU039,453,22,475
2025-03-08,12,1,SKU007,753,87,840
2025-03-08,12,2,SKU028,206,18,224
2025-03-08,13,2,SKU036,444,48,492
2025-03-08,13,3,SKU002,591,80,671
2025-03-08,14,1,SKU030,780,24,804
2025-03-08,14,2,SKU026,562,82,644
2025-03-08,14,3,SKU040,341,21,362
2025-03-08,15,1,SKU005,208,9,217
2025-03-08,15,2,SKU006,734,106,840
2025-03-08,15,3,SKU038,296,3,299
2025-03-09,1,1,SKU028,512,3,515
2025-03-09,1,3,SKU038,461,21,482
2025-03-09,2,1,SKU031,208,29,237
2025-03-09,2,2,SKU040,288,2,290
2025-03-09,2,3,SKU004,430,34,464
2025-03-09,3,1,SKU007,298,36,334
2025-03-09,3,2,SKU015,561,29,590
2025-03-09,3,3,SKU009,651,40,691
2025-03-09,4,1,SKU019,463,34,497
2025-03-09,4,2,SKU002,754,10,764
2025-03-09,4,3,SKU027,418,14,432
2025-03-09,5,2,SKU008,424,59,483
2025-03-09,5,3,SKU011,464,2,466
2025-03-09,6,1,SKU040,385,16,401
2025-03-09,6,2,SKU022,425,2,427
2025-03-09,6,3,SKU003,211,17,228
2025-03-09,7,1,SKU002,443,42,485
2025-03-09,7,2,SKU040,730,49,779
2025-03-09,7,3,SKU040,787,5,792
2025-03-09,8,1,SKU035,506,33,539
2025-03-09,8,3,SKU038,219,28,247
2025-03-09,9,1,SKU008,504,45,549
2025-03-09,9,2,SKU020,262,21,283
2025-03-09,9,3,SKU025,782,44,826
2025-03-09,10,1,SKU003,599,15,614
2025-03-09,10,2,SKU020,391,44,435
2025-03-09,11,1,SKU015,395,28,423
2025-03-09,11,2,SKU001,332,33,365
2025-03-09,11,3,SKU009,497,22,519
2025-03-09,12,1,SKU001,514,37,551
2025-03-09,12,3,SKU001,550,33,583
2025-03-09,13,2,SKU032,227,21,248
2025-03-09,13,3,SKU020,660,37,697
2025-03-09,14,1,SKU004,614,47,661
2025-03-09,14,2,SKU024,698,64,762
2025-03-09,14,3,SKU009,508,9,517
2025-03-09,15,1,SKU016,727,55,782
2025-03-09,15,2,SKU039,741,96,837
2025-03-09,15,3,SKU005,744,48,792
2025-03-10,1,1,SKU037,513,62,575
2025-03-10,1,2,SKU033,208,7,215
2025-03-10,1,3,SKU034,696,29,725
2025-03-10,2,2,SKU021,403,55,458
2025-03-10,2,3,SKU015,766,52,818
2025-03-10,3,2,SKU031,348,28,376
2025-03-10,4,1,SKU032,373,42,415
2025-03-10,4,3,SKU012,656,5,661
2025-03-10,5,1,SKU019,534,38,572
2025-03-10,5,2,SKU008,436,43,479
2025-03-10,5,3,SKU040,352,35,387
2025-03-10,6,1,SKU036,508,8,516
2025-03-10,6,2,SKU034,605,83,688
2025-03-10,7,1,SKU019,771,0,771
2025-03-10,7,2,SKU026,582,60,642
2025-03-10,7,3,SKU014,384,4,388
2025-03-10,8,1,SKU037,541,65,606
2025-03-10,8,2,SKU034,320,2,322
2025-03-10,8,3,SKU012,383,13,396
2025-03-10,9,1,SKU026,612,63,675
2025-03-10,9,3,SKU039,602,34,636
2025-03-10,10,1,SKU024,593,64,657
2025-03-10,10,3,SKU008,585,0,585
2025-03-10,11,1,SKU005,305,41,346
2025-03-10,11,2,SKU031,540,21,561
2025-03-10,11,3,SKU009,464,1,465
2025-03-10,12,1,SKU025,772,24,796
2025-03-10,12,2,SKU028,571,47,618
2025-03-10,12,3,SKU027,664,93,757
2025-03-10,13,1,SKU016,707,58,765
2025-03-10,13,3,SKU033,604,20,624
2025-03-10,14,1,SKU006,367,23,390
2025-03-10,14,2,SKU027,536,40,576
2025-03-10,14,3,SKU032,765,11,776
2025-03-10,15,1,SKU020,321,2,323
2025-03-10,15,2,SKU028,254,3,257
2025-03-10,15,3,SKU035,239,4,243
2025-03-11,1,1,SKU032,709,32,741
2025-03-11,1,2,SKU009,785,101,886
2025-03-11,1,3,SKU012,336,18,354
2025-03-11,2,1,SKU012,760,71,831
2025-03-11,2,2,SKU007,754,34,788
2025-03-11,2,3,SKU030,648,70,718
2025-03-11,3,1,SKU028,313,18,331
2025-03-11,3,2,SKU030,765,99,864
2025-03-11,3,3,SKU002,453,1,454
2025-03-11,4,1,SKU039,510,18,528
2025-03-11,4,2,SKU028,580,70,650
2025-03-11,4,3,SKU036,397,50,447
2025-03-11,5,1,SKU005,408,11,419
2025-03-11,5,3,SKU039,370,48,418
2025-03-11,6,1,SKU021,790,71,861
2025-03-11,6,3,SKU027,568,3,571
2025-03-11,7,2,SKU021,367,35,402
2025-03-11,7,3,SKU038,526,15,541
2025-03-11,8,1,SKU039,288,1,289
2025-03-11,8,3,SKU029,547,46,593
2025-03-11,9,1,SKU038,570,18,588
2025-03-11,9,2,SKU038,649,64,713
2025-03-11,9,3,SKU016,473,27,500
2025-03-11,10,1,SKU006,259,27,286
2025-03-11,10,2,SKU005,338,16,354
2025-03-11,10,3,SKU004,643,2,645
2025-03-11,11,1,SKU025,347,8,355
2025-03-11,11,2,SKU010,357,39,396
2025-03-11,11,3,SKU020,595,51,646
2025-03-11,12,1,SKU031,751,5,756
2025-03-11,12,2,SKU025,383,45,428
2025-03-11,12,3,SKU034,665,66,731
2025-03-11,13,1,SKU024,706,79,785
2025-03-11,13,2,SKU014,221,8,229
2025-03-11,13,3,SKU011,661,62,723
2025-03-11,14,1,SKU028,547,50,597
2025-03-11,14,3,SKU040,511,22,533
2025-03-11,15,1,SKU017,684,49,733
2025-03-11,15,3,SKU036,398,19,417
2025-03-12,1,1,SKU031,671,34,705
2025-03-12,1,2,SKU039,588,38,626
2025-03-12,1,3,SKU011,452,29,481
2025-03-12,2,1,SKU023,603,8,611
2025-03-12,2,2,SKU023,361,40,401
2025-03-12,3,1,SKU007,451,26,477
2025-03-12,3,3,SKU038,409,9,418
2025-03-12,4,2,SKU036,402,11,413
2025-03-12,4,3,SKU012,242,26,268
2025-03-12,5,2,SKU003,537,7,544
2025-03-12,5,3,SKU007,626,74,700
2025-03-12,6,1,SKU026,546,33,579
2025-03-12,6,3,SKU009,240,22,262
2025-03-12,7,1,SKU026,522,43,565
2025-03-12,7,2,SKU001,219,26,245
2025-03-12,7,3,SKU027,767,36,803
2025-03-12,8,1,SKU009,785,18,803
2025-03-12,8,2,SKU010,307,16,323
2025-03-12,8,3,SKU022,347,49,396
2025-03-12,9,1,SKU037,720,90,810
2025-03-12,9,2,SKU019,221,11,232
2025-03-12,9,3,SKU007,570,47,617
2025-03-12,10,1,SKU001,374,25,399
2025-03-12,10,2,SKU038,471,46,517
2025-03-12,11,1,SKU032,397,35,432
2025-03-12,11,2,SKU034,368,24,392
2025-03-12,11,3,SKU039,799,33,832
2025-03-12,12,1,SKU036,556,37,593
2025-03-12,12,2,SKU012,335,24,359
2025-03-12,12,3,SKU011,748,76,824
2025-03-12,13,2,SKU006,359,1,360
2025-03-12,13,3,SKU027,442,54,496
2025-03-12,14,1,SKU017,349,18,367
2025-03-12,14,2,SKU012,248,13,261
2025-03-12,14,3,SKU032,474,47,521
2025-03-12,15,2,SKU027,769,65,834
2025-03-12,15,3,SKU001,302,10,312
2025-03-13,1,1,SKU024,266,2,268
2025-03-13,1,2,SKU025,298,24,322
2025-03-13,1,3,SKU034,478,37,515
2025-03-13,2,2,SKU036,385,52,437
2025-03-13,3,1,SKU021,351,31,382
2025-03-13,3,3,SKU022,622,80,702
2025-03-13,4,1,SKU028,435,34,469
2025-03-13,4,3,SKU017,473,1,474
2025-03-13,5,1,SKU023,784,94,878
2025-03-13,5,2,SKU029,787,42,829
2025-03-13,5,3,SKU039,745,99,844
2025-03-13,6,1,SKU001,383,7,390
2025-03-13,6,2,SKU025,343,7,350
2025-03-13,6,3,SKU022,382,17,399
2025-03-13,7,1,SKU021,397,16,413
2025-03-13,7,3,SKU004,237,5,242
2025-03-13,8,2,SKU031,211,21,232
2025-03-13,8,3,SKU006,619,63,682
2025-03-13,9,2,SKU016,417,20,437
2025-03-13,10,1,SKU032,320,28,348
2025-03-13,10,2,SKU009,457,52,509
2025-03-13,10,3,SKU018,365,10,375
2025-03-13,11,1,SKU030,705,30,735
2025-03-13,11,2,SKU007,230,17,247
2025-03-13,11,3,SKU023,330,47,377
2025-03-13,12,1,SKU040,389,27,416
2025-03-13,12,3,SKU008,711,11,722
2025-03-13,13,1,SKU025,249,7,256
2025-03-13,13,2,SKU030,642,60,702
2025-03-13,13,3,SKU025,477,3,480
2025-03-13,14,1,SKU024,430,50,480
2025-03-13,14,2,SKU029,608,19,627
2025-03-13,14,3,SKU010,746,108,854
2025-03-13,15,2,SKU024,671,14,685
2025-03-14,1,1,SKU019,283,18,301
2025-03-14,1,2,SKU009,247,11,258
2025-03-14,1,3,SKU016,591,42,633
2025-03-14,2,1,SKU007,536,9,545
2025-03-14,2,2,SKU038,304,30,334
2025-03-14,2,3,SKU034,341,45,386
2025-03-14,3,1,SKU002,234,6,240
2025-03-14,3,2,SKU023,457,52,509
2025-03-14,4,1,SKU017,720,60,780
2025-03-14,4,2,SKU030,290,31,321
2025-03-14,5,1,SKU016,566,57,623
2025-03-14,5,2,SKU024,511,51,562
2025-03-14,5,3,SKU023,641,77,718
2025-03-14,6,1,SKU008,325,5,330
2025-03-14,7,1,SKU009,709,28,737
2025-03-14,7,2,SKU009,231,0,231
2025-03-14,7,3,SKU035,676,4,680
2025-03-14,8,1,SKU026,473,41,514
2025-03-14,8,2,SKU001,674,99,773
2025-03-14,8,3,SKU009,235,25,260
2025-03-14,9,1,SKU036,735,108,843
2025-03-14,9,2,SKU003,385,16,401
2025-03-14,9,3,SKU028,229,9,238
2025-03-14,10,1,SKU023,582,86,668
2025-03-14,10,2,SKU013,786,87,873
2025-03-14,10,3,SKU036,596,78,674
2025-03-14,11,1,SKU010,425,11,436
2025-03-14,11,2,SKU026,502,28,530
2025-03-14,11,3,SKU007,592,52,644
2025-03-14,12,2,SKU001,466,9,475
2025-03-14,12,3,SKU004,488,41,529
2025-03-14,13,1,SKU023,223,30,253
2025-03-14,13,2,SKU029,210,17,227
2025-03-14,13,3,SKU005,743,83,826
2025-03-14,14,2,SKU018,347,23,370
2025-03-14,14,3,SKU039,423,37,460
2025-03-14,15,2,SKU037,254,10,264
2025-03-14,15,3,SKU038,740,59,799
2025-03-15,1,1,SKU018,748,93,841
2025-03-15,1,2,SKU040,456,41,497
2025-03-15,1,3,SKU037,519,1,520
2025-03-15,2,2,SKU014,307,30,337
2025-03-15,2,3,SKU037,652,66,718
2025-03-15,3,1,SKU040,316,4,320
2025-03-15,3,2,SKU040,712,6,718
2025-03-15,3,3,SKU025,211,20,231
2025-03-15,4,1,SKU040,272,15,287
2025-03-15,4,2,SKU026,676,37,713
2025-03-15,4,3,SKU029,428,5,433
2025-03-15,5,3,SKU007,431,31,462
2025-03-15,6,1,SKU017,543,76,619
2025-03-15,6,2,SKU036,625,63,688
2025-03-15,6,3,SKU025,401,4,405
2025-03-15,7,1,SKU024,498,73,571
2025-03-15,8,1,SKU026,433,24,457
2025-03-15,8,2,SKU011,618,39,657
2025-03-15,8,3,SKU014,493,53,546
2025-03-15,9,1,SKU007,682,68,750
2025-03-15,9,2,SKU004,544,78,622
2025-03-15,9,3,SKU014,713,100,813
2025-03-15,10,1,SKU038,227,27,254
2025-03-15,10,2,SKU031,238,1,239
2025-03-15,10,3,SKU005,580,54,634
2025-03-15,11,1,SKU022,708,78,786
2025-03-15,11,2,SKU012,447,17,464
2025-03-15,11,3,SKU003,593,37,630
2025-03-15,12,2,SKU016,296,10,306
2025-03-15,13,2,SKU009,402,5,407
2025-03-15,13,3,SKU021,599,33,632
2025-03-15,14,1,SKU012,661,62,723
2025-03-15,14,2,SKU006,235,9,244
2025-03-15,14,3,SKU017,279,18,297
2025-03-15,15,1,SKU040,332,25,357
2025-03-15,15,2,SKU013,768,36,804
2025-03-16,1,1,SKU025,702,23,725
2025-03-16,1,2,SKU010,564,1,565
2025-03-16,1,3,SKU022,591,47,638
2025-03-16,2,1,SKU008,509,43,552
2025-03-16,2,2,SKU021,356,17,373
2025-03-16,2,3,SKU037,627,35,662
2025-03-16,3,1,SKU018,227,17,244
2025-03-16,3,2,SKU035,345,23,368
2025-03-16,4,1,SKU032,440,14,454
2025-03-16,4,2,SKU031,503,5,508
2025-03-16,4,3,SKU037,312,35,347
2025-03-16,5,1,SKU017,713,67,780
2025-03-16,5,2,SKU025,665,68,733
2025-03-16,5,3,SKU028,343,23,366
2025-03-16,6,1,SKU005,251,20,271
2025-03-16,6,2,SKU029,210,13,223
2025-03-16,6,3,SKU006,485,39,524
2025-03-16,7,1,SKU004,448,34,482
2025-03-16,7,2,SKU011,624,20,644
2025-03-16,7,3,SKU008,421,33,454
2025-03-16,8,1,SKU019,397,56,453
2025-03-16,8,2,SKU026,273,2,275
2025-03-16,8,3,SKU027,372,15,387
2025-03-16,9,1,SKU025,364,11,375
2025-03-16,9,2,SKU027,495,47,542
2025-03-16,9,3,SKU036,548,48,596
2025-03-16,10,1,SKU040,266,36,302
2025-03-16,10,2,SKU023,295,13,308
2025-03-16,10,3,SKU015,720,14,734
2025-03-16,11,1,SKU003,393,52,445
2025-03-16,11,2,SKU037,343,16,359
2025-03-16,11,3,SKU017,523,55,578
2025-03-16,12,1,SKU039,546,60,606
2025-03-16,12,2,SKU005,249,9,258
2025-03-16,12,3,SKU024,476,42,518
2025-03-16,13,1,SKU008,360,49,409
2025-03-16,13,2,SKU014,692,16,708
2025-03-16,13,3,SKU005,507,53,560
2025-03-16,14,1,SKU037,606,46,652
2025-03-16,14,2,SKU007,466,46,512
2025-03-16,14,3,SKU002,474,50,524
2025-03-16,15,1,SKU040,711,32,743
2025-03-16,15,2,SKU032,612,4,616
2025-03-17,1,1,SKU013,555,25,580
2025-03-17,1,2,SKU025,633,28,661
2025-03-17,2,1,SKU034,776,29,805
2025-03-17,2,2,SKU009,266,23,289
2025-03-17,2,3,SKU001,575,38,613
2025-03-17,3,1,SKU016,554,15,569
2025-03-17,3,2,SKU007,604,35,639
2025-03-17,3,3,SKU036,633,92,725
2025-03-17,4,2,SKU035,368,35,403
2025-03-17,4,3,SKU022,512,43,555
2025-03-17,5,1,SKU030,521,65,586
2025-03-17,5,2,SKU031,625,81,706
2025-03-17,5,3,SKU001,493,59,552
2025-03-17,6,1,SKU009,467,33,500
2025-03-17,6,2,SKU028,248,29,277
2025-03-17,6,3,SKU033,512,71,583
2025-03-17,7,1,SKU003,413,31,444
2025-03-17,7,3,SKU003,660,76,736
2025-03-17,8,1,SKU014,473,24,497
2025-03-17,8,2,SKU004,428,1,429
2025-03-17,8,3,SKU001,624,31,655
2025-03-17,9,1,SKU006,656,17,673
2025-03-17,9,2,SKU027,313,9,322
2025-03-17,9,3,SKU007,650,94,744
2025-03-17,10,1,SKU025,441,21,462
2025-03-17,10,2,SKU032,448,12,460
2025-03-17,11,1,SKU006,675,41,716
2025-03-17,11,2,SKU039,503,64,567
2025-03-17,11,3,SKU012,225,21,246
2025-03-17,12,1,SKU018,645,36,681
2025-03-17,12,2,SKU003,436,10,446
2025-03-17,12,3,SKU001,792,34,826
2025-03-17,13,1,SKU006,617,0,617
2025-03-17,13,2,SKU031,247,33,280
2025-03-17,13,3,SKU003,388,54,442
2025-03-17,14,1,SKU002,437,36,473
2025-03-17,14,2,SKU025,506,26,532
2025-03-17,14,3,SKU038,244,11,255
2025-03-17,15,1,SKU030,436,54,490
2025-03-17,15,2,SKU001,396,56,452
2025-03-17,15,3,SKU004,670,46,716
2025-03-18,1,1,SKU002,261,10,271
2025-03-18,1,2,SKU023,254,15,269
2025-03-18,1,3,SKU017,609,47,656
2025-03-18,2,1,SKU030,683,77,760
2025-03-18,2,2,SKU035,740,39,779
2025-03-18,2,3,SKU002,242,3,245
2025-03-18,3,1,SKU016,557,80,637
2025-03-18,3,2,SKU033,387,23,410
2025-03-18,3,3,SKU024,686,93,779
2025-03-18,4,1,SKU035,619,62,681
2025-03-18,4,2,SKU008,310,32,342
2025-03-18,4,3,SKU021,239,18,257
2025-03-18,5,1,SKU019,508,35,543
2025-03-18,5,3,SKU028,729,39,768
2025-03-18,6,1,SKU002,287,21,308
2025-03-18,6,2,SKU005,741,70,811
2025-03-18,6,3,SKU004,711,32,743
2025-03-18,7,2,SKU014,320,5,325
2025-03-18,7,3,SKU006,514,13,527
2025-03-18,8,3,SKU020,440,30,470
2025-03-18,9,1,SKU020,253,29,282
2025-03-18,9,2,SKU036,308,2,310
2025-03-18,9,3,SKU024,454,63,517
2025-03-18,10,1,SKU014,784,17,801
2025-03-18,10,2,SKU009,277,17,294
2025-03-18,10,3,SKU040,787,73,860
2025-03-18,12,1,SKU020,424,29,453
2025-03-18,12,2,SKU022,430,61,491
2025-03-18,12,3,SKU015,262,32,294
2025-03-18,13,1,SKU036,278,28,306
2025-03-18,13,2,SKU005,556,62,618
2025-03-18,13,3,SKU031,514,10,524
2025-03-18,14,2,SKU017,268,18,286
2025-03-18,14,3,SKU010,757,12,769
2025-03-18,15,2,SKU035,771,108,879
2025-03-18,15,3,SKU004,397,1,398
2025-03-19,1,2,SKU033,412,45,457
2025-03-19,1,3,SKU001,727,57,784
2025-03-19,2,1,SKU032,517,16,533
2025-03-19,2,2,SKU024,479,2,481
2025-03-19,2,3,SKU003,578,79,657
2025-03-19,3,2,SKU009,609,13,622
2025-03-19,4,1,SKU006,646,9,655
2025-03-19,4,2,SKU040,203,1,204
2025-03-19,4,3,SKU027,781,84,865
2025-03-19,5,2,SKU005,482,18,500
2025-03-19,5,3,SKU040,575,76,651
2025-03-19,6,1,SKU014,205,10,215
2025-03-19,6,2,SKU012,658,4,662
2025-03-19,7,2,SKU002,686,75,761
2025-03-19,7,3,SKU024,427,29,456
2025-03-19,8,1,SKU007,621,16,637
2025-03-19,8,2,SKU019,445,17,462
2025-03-19,8,3,SKU026,429,51,480
2025-03-19,9,1,SKU031,510,60,570
2025-03-19,9,2,SKU037,417,0,417
2025-03-19,9,3,SKU015,602,16,618
2025-03-19,10,1,SKU033,514,12,526
2025-03-19,10,2,SKU027,203,20,223
2025-03-19,10,3,SKU036,214,0,214
2025-03-19,11,2,SKU039,237,23,260
2025-03-19,11,3,SKU017,475,46,521
2025-03-19,12,1,SKU024,725,23,748
2025-03-19,12,2,SKU005,776,5,781
2025-03-19,12,3,SKU034,288,35,323
2025-03-19,13,1,SKU013,308,4,312
2025-03-19,13,2,SKU033,585,29,614
2025-03-19,13,3,SKU027,554,56,610
2025-03-19,14,1,SKU025,317,4,321
2025-03-19,14,2,SKU017,390,28,418
2025-03-19,14,3,SKU011,574,15,589
2025-03-19,15,2,SKU034,673,98,771
2025-03-19,15,3,SKU014,433,16,449
2025-03-20,1,1,SKU033,449,15,464
2025-03-20,1,2,SKU032,278,34,312
2025-03-20,1,3,SKU037,373,33,406
2025-03-20,2,2,SKU002,306,24,330
2025-03-20,2,3,SKU035,322,7,329
2025-03-20,3,2,SKU040,695,14,709
2025-03-20,3,3,SKU005,508,11,519
2025-03-20,4,1,SKU025,714,102,816
2025-03-20,4,2,SKU040,387,22,409
2025-03-20,4,3,SKU030,244,35,279
2025-03-20,5,1,SKU015,206,26,232
2025-03-20,5,2,SKU037,327,40,367
2025-03-20,5,3,SKU006,646,70,716
2025-03-20,6,2,SKU030,472,45,517
2025-03-20,6,3,SKU040,496,17,513
2025-03-20,7,1,SKU012,754,52,806
2025-03-20,7,2,SKU006,373,8,381
2025-03-20,7,3,SKU013,266,7,273
2025-03-20,8,1,SKU019,255,36,291
2025-03-20,8,2,SKU010,644,67,711
2025-03-20,8,3,SKU015,259,25,284
2025-03-20,9,1,SKU033,552,65,617
2025-03-20,9,2,SKU026,407,34,441
2025-03-20,9,3,SKU023,267,39,306
2025-03-20,10,1,SKU004,747,91,838
2025-03-20,10,2,SKU027,654,20,674
2025-03-20,11,1,SKU001,448,38,486
2025-03-20,11,2,SKU008,459,58,517
2025-03-20,12,1,SKU035,634,74,708
2025-03-20,12,2,SKU028,244,17,261
2025-03-20,12,3,SKU003,407,1,408
2025-03-20,13,1,SKU030,250,18,268
2025-03-20,13,2,SKU003,785,102,887
2025-03-20,13,3,SKU004,472,46,518
2025-03-20,14,1,SKU032,785,43,828
2025-03-20,14,2,SKU002,690,34,724
2025-03-20,14,3,SKU029,554,6,560
2025-03-20,15,2,SKU029,420,35,455
2025-03-20,15,3,SKU032,613,31,644
2025-03-21,1,1,SKU022,574,0,574
2025-03-21,1,2,SKU022,467,0,467
2025-03-21,1,3,SKU014,239,22,261
2025-03-21,2,1,SKU002,710,1,711
2025-03-21,2,2,SKU015,345,22,367
2025-03-21,3,1,SKU036,778,101,879
2025-03-21,3,3,SKU001,517,69,586
2025-03-21,4,1,SKU001,713,20,733
2025-03-21,4,2,SKU026,550,32,582
2025-03-21,4,3,SKU027,294,14,308
2025-03-21,5,1,SKU006,712,36,748
2025-03-21,5,2,SKU020,301,37,338
2025-03-21,5,3,SKU007,588,39,627
2025-03-21,6,2,SKU020,644,62,706
2025-03-21,6,3,SKU005,214,27,241
2025-03-21,7,2,SKU026,564,21,585
2025-03-21,7,3,SKU039,433,50,483
2025-03-21,8,1,SKU003,635,58,693
2025-03-21,8,2,SKU015,281,5,286
2025-03-21,8,3,SKU028,387,26,413
2025-03-21,9,1,SKU038,418,50,468
2025-03-21,9,2,SKU006,376,10,386
2025-03-21,9,3,SKU011,503,27,530
2025-03-21,10,1,SKU032,331,27,358
2025-03-21,10,2,SKU039,517,47,564
2025-03-21,10,3,SKU028,399,12,411
2025-03-21,11,1,SKU038,648,18,666
2025-03-21,11,2,SKU026,357,1,358
2025-03-21,11,3,SKU003,498,42,540
2025-03-21,12,1,SKU023,769,24,793
2025-03-21,12,2,SKU030,238,33,271
2025-03-21,12,3,SKU010,305,9,314
2025-03-21,13,2,SKU032,370,27,397
2025-03-21,13,3,SKU029,742,39,781
2025-03-21,14,1,SKU004,740,22,762
2025-03-21,14,2,SKU009,615,80,695
2025-03-21,14,3,SKU031,518,37,555
2025-03-21,15,1,SKU020,275,15,290
2025-03-21,15,2,SKU007,423,58,481
2025-03-21,15,3,SKU037,352,15,367
2025-03-22,1,1,SKU020,383,12,395
2025-03-22,1,2,SKU008,616,25,641
2025-03-22,2,2,SKU025,270,18,288
2025-03-22,2,3,SKU009,349,25,374
2025-03-22,3,1,SKU035,584,86,670
2025-03-22,3,2,SKU027,677,19,696
2025-03-22,3,3,SKU021,574,44,618
2025-03-22,4,1,SKU030,625,42,667
2025-03-22,4,3,SKU026,536,74,610
2025-03-22,5,1,SKU021,624,88,712
2025-03-22,5,2,SKU027,773,60,833
2025-03-22,6,1,SKU034,749,105,854
2025-03-22,6,2,SKU001,700,72,772
2025-03-22,6,3,SKU036,248,9,257
2025-03-22,7,1,SKU032,695,39,734
2025-03-22,7,2,SKU027,703,62,765
2025-03-22,7,3,SKU032,623,76,699
2025-03-22,8,1,SKU022,574,39,613
2025-03-22,8,2,SKU019,557,34,591
2025-03-22,8,3,SKU001,798,73,871
2025-03-22,9,1,SKU019,794,74,868
2025-03-22,9,2,SKU031,444,63,507
2025-03-22,9,3,SKU026,799,88,887
2025-03-22,10,1,SKU003,591,84,675
2025-03-22,10,3,SKU017,789,95,884
2025-03-22,11,1,SKU028,327,43,370
2025-03-22,11,2,SKU004,738,6,744
2025-03-22,12,1,SKU038,454,2,456
2025-03-22,12,2,SKU027,448,42,490
2025-03-22,13,1,SKU002,762,57,819
2025-03-22,13,2,SKU013,267,37,304
2025-03-22,13,3,SKU005,430,12,442
2025-03-22,14,1,SKU040,347,34,381
2025-03-22,14,2,SKU005,732,43,775
2025-03-22,14,3,SKU001,255,18,273
2025-03-22,15,1,SKU034,587,62,649
2025-03-22,15,3,SKU034,354,26,380
2025-03-23,1,2,SKU034,622,58,680
2025-03-23,2,1,SKU012,376,50,426
2025-03-23,2,2,SKU014,563,56,619
2025-03-23,2,3,SKU017,633,38,671
2025-03-23,3,1,SKU020,549,15,564
2025-03-23,3,2,SKU024,200,15,215
2025-03-23,3,3,SKU031,746,86,832
2025-03-23,4,1,SKU036,441,33,474
2025-03-23,4,2,SKU019,540,12,552
2025-03-23,5,1,SKU006,673,0,673
2025-03-23,5,2,SKU017,769,60,829
2025-03-23,5,3,SKU013,708,103,811
2025-03-23,6,1,SKU039,416,60,476
2025-03-23,6,2,SKU007,548,30,578
2025-03-23,7,1,SKU025,754,19,773
2025-03-23,7,3,SKU040,683,39,722
2025-03-23,8,1,SKU037,607,89,696
2025-03-23,8,2,SKU034,427,20,447
2025-03-23,8,3,SKU011,425,3,428
2025-03-23,9,1,SKU032,371,46,417
2025-03-23,9,2,SKU038,287,18,305
2025-03-23,9,3,SKU011,591,45,636
2025-03-23,10,3,SKU020,265,20,285
2025-03-23,11,2,SKU040,503,49,552
2025-03-23,11,3,SKU020,596,16,612
2025-03-23,12,1,SKU030,702,32,734
2025-03-23,12,2,SKU039,589,23,612
2025-03-23,12,3,SKU004,548,14,562
2025-03-23,13,1,SKU018,484,57,541
2025-03-23,13,2,SKU009,290,8,298
2025-03-23,13,3,SKU008,266,20,286
2025-03-23,14,1,SKU031,734,17,751
2025-03-23,14,2,SKU023,429,0,429
2025-03-23,14,3,SKU019,589,1,590
2025-03-23,15,1,SKU001,619,76,695
2025-03-23,15,2,SKU004,547,30,577
2025-03-23,15,3,SKU040,661,34,695
2025-03-24,2,2,SKU010,668,2,670
2025-03-24,2,3,SKU013,452,58,510
2025-03-24,3,1,SKU017,576,67,643
2025-03-24,3,2,SKU024,758,76,834
2025-03-24,4,1,SKU028,290,1,291
2025-03-24,4,2,SKU031,729,100,829
2025-03-24,4,3,SKU016,236,4,240
2025-03-24,5,1,SKU031,718,48,766
2025-03-24,6,1,SKU014,697,96,793
2025-03-24,6,2,SKU026,316,33,349
2025-03-24,6,3,SKU010,373,51,424
2025-03-24,7,1,SKU036,578,41,619
2025-03-24,7,2,SKU012,760,49,809
2025-03-24,7,3,SKU009,320,26,346
2025-03-24,8,1,SKU012,693,33,726
2025-03-24,8,2,SKU005,778,77,855
2025-03-24,8,3,SKU001,260,28,288
2025-03-24,9,1,SKU023,296,18,314
2025-03-24,9,2,SKU035,566,76,642
2025-03-24,9,3,SKU018,790,81,871
2025-03-24,10,1,SKU021,726,65,791
2025-03-24,10,2,SKU003,242,6,248
2025-03-24,11,2,SKU033,305,26,331
2025-03-24,11,3,SKU031,778,6,784
2025-03-24,12,1,SKU030,415,43,458
2025-03-24,12,2,SKU037,405,23,428
2025-03-24,13,1,SKU005,292,11,303
2025-03-24,13,2,SKU001,224,5,229
2025-03-24,14,1,SKU013,796,69,865
2025-03-24,14,2,SKU007,456,17,473
2025-03-24,14,3,SKU005,412,23,435
2025-03-24,15,1,SKU008,389,57,446
2025-03-24,15,2,SKU032,504,68,572
2025-03-24,15,3,SKU020,286,3,289
2025-03-25,1,2,SKU015,782,96,878
2025-03-25,1,3,SKU017,355,4,359
2025-03-25,2,1,SKU008,231,15,246
2025-03-25,2,2,SKU014,376,4,380
2025-03-25,2,3,SKU039,769,90,859
2025-03-25,3,1,SKU040,798,56,854
2025-03-25,3,3,SKU004,375,16,391
2025-03-25,4,1,SKU025,331,23,354
2025-03-25,5,1,SKU016,723,60,783
2025-03-25,5,2,SKU035,262,2,264
2025-03-25,5,3,SKU025,755,101,856
2025-03-25,6,2,SKU002,580,64,644
2025-03-25,6,3,SKU033,365,30,395
2025-03-25,7,1,SKU031,542,74,616
2025-03-25,7,2,SKU017,325,42,367
2025-03-25,7,3,SKU034,464,64,528
2025-03-25,8,2,SKU018,498,32,530
2025-03-25,8,3,SKU019,435,35,470
2025-03-25,9,1,SKU035,235,3,238
2025-03-25,9,2,SKU009,287,28,315
2025-03-25,9,3,SKU018,694,35,729
2025-03-25,10,1,SKU014,738,89,827
2025-03-25,10,2,SKU031,730,97,827
2025-03-25,11,1,SKU009,738,16,754
2025-03-25,11,2,SKU007,604,71,675
2025-03-25,11,3,SKU031,778,6,784
2025-03-25,12,1,SKU038,761,72,833
2025-03-25,12,3,SKU012,522,38,560
2025-03-25,13,1,SKU024,291,25,316
2025-03-25,13,2,SKU019,773,1,774
2025-03-25,13,3,SKU004,573,0,573
2025-03-25,14,1,SKU010,321,44,365
2025-03-25,14,2,SKU037,632,56,688
2025-03-25,14,3,SKU032,792,39,831
2025-03-25,15,1,SKU008,792,43,835
2025-03-25,15,2,SKU006,244,4,248
2025-03-25,15,3,SKU016,542,1,543
2025-03-26,1,2,SKU033,206,12,218
2025-03-26,1,3,SKU025,232,23,255
2025-03-26,2,1,SKU018,284,23,307
2025-03-26,2,2,SKU026,669,87,756
2025-03-26,2,3,SKU018,333,44,377
2025-03-26,3,1,SKU008,226,7,233
2025-03-26,3,2,SKU008,423,23,446
2025-03-26,3,3,SKU039,257,35,292
2025-03-26,4,1,SKU006,489,41,530
2025-03-26,4,2,SKU039,484,68,552
2025-03-26,4,3,SKU004,390,32,422
2025-03-26,5,1,SKU028,794,4,798
2025-03-26,5,2,SKU036,767,35,802
2025-03-26,5,3,SKU029,419,11,430
2025-03-26,6,2,SKU006,284,38,322
2025-03-26,6,3,SKU015,648,5,653
2025-03-26,7,1,SKU015,722,8,730
2025-03-26,7,2,SKU008,620,80,700
2025-03-26,7,3,SKU008,505,20,525
2025-03-26,8,1,SKU010,690,32,722
2025-03-26,8,2,SKU030,295,10,305
2025-03-26,9,1,SKU002,489,40,529
2025-03-26,9,2,SKU011,396,41,437
2025-03-26,9,3,SKU038,316,9,325
2025-03-26,10,1,SKU039,739,41,780
2025-03-26,10,3,SKU009,713,98,811
2025-03-26,11,1,SKU016,713,18,731
2025-03-26,11,2,SKU040,613,12,625
2025-03-26,12,1,SKU025,326,14,340
2025-03-26,12,2,SKU039,276,5,281
2025-03-26,12,3,SKU040,555,58,613
2025-03-26,13,1,SKU017,404,29,433
2025-03-26,13,3,SKU013,583,59,642
2025-03-26,14,1,SKU007,692,35,727
2025-03-26,14,2,SKU023,207,17,224
2025-03-26,14,3,SKU024,291,29,320
2025-03-26,15,1,SKU035,790,49,839
2025-03-26,15,2,SKU001,258,24,282
2025-03-26,15,3,SKU005,356,14,370
2025-03-27,1,1,SKU021,630,81,711
2025-03-27,1,2,SKU024,594,59,653
2025-03-27,2,1,SKU001,313,41,354
2025-03-27,2,2,SKU013,497,36,533
2025-03-27,2,3,SKU030,410,51,461
2025-03-27,3,1,SKU014,672,60,732
2025-03-27,3,2,SKU007,298,24,322
2025-03-27,3,3,SKU017,279,26,305
2025-03-27,4,1,SKU035,237,9,246
2025-03-27,4,2,SKU002,610,19,629
2025-03-27,4,3,SKU006,766,74,840
2025-03-27,5,2,SKU001,767,51,818
2025-03-27,5,3,SKU012,418,23,441
2025-03-27,6,1,SKU016,361,41,402
2025-03-27,6,2,SKU032,479,29,508
2025-03-27,6,3,SKU010,797,80,877
2025-03-27,7,1,SKU014,602,29,631
2025-03-27,7,2,SKU005,432,46,478
2025-03-27,7,3,SKU001,383,19,402
2025-03-27,8,1,SKU030,375,28,403
2025-03-27,8,2,SKU001,430,35,465
2025-03-27,8,3,SKU036,541,40,581
2025-03-27,9,1,SKU016,256,18,274
2025-03-27,9,3,SKU040,291,19,310
2025-03-27,10,1,SKU004,596,50,646
2025-03-27,10,2,SKU022,636,49,685
2025-03-27,10,3,SKU027,673,38,711
2025-03-27,11,1,SKU032,267,9,276
2025-03-27,11,2,SKU024,511,3,514
2025-03-27,11,3,SKU005,271,14,285
2025-03-27,12,1,SKU032,449,4,453
2025-03-27,12,2,SKU032,344,1,345
2025-03-27,12,3,SKU009,433,25,458
2025-03-27,14,1,SKU034,742,58,800
2025-03-27,14,2,SKU003,458,24,482
2025-03-27,15,1,SKU003,545,66,611
2025-03-27,15,2,SKU003,255,21,276
2025-03-27,15,3,SKU004,616,45,661
2025-03-28,1,1,SKU021,400,32,432
2025-03-28,1,2,SKU006,220,27,247
2025-03-28,1,3,SKU029,692,93,785
2025-03-28,2,2,SKU027,585,58,643
2025-03-28,2,3,SKU025,225,23,248
2025-03-28,3,1,SKU021,454,46,500
2025-03-28,3,2,SKU025,354,14,368
2025-03-28,4,1,SKU024,561,64,625
2025-03-28,5,1,SKU008,388,51,439
2025-03-28,5,2,SKU020,592,73,665
2025-03-28,6,1,SKU030,406,43,449
2025-03-28,6,2,SKU017,476,21,497
2025-03-28,6,3,SKU014,696,66,762
2025-03-28,7,2,SKU018,239,6,245
2025-03-28,7,3,SKU007,372,39,411
2025-03-28,8,1,SKU003,785,113,898
2025-03-28,8,3,SKU009,648,73,721
2025-03-28,9,1,SKU034,730,58,788
2025-03-28,10,1,SKU010,219,21,240
2025-03-28,10,2,SKU008,494,6,500
2025-03-28,10,3,SKU024,626,3,629
2025-03-28,11,2,SKU016,419,42,461
2025-03-28,11,3,SKU022,573,81,654
2025-03-28,12,1,SKU016,634,56,690
2025-03-28,12,2,SKU033,644,55,699
2025-03-28,13,1,SKU016,753,90,843
2025-03-28,13,2,SKU007,724,30,754
2025-03-28,14,1,SKU018,425,45,470
2025-03-28,14,2,SKU024,526,73,599
2025-03-28,14,3,SKU035,246,28,274
2025-03-28,15,1,SKU022,794,16,810
2025-03-28,15,2,SKU011,476,15,491
2025-03-28,15,3,SKU003,653,27,680
2025-03-29,1,1,SKU007,465,19,484
2025-03-29,1,2,SKU002,486,16,502
2025-03-29,1,3,SKU011,762,33,795
2025-03-29,2,1,SKU031,739,90,829
2025-03-29,2,2,SKU008,706,55,761
2025-03-29,2,3,SKU030,631,46,677
2025-03-29,3,1,SKU037,220,16,236
2025-03-29,3,2,SKU022,724,102,826
2025-03-29,3,3,SKU039,685,17,702
2025-03-29,4,1,SKU002,201,24,225
2025-03-29,4,2,SKU014,351,32,383
2025-03-29,4,3,SKU020,684,44,728
2025-03-29,5,1,SKU020,601,43,644
2025-03-29,5,2,SKU036,422,55,477
2025-03-29,5,3,SKU016,612,15,627
2025-03-29,6,1,SKU014,482,25,507
2025-03-29,6,2,SKU019,299,42,341
2025-03-29,6,3,SKU040,380,54,434
2025-03-29,7,1,SKU036,739,44,783
2025-03-29,7,3,SKU018,265,10,275
2025-03-29,8,1,SKU026,243,29,272
2025-03-29,8,2,SKU005,322,17,339
2025-03-29,9,1,SKU015,760,75,835
2025-03-29,9,2,SKU008,452,22,474
2025-03-29,9,3,SKU039,449,14,463
2025-03-29,10,1,SKU033,607,22,629
2025-03-29,10,2,SKU008,665,45,710
2025-03-29,10,3,SKU005,623,80,703
2025-03-29,11,1,SKU012,269,31,300
2025-03-29,11,3,SKU011,613,78,691
2025-03-29,12,1,SKU025,298,25,323
2025-03-29,12,2,SKU031,203,9,212
2025-03-29,12,3,SKU037,288,15,303
2025-03-29,13,1,SKU036,385,53,438
2025-03-29,13,2,SKU015,543,57,600
2025-03-29,13,3,SKU035,367,4,371
2025-03-29,14,1,SKU009,376,22,398
2025-03-29,14,3,SKU026,657,81,738
2025-03-29,15,1,SKU031,207,20,227
2025-03-29,15,2,SKU002,726,23,749
2025-03-29,15,3,SKU022,392,30,422
2025-03-30,1,1,SKU027,464,53,517
2025-03-30,1,2,SKU007,712,38,750
2025-03-30,1,3,SKU029,225,13,238
2025-03-30,2,1,SKU008,208,25,233
2025-03-30,2,2,SKU035,675,87,762
2025-03-30,2,3,SKU033,235,25,260
2025-03-30,3,1,SKU034,614,91,705
2025-03-30,3,2,SKU018,758,49,807
2025-03-30,3,3,SKU021,658,39,697
2025-03-30,4,1,SKU016,733,75,808
2025-03-30,4,3,SKU033,624,42,666
2025-03-30,5,1,SKU040,759,25,784
2025-03-30,5,2,SKU015,293,16,309
2025-03-30,5,3,SKU021,699,47,746
2025-03-30,6,1,SKU038,792,95,887
2025-03-30,6,2,SKU032,685,99,784
2025-03-30,7,2,SKU024,655,11,666
2025-03-30,8,1,SKU029,284,25,309
2025-03-30,8,2,SKU037,603,48,651
2025-03-30,8,3,SKU019,373,28,401
2025-03-30,9,1,SKU010,265,14,279
2025-03-30,9,2,SKU023,574,30,604
2025-03-30,9,3,SKU013,568,79,647
2025-03-30,10,2,SKU032,668,88,756
2025-03-30,11,1,SKU004,282,22,304
2025-03-30,11,2,SKU005,312,36,348
2025-03-30,11,3,SKU019,391,53,444
2025-03-30,12,1,SKU020,279,8,287
2025-03-30,12,2,SKU039,384,43,427
2025-03-30,12,3,SKU001,617,47,664
2025-03-30,13,1,SKU018,570,4,574
2025-03-30,13,2,SKU034,266,22,288
2025-03-30,14,2,SKU015,541,15,556
2025-03-30,15,1,SKU030,751,3,754
2025-03-31,1,1,SKU030,696,32,728
2025-03-31,1,3,SKU033,399,53,452
2025-03-31,2,1,SKU023,288,19,307
2025-03-31,2,2,SKU012,471,47,518
2025-03-31,3,2,SKU037,531,58,589
2025-03-31,3,3,SKU014,736,73,809
2025-03-31,4,1,SKU006,765,13,778
2025-03-31,4,2,SKU018,235,17,252
2025-03-31,4,3,SKU029,662,68,730
2025-03-31,5,1,SKU005,615,73,688
2025-03-31,5,2,SKU029,730,52,782
2025-03-31,5,3,SKU027,350,5,355
2025-03-31,6,1,SKU021,315,44,359
2025-03-31,6,3,SKU006,206,25,231
2025-03-31,7,1,SKU016,599,42,641
2025-03-31,7,2,SKU016,573,57,630
2025-03-31,7,3,SKU017,284,1,285
2025-03-31,8,1,SKU024,249,27,276
2025-03-31,8,2,SKU035,427,22,449
2025-03-31,8,3,SKU028,731,52,783
2025-03-31,9,1,SKU007,771,111,882
2025-03-31,9,3,SKU027,417,51,468
2025-03-31,10,1,SKU033,628,11,639
2025-03-31,10,2,SKU020,541,74,615
2025-03-31,10,3,SKU023,786,103,889
2025-03-31,11,1,SKU016,395,31,426
2025-03-31,11,2,SKU034,384,49,433
2025-03-31,11,3,SKU008,707,97,804
2025-03-31,12,1,SKU026,694,74,768
2025-03-31,12,2,SKU020,310,45,355
2025-03-31,12,3,SKU005,695,13,708
2025-03-31,13,1,SKU011,706,85,791
2025-03-31,13,3,SKU039,514,43,557
2025-03-31,14,1,SKU038,271,4,275
2025-03-31,14,2,SKU031,442,37,479
2025-03-31,14,3,SKU029,687,78,765
2025-03-31,15,1,SKU029,746,60,806
2025-03-31,15,2,SKU014,691,33,724
2025-03-31,15,3,SKU038,719,55,774
2025-04-01,1,1,SKU015,507,9,516
2025-04-01,2,1,SKU023,641,13,654
2025-04-01,2,2,SKU006,667,72,739
2025-04-01,2,3,SKU007,636,56,692
2025-04-01,3,2,SKU019,441,10,451
2025-04-01,3,3,SKU003,792,91,883
2025-04-01,4,1,SKU020,512,58,570
2025-04-01,4,2,SKU037,706,33,739
2025-04-01,5,1,SKU003,380,4,384
2025-04-01,5,2,SKU009,277,20,297
2025-04-01,5,3,SKU026,277,6,283
2025-04-01,6,2,SKU031,634,28,662
2025-04-01,7,2,SKU035,524,67,591
2025-04-01,7,3,SKU018,657,50,707
2025-04-01,8,1,SKU005,419,23,442
2025-04-01,8,3,SKU013,296,13,309
2025-04-01,9,1,SKU001,430,43,473
2025-04-01,9,2,SKU038,483,15,498
2025-04-01,9,3,SKU012,203,18,221
2025-04-01,10,2,SKU037,605,30,635
2025-04-01,10,3,SKU002,311,3,314
2025-04-01,11,1,SKU028,427,0,427
2025-04-01,11,2,SKU006,596,2,598
2025-04-01,11,3,SKU029,792,64,856
2025-04-01,12,1,SKU018,582,71,653
2025-04-01,12,2,SKU027,672,33,705
2025-04-01,13,1,SKU024,236,34,270
2025-04-01,13,2,SKU027,541,51,592
2025-04-01,13,3,SKU018,498,49,547
2025-04-01,14,1,SKU023,712,31,743
2025-04-01,14,2,SKU024,339,34,373
2025-04-01,14,3,SKU032,426,4,430
2025-04-01,15,1,SKU011,559,13,572
2025-04-01,15,2,SKU013,288,13,301
2025-04-01,15,3,SKU025,722,72,794
2025-04-02,1,1,SKU037,416,58,474
2025-04-02,1,2,SKU017,643,27,670
2025-04-02,1,3,SKU038,370,21,391
2025-04-02,2,2,SKU016,738,9,747
2025-04-02,3,1,SKU034,213,2,215
2025-04-02,3,3,SKU009,294,0,294
2025-04-02,4,1,SKU015,394,8,402
2025-04-02,4,2,SKU030,746,33,779
2025-04-02,4,3,SKU011,312,29,341
2025-04-02,5,1,SKU026,495,18,513
2025-04-02,5,2,SKU037,439,34,473
2025-04-02,5,3,SKU029,663,5,668
2025-04-02,6,1,SKU009,741,44,785
2025-04-02,6,3,SKU022,495,16,511
2025-04-02,7,1,SKU005,764,47,811
2025-04-02,7,3,SKU004,685,36,721
2025-04-02,8,1,SKU035,581,27,608
2025-04-02,8,2,SKU033,653,16,669
2025-04-02,8,3,SKU023,553,40,593
2025-04-02,9,1,SKU037,277,18,295
2025-04-02,9,2,SKU015,539,18,557
2025-04-02,9,3,SKU001,660,87,747
2025-04-02,10,1,SKU030,407,56,463
2025-04-02,10,2,SKU028,572,72,644
2025-04-02,11,1,SKU017,299,10,309
2025-04-02,11,2,SKU025,686,6,692
2025-04-02,11,3,SKU029,567,16,583
2025-04-02,12,1,SKU035,522,71,593
2025-04-02,12,2,SKU037,729,26,755
2025-04-02,12,3,SKU013,507,14,521
2025-04-02,13,1,SKU040,734,79,813
2025-04-02,13,2,SKU027,437,50,487
2025-04-02,13,3,SKU038,600,11,611
2025-04-02,14,1,SKU009,321,21,342
2025-04-02,14,2,SKU016,656,81,737
2025-04-02,14,3,SKU034,591,54,645
2025-04-02,15,1,SKU006,315,28,343
2025-04-02,15,2,SKU035,455,8,463
2025-04-03,1,1,SKU022,308,21,329
2025-04-03,1,2,SKU006,433,41,474
2025-04-03,2,1,SKU003,358,49,407
2025-04-03,2,2,SKU014,596,78,674
2025-04-03,2,3,SKU025,311,36,347
2025-04-03,3,1,SKU024,643,37,680
2025-04-03,3,2,SKU002,255,32,287
2025-04-03,3,3,SKU025,758,102,860
2025-04-03,4,1,SKU035,533,22,555
2025-04-03,4,2,SKU014,225,6,231
2025-04-03,4,3,SKU029,321,2,323
2025-04-03,5,1,SKU028,698,73,771
2025-04-03,5,2,SKU026,668,94,762
2025-04-03,5,3,SKU002,387,44,431
2025-04-03,6,1,SKU020,588,34,622
2025-04-03,6,2,SKU027,246,0,246
2025-04-03,6,3,SKU025,484,51,535
2025-04-03,7,1,SKU012,224,18,242
2025-04-03,7,2,SKU029,665,59,724
2025-04-03,7,3,SKU010,409,23,432
2025-04-03,8,1,SKU011,576,55,631
2025-04-03,8,2,SKU010,389,48,437
2025-04-03,8,3,SKU019,430,23,453
2025-04-03,9,1,SKU003,511,17,528
2025-04-03,9,3,SKU019,479,3,482
2025-04-03,10,1,SKU037,249,7,256
2025-04-03,10,2,SKU015,771,69,840
2025-04-03,10,3,SKU019,766,83,849
2025-04-03,11,3,SKU008,345,23,368
2025-04-03,12,1,SKU037,649,20,669
2025-04-03,12,2,SKU008,734,6,740
2025-04-03,12,3,SKU034,314,15,329
2025-04-03,13,1,SKU037,776,25,801
2025-04-03,13,2,SKU026,306,18,324
2025-04-03,13,3,SKU004,257,27,284
2025-04-03,14,1,SKU024,704,45,749
2025-04-03,14,3,SKU039,696,82,778
2025-04-03,15,1,SKU039,767,12,779
2025-04-03,15,2,SKU012,288,26,314
2025-04-03,15,3,SKU037,560,26,586
2025-04-04,1,1,SKU030,585,74,659
2025-04-04,1,2,SKU014,655,1,656
2025-04-04,1,3,SKU013,584,13,597
2025-04-04,2,1,SKU014,443,45,488
2025-04-04,2,2,SKU028,387,47,434
2025-04-04,2,3,SKU009,370,12,382
2025-04-04,3,1,SKU030,594,75,669
2025-04-04,3,2,SKU029,600,49,649
2025-04-04,4,1,SKU003,454,27,481
2025-04-04,4,2,SKU027,382,48,430
2025-04-04,4,3,SKU022,512,60,572
2025-04-04,5,2,SKU003,634,47,681
2025-04-04,5,3,SKU008,786,1,787
2025-04-04,6,1,SKU028,669,44,713
2025-04-04,6,2,SKU003,367,21,388
2025-04-04,6,3,SKU022,403,32,435
2025-04-04,7,1,SKU011,310,8,318
2025-04-04,7,2,SKU034,745,80,825
2025-04-04,7,3,SKU030,666,25,691
2025-04-04,8,2,SKU039,445,14,459
2025-04-04,8,3,SKU012,637,1,638
2025-04-04,9,1,SKU002,720,37,757
2025-04-04,9,3,SKU037,575,1,576
2025-04-04,10,1,SKU017,362,41,403
2025-04-04,10,2,SKU024,476,69,545
2025-04-04,10,3,SKU030,417,52,469
2025-04-04,11,1,SKU004,375,27,402
2025-04-04,11,2,SKU007,501,73,574
2025-04-04,11,3,SKU020,613,20,633
2025-04-04,12,1,SKU037,466,14,480
2025-04-04,12,2,SKU005,772,27,799
2025-04-04,12,3,SKU008,533,49,582
2025-04-04,13,2,SKU030,775,112,887
2025-04-04,13,3,SKU028,668,66,734
2025-04-04,14,1,SKU014,463,47,510
2025-04-04,14,2,SKU036,722,17,739
2025-04-04,14,3,SKU002,630,20,650
2025-04-04,15,1,SKU017,309,18,327
2025-04-04,15,2,SKU025,253,21,274
2025-04-04,15,3,SKU018,428,56,484
2025-04-05,1,1,SKU027,733,99,832
2025-04-05,1,2,SKU036,721,8,729
2025-04-05,2,1,SKU001,755,78,833
2025-04-05,2,2,SKU037,668,87,755
2025-04-05,2,3,SKU009,459,59,518
2025-04-05,3,1,SKU021,708,57,765
2025-04-05,3,2,SKU032,461,6,467
2025-04-05,3,3,SKU024,707,84,791
2025-04-05,4,2,SKU008,639,73,712
2025-04-05,4,3,SKU028,431,4,435
2025-04-05,5,1,SKU016,493,34,527
2025-04-05,5,2,SKU022,299,24,323
2025-04-05,5,3,SKU001,207,5,212
2025-04-05,6,1,SKU012,351,28,379
2025-04-05,6,3,SKU006,609,58,667
2025-04-05,7,1,SKU024,596,8,604
2025-04-05,7,2,SKU039,322,36,358
2025-04-05,7,3,SKU022,486,47,533
2025-04-05,8,1,SKU037,708,53,761
2025-04-05,8,2,SKU015,402,28,430
2025-04-05,8,3,SKU019,485,49,534
2025-04-05,9,1,SKU015,355,3,358
2025-04-05,9,2,SKU009,760,45,805
2025-04-05,10,1,SKU010,754,19,773
2025-04-05,10,2,SKU028,699,33,732
2025-04-05,10,3,SKU004,321,12,333
2025-04-05,11,1,SKU019,465,36,501
2025-04-05,11,2,SKU028,639,61,700
2025-04-05,11,3,SKU039,709,15,724
2025-04-05,12,1,SKU004,523,51,574
2025-04-05,12,2,SKU033,643,83,726
2025-04-05,12,3,SKU010,590,63,653
2025-04-05,13,1,SKU025,202,6,208
2025-04-05,13,2,SKU002,360,4,364
2025-04-05,13,3,SKU031,619,14,633
2025-04-05,14,2,SKU030,351,19,370
2025-04-05,14,3,SKU013,352,12,364
2025-04-05,15,1,SKU017,781,63,844
2025-04-05,15,2,SKU009,613,65,678
2025-04-05,15,3,SKU012,381,52,433
2025-04-06,1,1,SKU009,264,38,302
2025-04-06,1,2,SKU008,331,25,356
2025-04-06,1,3,SKU021,765,39,804
2025-04-06,2,1,SKU038,345,17,362
2025-04-06,2,2,SKU018,733,17,750
2025-04-06,2,3,SKU010,778,68,846
2025-04-06,3,2,SKU035,235,17,252
2025-04-06,3,3,SKU020,344,1,345
2025-04-06,4,1,SKU005,641,41,682
2025-04-06,4,2,SKU022,259,8,267
2025-04-06,4,3,SKU023,656,1,657
2025-04-06,5,1,SKU021,681,70,751
2025-04-06,5,2,SKU027,479,16,495
2025-04-06,5,3,SKU012,205,21,226
2025-04-06,6,1,SKU014,293,3,296
2025-04-06,6,2,SKU036,465,34,499
2025-04-06,6,3,SKU003,270,19,289
2025-04-06,7,2,SKU039,537,5,542
2025-04-06,7,3,SKU012,650,89,739
2025-04-06,8,1,SKU007,370,36,406
2025-04-06,9,1,SKU019,452,35,487
2025-04-06,9,2,SKU013,290,21,311
2025-04-06,9,3,SKU039,727,23,750
2025-04-06,10,1,SKU015,765,91,856
2025-04-06,10,2,SKU037,723,57,780
2025-04-06,10,3,SKU001,422,33,455
2025-04-06,11,1,SKU036,332,41,373
2025-04-06,11,2,SKU039,607,72,679
2025-04-06,11,3,SKU027,709,86,795
2025-04-06,12,1,SKU030,392,46,438
2025-04-06,12,2,SKU011,418,53,471
2025-04-06,12,3,SKU037,200,18,218
2025-04-06,14,2,SKU024,729,56,785
2025-04-06,14,3,SKU012,585,4,589
2025-04-06,15,1,SKU015,778,103,881
2025-04-06,15,2,SKU005,719,6,725
2025-04-06,15,3,SKU016,516,65,581
2025-04-07,1,1,SKU010,600,35,635
2025-04-07,1,2,SKU002,651,74,725
2025-04-07,2,1,SKU029,723,15,738
2025-04-07,2,2,SKU008,356,18,374
2025-04-07,2,3,SKU018,318,26,344
2025-04-07,3,1,SKU016,796,68,864
2025-04-07,3,2,SKU026,563,75,638
2025-04-07,4,1,SKU009,542,8,550
2025-04-07,4,2,SKU027,540,9,549
2025-04-07,4,3,SKU018,293,4,297
2025-04-07,5,1,SKU005,533,7,540
2025-04-07,5,3,SKU039,392,17,409
2025-04-07,6,1,SKU015,579,64,643
2025-04-07,6,2,SKU023,545,58,603
2025-04-07,6,3,SKU014,667,13,680
2025-04-07,7,1,SKU012,503,68,571
2025-04-07,7,2,SKU016,772,114,886
2025-04-07,8,1,SKU003,436,48,484
2025-04-07,8,2,SKU014,272,24,296
2025-04-07,8,3,SKU013,221,18,239
2025-04-07,9,1,SKU025,216,0,216
2025-04-07,9,2,SKU040,414,44,458
2025-04-07,10,2,SKU022,735,12,747
2025-04-07,10,3,SKU021,447,16,463
2025-04-07,11,1,SKU033,547,63,610
2025-04-07,11,2,SKU037,614,87,701
2025-04-07,11,3,SKU016,211,3,214
2025-04-07,12,1,SKU038,304,9,313
2025-04-07,12,2,SKU017,763,66,829
2025-04-07,12,3,SKU006,476,3,479
2025-04-07,13,1,SKU004,458,61,519
2025-04-07,13,2,SKU024,398,2,400
2025-04-07,13,3,SKU004,466,50,516
2025-04-07,14,1,SKU038,323,30,353
2025-04-07,14,2,SKU015,666,49,715
2025-04-07,15,1,SKU025,558,28,586
2025-04-07,15,2,SKU025,713,36,749
2025-04-08,1,1,SKU015,208,29,237
2025-04-08,1,2,SKU004,670,4,674
2025-04-08,1,3,SKU018,481,42,523
2025-04-08,2,1,SKU006,319,35,354
2025-04-08,2,2,SKU034,747,37,784
2025-04-08,2,3,SKU013,296,21,317
2025-04-08,3,1,SKU010,243,0,243
2025-04-08,3,2,SKU026,456,21,477
2025-04-08,4,2,SKU036,508,9,517
2025-04-08,4,3,SKU009,619,66,685
2025-04-08,5,1,SKU010,305,41,346
2025-04-08,5,2,SKU007,761,108,869
2025-04-08,5,3,SKU020,429,34,463
2025-04-08,6,1,SKU001,270,3,273
2025-04-08,6,2,SKU004,404,9,413
2025-04-08,6,3,SKU029,617,37,654
2025-04-08,7,1,SKU027,586,74,660
2025-04-08,7,2,SKU033,766,81,847
2025-04-08,7,3,SKU009,445,36,481
2025-04-08,8,1,SKU016,742,1,743
2025-04-08,8,2,SKU004,348,44,392
2025-04-08,8,3,SKU017,440,39,479
2025-04-08,9,1,SKU022,287,32,319
2025-04-08,9,2,SKU038,545,20,565
2025-04-08,9,3,SKU029,705,4,709
2025-04-08,10,1,SKU033,248,19,267
2025-04-08,10,2,SKU033,310,17,327
2025-04-08,10,3,SKU002,354,1,355
2025-04-08,11,2,SKU037,218,18,236
2025-04-08,11,3,SKU040,789,42,831
2025-04-08,12,1,SKU028,384,2,386
2025-04-08,12,2,SKU009,595,15,610
2025-04-08,12,3,SKU028,275,35,310
2025-04-08,13,1,SKU038,428,4,432
2025-04-08,13,2,SKU010,369,39,408
2025-04-08,13,3,SKU027,712,31,743
2025-04-08,14,1,SKU013,769,90,859
2025-04-08,14,2,SKU030,791,32,823
2025-04-08,15,1,SKU023,666,4,670
2025-04-08,15,2,SKU026,725,106,831
2025-04-08,15,3,SKU020,681,53,734
2025-04-09,1,2,SKU026,487,36,523
2025-04-09,1,3,SKU008,292,16,308
2025-04-09,2,1,SKU021,628,52,680
2025-04-09,2,2,SKU034,463,13,476
2025-04-09,2,3,SKU002,602,28,630
2025-04-09,3,1,SKU030,434,58,492
2025-04-09,3,2,SKU006,240,29,269
2025-04-09,3,3,SKU015,667,11,678
2025-04-09,4,1,SKU002,506,68,574
2025-04-09,4,3,SKU025,304,39,343
2025-04-09,5,1,SKU010,516,75,591
2025-04-09,5,2,SKU025,235,13,248
2025-04-09,5,3,SKU025,560,73,633
2025-04-09,6,1,SKU015,440,35,475
2025-04-09,6,2,SKU038,646,44,690
2025-04-09,7,2,SKU020,790,31,821
2025-04-09,7,3,SKU008,320,32,352
2025-04-09,8,1,SKU033,348,49,397
2025-04-09,8,2,SKU036,612,61,673
2025-04-09,8,3,SKU025,529,74,603
2025-04-09,9,1,SKU004,338,15,353
2025-04-09,9,2,SKU033,233,18,251
2025-04-09,10,1,SKU013,614,90,704
2025-04-09,10,3,SKU001,795,34,829
2025-04-09,11,1,SKU032,286,26,312
2025-04-09,11,2,SKU002,517,29,546
2025-04-09,11,3,SKU038,690,8,698
2025-04-09,12,1,SKU004,411,48,459
2025-04-09,12,2,SKU005,625,49,674
2025-04-09,12,3,SKU021,205,11,216
2025-04-09,13,1,SKU017,668,51,719
2025-04-09,13,3,SKU025,297,37,334
2025-04-09,14,2,SKU004,287,8,295
2025-04-09,14,3,SKU040,619,41,660
2025-04-09,15,1,SKU026,708,95,803
2025-04-09,15,2,SKU001,433,29,462
2025-04-09,15,3,SKU025,467,0,467
2025-04-10,1,1,SKU035,632,23,655
2025-04-10,1,2,SKU019,525,49,574
2025-04-10,1,3,SKU031,499,9,508
2025-04-10,2,1,SKU001,698,34,732
2025-04-10,2,2,SKU018,244,28,272
2025-04-10,2,3,SKU037,282,3,285
2025-04-10,3,2,SKU016,269,30,299
2025-04-10,3,3,SKU033,649,63,712
2025-04-10,4,1,SKU007,452,57,509
2025-04-10,4,2,SKU027,774,107,881
2025-04-10,4,3,SKU005,373,45,418
2025-04-10,5,1,SKU021,221,17,238
2025-04-10,5,2,SKU027,270,39,309
2025-04-10,6,2,SKU020,691,4,695
2025-04-10,6,3,SKU030,641,71,712
2025-04-10,7,1,SKU030,452,54,506
2025-04-10,7,2,SKU004,728,54,782
2025-04-10,7,3,SKU016,676,51,727
2025-04-10,8,1,SKU007,576,26,602
2025-04-10,8,2,SKU016,419,56,475
2025-04-10,9,1,SKU028,237,10,247
2025-04-10,9,2,SKU006,498,59,557
2025-04-10,9,3,SKU016,634,1,635
2025-04-10,10,2,SKU016,708,87,795
2025-04-10,10,3,SKU034,404,37,441
2025-04-10,11,1,SKU008,228,8,236
2025-04-10,11,2,SKU018,764,31,795
2025-04-10,11,3,SKU020,531,29,560
2025-04-10,12,2,SKU027,209,19,228
2025-04-10,12,3,SKU013,678,82,760
2025-04-10,13,1,SKU033,259,26,285
2025-04-10,13,2,SKU036,395,15,410
2025-04-10,13,3,SKU032,318,27,345
2025-04-10,14,1,SKU013,647,61,708
2025-04-10,14,2,SKU021,565,14,579
2025-04-10,14,3,SKU011,596,73,669
2025-04-10,15,1,SKU018,300,3,303
2025-04-10,15,2,SKU002,264,6,270
2025-04-10,15,3,SKU030,318,35,353
2025-04-11,1,1,SKU017,222,24,246
2025-04-11,1,2,SKU025,529,72,601
2025-04-11,1,3,SKU017,255,23,278
2025-04-11,2,1,SKU018,651,10,661
2025-04-11,2,3,SKU033,208,8,216
2025-04-11,3,1,SKU030,440,11,451
2025-04-11,3,2,SKU006,629,70,699
2025-04-11,3,3,SKU025,525,14,539
2025-04-11,4,1,SKU001,300,35,335
2025-04-11,4,2,SKU015,578,6,584
2025-04-11,4,3,SKU009,312,16,328
2025-04-11,5,1,SKU004,340,22,362
2025-04-11,5,2,SKU035,248,8,256
2025-04-11,5,3,SKU007,200,11,211
2025-04-11,6,2,SKU015,711,102,813
2025-04-11,6,3,SKU037,279,26,305
2025-04-11,7,1,SKU037,417,33,450
2025-04-11,7,2,SKU031,405,37,442
2025-04-11,7,3,SKU037,763,3,766
2025-04-11,8,1,SKU027,422,47,469
2025-04-11,8,3,SKU029,358,44,402
2025-04-11,9,1,SKU039,221,29,250
2025-04-11,9,2,SKU029,791,67,858
2025-04-11,9,3,SKU018,636,86,722
2025-04-11,10,1,SKU001,450,31,481
2025-04-11,10,2,SKU020,254,2,256
2025-04-11,11,1,SKU035,250,24,274
2025-04-11,11,2,SKU024,506,62,568
2025-04-11,11,3,SKU002,210,1,211
2025-04-11,12,2,SKU027,536,76,612
2025-04-11,12,3,SKU013,374,35,409
2025-04-11,13,1,SKU032,730,19,749
2025-04-11,13,2,SKU019,371,49,420
2025-04-11,13,3,SKU029,537,58,595
2025-04-11,14,1,SKU002,648,18,666
2025-04-11,14,2,SKU037,763,31,794
2025-04-11,15,2,SKU036,676,2,678
2025-04-11,15,3,SKU026,775,65,840
2025-04-12,1,1,SKU019,259,23,282
2025-04-12,1,2,SKU014,645,13,658
2025-04-12,1,3,SKU022,341,22,363
2025-04-12,2,2,SKU032,640,92,732
2025-04-12,2,3,SKU005,612,2,614
2025-04-12,3,1,SKU027,605,75,680
2025-04-12,3,3,SKU003,380,48,428
2025-04-12,4,1,SKU038,281,15,296
2025-04-12,4,2,SKU024,436,5,441
2025-04-12,4,3,SKU018,574,60,634
2025-04-12,5,1,SKU029,744,42,786
2025-04-12,5,3,SKU024,292,3,295
2025-04-12,6,2,SKU003,355,8,363
2025-04-12,6,3,SKU005,415,19,434
2025-04-12,7,2,SKU025,349,10,359
2025-04-12,7,3,SKU034,249,8,257
2025-04-12,8,1,SKU028,713,60,773
2025-04-12,8,2,SKU038,277,13,290
2025-04-12,8,3,SKU018,399,39,438
2025-04-12,9,1,SKU030,357,32,389
2025-04-12,9,2,SKU016,290,9,299
2025-04-12,9,3,SKU032,438,36,474
2025-04-12,10,1,SKU005,604,83,687
2025-04-12,10,2,SKU039,412,2,414
2025-04-12,10,3,SKU023,668,1,669
2025-04-12,11,1,SKU012,373,11,384
2025-04-12,11,2,SKU010,419,36,455
2025-04-12,11,3,SKU022,771,68,839
2025-04-12,12,1,SKU016,620,26,646
2025-04-12,12,2,SKU018,505,62,567
2025-04-12,12,3,SKU017,427,35,462
2025-04-12,13,2,SKU032,650,11,661
2025-04-12,14,1,SKU021,222,9,231
2025-04-12,14,3,SKU030,435,56,491
2025-04-12,15,1,SKU032,250,3,253
2025-04-12,15,2,SKU025,608,44,652
2025-04-12,15,3,SKU011,480,51,531
2025-04-13,1,2,SKU005,557,16,573
2025-04-13,1,3,SKU011,407,22,429
2025-04-13,2,1,SKU017,736,17,753
2025-04-13,2,2,SKU037,207,18,225
2025-04-13,2,3,SKU020,639,12,651
2025-04-13,3,1,SKU030,707,1,708
2025-04-13,3,3,SKU033,217,16,233
2025-04-13,4,1,SKU012,550,71,621
2025-04-13,4,3,SKU026,380,51,431
2025-04-13,5,3,SKU023,569,1,570
2025-04-13,6,1,SKU040,573,65,638
2025-04-13,6,2,SKU007,343,9,352
2025-04-13,6,3,SKU021,477,12,489
2025-04-13,7,1,SKU019,544,41,585
2025-04-13,7,2,SKU006,327,19,346
2025-04-13,7,3,SKU007,786,106,892
2025-04-13,8,1,SKU031,573,76,649
2025-04-13,8,2,SKU006,438,50,488
2025-04-13,8,3,SKU027,395,19,414
2025-04-13,9,1,SKU034,742,43,785
2025-04-13,9,2,SKU019,239,12,251
2025-04-13,9,3,SKU004,524,27,551
2025-04-13,10,1,SKU039,693,81,774
2025-04-13,10,2,SKU001,479,68,547
2025-04-13,10,3,SKU017,296,5,301
2025-04-13,11,1,SKU025,268,37,305
2025-04-13,11,2,SKU006,519,30,549
2025-04-13,11,3,SKU011,786,116,902
2025-04-13,12,1,SKU017,208,20,228
2025-04-13,12,2,SKU019,768,74,842
2025-04-13,12,3,SKU010,663,74,737
2025-04-13,13,1,SKU003,574,5,579
2025-04-13,13,3,SKU038,304,17,321
2025-04-13,14,2,SKU015,403,16,419
2025-04-13,14,3,SKU031,292,25,317
2025-04-13,15,2,SKU001,202,25,227
2025-04-13,15,3,SKU005,546,0,546
2025-04-14,1,1,SKU001,361,50,411
2025-04-14,1,2,SKU014,574,63,637
2025-04-14,1,3,SKU037,313,32,345
2025-04-14,2,1,SKU014,562,42,604
2025-04-14,2,2,SKU007,447,40,487
2025-04-14,2,3,SKU037,654,64,718
2025-04-14,3,1,SKU027,793,115,908
2025-04-14,3,3,SKU016,799,76,875
2025-04-14,4,1,SKU027,727,20,747
2025-04-14,4,3,SKU003,264,22,286
2025-04-14,5,1,SKU018,605,81,686
2025-04-14,5,2,SKU007,335,37,372
2025-04-14,5,3,SKU005,673,33,706
2025-04-14,6,1,SKU026,477,47,524
2025-04-14,6,2,SKU038,499,15,514
2025-04-14,6,3,SKU028,394,52,446
2025-04-14,7,1,SKU017,264,7,271
2025-04-14,7,3,SKU035,606,81,687
2025-04-14,8,1,SKU007,224,25,249
2025-04-14,8,2,SKU018,723,14,737
2025-04-14,8,3,SKU004,784,88,872
2025-04-14,9,2,SKU021,701,48,749
2025-04-14,9,3,SKU015,250,35,285
2025-04-14,10,1,SKU035,306,25,331
2025-04-14,10,3,SKU036,369,21,390
2025-04-14,11,1,SKU035,425,5,430
2025-04-14,11,2,SKU025,418,12,430
2025-04-14,11,3,SKU034,226,29,255
2025-04-14,12,1,SKU026,641,33,674
2025-04-14,12,3,SKU013,664,86,750
2025-04-14,13,2,SKU020,529,19,548
2025-04-14,14,1,SKU025,633,80,713
2025-04-14,14,2,SKU026,443,47,490
2025-04-14,14,3,SKU035,556,11,567
2025-04-14,15,1,SKU025,637,60,697
2025-04-14,15,2,SKU010,545,28,573
2025-04-14,15,3,SKU030,357,48,405
2025-04-15,1,1,SKU007,288,19,307
2025-04-15,1,2,SKU018,745,16,761
2025-04-15,1,3,SKU016,571,80,651
2025-04-15,2,1,SKU027,771,68,839
2025-04-15,2,2,SKU019,707,34,741
2025-04-15,3,1,SKU004,758,2,760
2025-04-15,3,2,SKU014,794,77,871
2025-04-15,3,3,SKU002,322,5,327
2025-04-15,4,1,SKU040,329,3,332
2025-04-15,4,2,SKU010,246,19,265
2025-04-15,4,3,SKU026,252,7,259
2025-04-15,5,1,SKU033,280,21,301
2025-04-15,5,2,SKU027,796,109,905
2025-04-15,5,3,SKU007,258,4,262
2025-04-15,6,1,SKU026,742,80,822
2025-04-15,6,2,SKU007,361,8,369
2025-04-15,7,1,SKU030,465,49,514
2025-04-15,7,2,SKU021,798,101,899
2025-04-15,7,3,SKU016,563,3,566
2025-04-15,8,1,SKU019,646,1,647
2025-04-15,8,3,SKU011,612,72,684
2025-04-15,9,1,SKU009,653,81,734
2025-04-15,9,2,SKU018,483,14,497
2025-04-15,9,3,SKU024,271,8,279
2025-04-15,10,2,SKU035,772,0,772
2025-04-15,11,1,SKU024,705,40,745
2025-04-15,11,2,SKU026,224,9,233
2025-04-15,11,3,SKU038,310,33,343
2025-04-15,12,2,SKU002,689,62,751
2025-04-15,12,3,SKU029,714,20,734
2025-04-15,13,1,SKU031,237,7,244
2025-04-15,13,2,SKU040,234,26,260
2025-04-15,13,3,SKU001,306,6,312
2025-04-15,14,1,SKU007,669,88,757
2025-04-15,14,2,SKU023,415,48,463
2025-04-15,14,3,SKU039,236,28,264
2025-04-15,15,1,SKU008,228,19,247
2025-04-15,15,2,SKU040,518,34,552
2025-04-15,15,3,SKU010,588,12,600
2025-04-16,1,2,SKU018,498,51,549
2025-04-16,1,3,SKU040,602,52,654
2025-04-16,2,1,SKU002,621,9,630
2025-04-16,2,2,SKU040,781,27,808
2025-04-16,2,3,SKU023,752,47,799
2025-04-16,3,1,SKU030,350,25,375
2025-04-16,3,3,SKU020,293,35,328
2025-04-16,4,2,SKU013,505,45,550
2025-04-16,4,3,SKU001,294,15,309
2025-04-16,5,1,SKU001,687,17,704
2025-04-16,5,2,SKU034,419,51,470
2025-04-16,6,1,SKU040,671,16,687
2025-04-16,6,2,SKU005,216,8,224
2025-04-16,6,3,SKU027,538,74,612
2025-04-16,7,1,SKU006,710,103,813
2025-04-16,7,2,SKU016,688,36,724
2025-04-16,7,3,SKU001,334,6,340
2025-04-16,8,1,SKU007,227,12,239
2025-04-16,8,2,SKU032,477,36,513
2025-04-16,8,3,SKU034,466,36,502
2025-04-16,9,1,SKU030,224,3,227
2025-04-16,9,2,SKU024,222,2,224
2025-04-16,9,3,SKU021,299,19,318
2025-04-16,10,1,SKU025,222,9,231
2025-04-16,10,2,SKU015,773,43,816
2025-04-16,10,3,SKU011,682,25,707
2025-04-16,11,1,SKU021,378,8,386
2025-04-16,11,3,SKU034,250,32,282
2025-04-16,12,1,SKU016,489,47,536
2025-04-16,12,2,SKU033,742,110,852
2025-04-16,12,3,SKU028,499,36,535
2025-04-16,13,2,SKU038,797,54,851
2025-04-16,13,3,SKU006,476,2,478
2025-04-16,14,1,SKU038,471,68,539
2025-04-16,14,2,SKU021,568,61,629
2025-04-16,14,3,SKU028,447,29,476
2025-04-16,15,1,SKU019,683,19,702
2025-04-16,15,2,SKU014,697,92,789
2025-04-16,15,3,SKU016,770,113,883
2025-04-17,1,1,SKU018,441,51,492
2025-04-17,1,2,SKU022,766,55,821
2025-04-17,2,1,SKU033,566,10,576
2025-04-17,2,2,SKU039,287,13,300
2025-04-17,3,1,SKU022,682,43,725
2025-04-17,3,2,SKU013,425,51,476
2025-04-17,3,3,SKU008,444,30,474
2025-04-17,4,2,SKU015,730,101,831
2025-04-17,4,3,SKU002,638,68,706
2025-04-17,5,1,SKU038,247,34,281
2025-04-17,5,2,SKU015,259,36,295
2025-04-17,5,3,SKU004,253,34,287
2025-04-17,6,1,SKU031,303,15,318
2025-04-17,6,2,SKU011,396,35,431
2025-04-17,7,1,SKU027,432,58,490
2025-04-17,7,2,SKU037,494,3,497
2025-04-17,7,3,SKU011,617,18,635
2025-04-17,8,1,SKU015,462,59,521
2025-04-17,8,2,SKU020,651,34,685
2025-04-17,8,3,SKU025,352,41,393
2025-04-17,9,1,SKU020,387,51,438
2025-04-17,9,2,SKU014,584,80,664
2025-04-17,9,3,SKU023,732,26,758
2025-04-17,10,1,SKU012,483,37,520
2025-04-17,10,2,SKU006,792,59,851
2025-04-17,10,3,SKU004,365,25,390
2025-04-17,11,1,SKU010,277,28,305
2025-04-17,11,2,SKU014,684,76,760
2025-04-17,11,3,SKU003,587,73,660
2025-04-17,12,1,SKU030,794,37,831
2025-04-17,12,2,SKU037,551,53,604
2025-04-17,12,3,SKU037,286,29,315
2025-04-17,13,1,SKU009,646,64,710
2025-04-17,13,2,SKU038,782,73,855
2025-04-17,13,3,SKU013,567,31,598
2025-04-17,14,1,SKU007,550,52,602
2025-04-17,14,2,SKU032,285,4,289
2025-04-17,14,3,SKU011,575,20,595
2025-04-17,15,2,SKU031,747,51,798
2025-04-17,15,3,SKU035,511,56,567
2025-04-18,1,1,SKU013,263,23,286
2025-04-18,1,2,SKU025,245,14,259
2025-04-18,1,3,SKU029,791,116,907
2025-04-18,2,1,SKU036,240,19,259
2025-04-18,2,3,SKU004,531,13,544
2025-04-18,3,1,SKU015,317,39,356
2025-04-18,3,2,SKU032,667,92,759
2025-04-18,3,3,SKU031,442,18,460
2025-04-18,4,1,SKU037,244,26,270
2025-04-18,4,2,SKU003,366,22,388
2025-04-18,4,3,SKU025,459,58,517
2025-04-18,5,1,SKU026,757,25,782
2025-04-18,5,2,SKU025,793,59,852
2025-04-18,5,3,SKU006,410,30,440
2025-04-18,6,1,SKU036,383,43,426
2025-04-18,6,2,SKU022,321,40,361
2025-04-18,6,3,SKU032,649,75,724
2025-04-18,7,1,SKU004,411,4,415
2025-04-18,7,3,SKU027,311,45,356
2025-04-18,8,1,SKU024,319,22,341
2025-04-18,8,3,SKU001,591,63,654
2025-04-18,9,1,SKU031,252,16,268
2025-04-18,9,2,SKU020,484,19,503
2025-04-18,10,1,SKU005,211,9,220
2025-04-18,10,3,SKU012,503,60,563
2025-04-18,11,1,SKU003,728,84,812
2025-04-18,11,2,SKU027,756,77,833
2025-04-18,11,3,SKU007,738,102,840
2025-04-18,12,1,SKU004,705,75,780
2025-04-18,12,2,SKU035,729,36,765
2025-04-18,12,3,SKU034,400,21,421
2025-04-18,13,1,SKU019,398,43,441
2025-04-18,13,2,SKU013,503,19,522
2025-04-18,13,3,SKU019,525,74,599
2025-04-18,14,1,SKU014,504,13,517
2025-04-18,14,2,SKU013,292,40,332
2025-04-18,15,1,SKU025,486,24,510
2025-04-18,15,2,SKU027,280,6,286
2025-04-18,15,3,SKU004,531,44,575
2025-04-19,1,1,SKU020,293,31,324
2025-04-19,1,2,SKU038,599,45,644
2025-04-19,1,3,SKU009,218,10,228
2025-04-19,2,1,SKU011,746,75,821
2025-04-19,2,2,SKU008,596,58,654
2025-04-19,2,3,SKU003,604,77,681
2025-04-19,3,1,SKU011,417,44,461
2025-04-19,3,2,SKU034,494,63,557
2025-04-19,3,3,SKU012,432,3,435
2025-04-19,4,1,SKU010,242,29,271
2025-04-19,4,2,SKU010,348,51,399
2025-04-19,4,3,SKU020,530,32,562
2025-04-19,5,1,SKU006,777,82,859
2025-04-19,5,2,SKU022,463,46,509
2025-04-19,5,3,SKU024,460,19,479
2025-04-19,6,1,SKU027,462,9,471
2025-04-19,6,2,SKU019,326,13,339
2025-04-19,6,3,SKU033,217,14,231
2025-04-19,7,1,SKU017,774,72,846
2025-04-19,7,2,SKU001,425,54,479
2025-04-19,7,3,SKU030,420,43,463
2025-04-19,8,1,SKU038,659,1,660
2025-04-19,8,3,SKU019,522,48,570
2025-04-19,9,1,SKU011,619,14,633
2025-04-19,9,2,SKU015,302,33,335
2025-04-19,9,3,SKU017,279,18,297
2025-04-19,10,1,SKU019,789,0,789
2025-04-19,10,2,SKU016,733,16,749
2025-04-19,10,3,SKU026,337,41,378
2025-04-19,11,1,SKU039,597,57,654
2025-04-19,11,2,SKU012,765,110,875
2025-04-19,11,3,SKU029,672,92,764
2025-04-19,12,1,SKU013,516,17,533
2025-04-19,12,2,SKU036,353,37,390
2025-04-19,12,3,SKU005,602,8,610
2025-04-19,13,2,SKU008,723,35,758
2025-04-19,13,3,SKU026,752,84,836
2025-04-19,14,1,SKU011,562,71,633
2025-04-19,14,2,SKU017,336,16,352
2025-04-19,14,3,SKU015,200,21,221
2025-04-19,15,1,SKU038,313,44,357
2025-04-19,15,2,SKU032,420,15,435
2025-04-19,15,3,SKU001,338,22,360
2025-04-20,1,1,SKU006,469,13,482
2025-04-20,1,2,SKU035,262,24,286
2025-04-20,2,1,SKU015,491,65,556
2025-04-20,2,2,SKU038,671,22,693
2025-04-20,3,2,SKU004,573,17,590
2025-04-20,3,3,SKU017,682,38,720
2025-04-20,4,1,SKU027,739,27,766
2025-04-20,4,2,SKU003,335,19,354
2025-04-20,4,3,SKU021,340,10,350
2025-04-20,5,1,SKU019,730,85,815
2025-04-20,5,2,SKU003,239,16,255
2025-04-20,5,3,SKU011,250,13,263
2025-04-20,6,1,SKU018,522,20,542
2025-04-20,6,2,SKU011,337,32,369
2025-04-20,7,1,SKU026,710,42,752
2025-04-20,7,2,SKU022,384,45,429
2025-04-20,7,3,SKU006,656,34,690
2025-04-20,8,1,SKU039,397,27,424
2025-04-20,8,2,SKU036,289,38,327
2025-04-20,8,3,SKU035,699,77,776
2025-04-20,9,1,SKU023,251,32,283
2025-04-20,9,2,SKU031,266,1,267
2025-04-20,9,3,SKU023,406,31,437
2025-04-20,10,1,SKU019,787,92,879
2025-04-20,10,2,SKU025,746,3,749
2025-04-20,10,3,SKU033,369,26,395
2025-04-20,11,1,SKU040,328,24,352
2025-04-20,11,2,SKU012,572,20,592
2025-04-20,11,3,SKU031,634,15,649
2025-04-20,12,1,SKU011,529,54,583
2025-04-20,12,2,SKU021,715,98,813
2025-04-20,12,3,SKU010,327,26,353
2025-04-20,13,1,SKU025,552,64,616
2025-04-20,13,2,SKU031,204,28,232
2025-04-20,13,3,SKU020,701,24,725
2025-04-20,14,1,SKU030,777,54,831
2025-04-20,14,2,SKU035,615,39,654
2025-04-20,15,1,SKU017,234,13,247
2025-04-20,15,2,SKU012,616,17,633
2025-04-20,15,3,SKU017,332,37,369
2025-04-21,1,1,SKU022,737,81,818
2025-04-21,1,2,SKU007,559,65,624
2025-04-21,1,3,SKU021,582,56,638
2025-04-21,2,1,SKU002,741,42,783
2025-04-21,2,2,SKU005,785,62,847
2025-04-21,2,3,SKU006,744,30,774
2025-04-21,3,1,SKU013,485,50,535
2025-04-21,3,2,SKU007,205,9,214
2025-04-21,3,3,SKU017,455,12,467
2025-04-21,4,1,SKU012,307,27,334
2025-04-21,4,2,SKU023,209,14,223
2025-04-21,4,3,SKU032,318,15,333
2025-04-21,5,2,SKU024,422,6,428
2025-04-21,5,3,SKU008,630,60,690
2025-04-21,6,1,SKU024,306,37,343
2025-04-21,6,3,SKU004,349,42,391
2025-04-21,7,1,SKU039,629,32,661
2025-04-21,7,2,SKU006,765,106,871
2025-04-21,7,3,SKU028,313,8,321
2025-04-21,8,2,SKU035,605,45,650
2025-04-21,8,3,SKU023,388,40,428
2025-04-21,9,1,SKU028,575,29,604
2025-04-21,9,2,SKU036,670,52,722
2025-04-21,9,3,SKU008,311,37,348
2025-04-21,10,1,SKU014,752,63,815
2025-04-21,10,2,SKU025,720,94,814
2025-04-21,10,3,SKU017,550,12,562
2025-04-21,11,2,SKU027,385,32,417
2025-04-21,12,1,SKU008,227,17,244
2025-04-21,12,2,SKU026,762,72,834
2025-04-21,12,3,SKU028,232,17,249
2025-04-21,13,2,SKU023,252,24,276
2025-04-21,13,3,SKU003,677,94,771
2025-04-21,14,1,SKU014,383,21,404
2025-04-21,14,2,SKU016,242,15,257
2025-04-21,14,3,SKU020,520,9,529
2025-04-21,15,2,SKU005,696,59,755
2025-04-21,15,3,SKU038,229,32,261
2025-04-22,1,1,SKU024,414,39,453
2025-04-22,1,3,SKU004,303,8,311
2025-04-22,2,1,SKU015,505,62,567
2025-04-22,2,2,SKU036,529,16,545
2025-04-22,2,3,SKU008,685,44,729
2025-04-22,3,1,SKU013,748,20,768
2025-04-22,3,2,SKU034,641,23,664
2025-04-22,3,3,SKU030,393,13,406
2025-04-22,4,1,SKU026,457,41,498
2025-04-22,4,2,SKU011,755,63,818
2025-04-22,4,3,SKU023,589,19,608
2025-04-22,5,1,SKU020,394,20,414
2025-04-22,5,3,SKU040,547,51,598
2025-04-22,6,1,SKU009,528,69,597
2025-04-22,6,2,SKU040,335,36,371
2025-04-22,6,3,SKU021,796,39,835
2025-04-22,7,1,SKU017,693,61,754
2025-04-22,7,2,SKU008,711,83,794
2025-04-22,7,3,SKU026,538,47,585
2025-04-22,8,1,SKU034,692,91,783
2025-04-22,8,2,SKU026,509,6,515
2025-04-22,8,3,SKU018,587,46,633
2025-04-22,9,1,SKU016,472,36,508
2025-04-22,9,2,SKU013,322,12,334
2025-04-22,9,3,SKU034,746,70,816
2025-04-22,10,1,SKU001,778,79,857
2025-04-22,10,2,SKU007,242,29,271
2025-04-22,10,3,SKU015,587,14,601
2025-04-22,11,2,SKU017,254,7,261
2025-04-22,11,3,SKU022,608,69,677
2025-04-22,12,1,SKU024,723,52,775
2025-04-22,12,2,SKU039,603,30,633
2025-04-22,13,1,SKU014,743,5,748
2025-04-22,13,2,SKU038,397,51,448
2025-04-22,14,1,SKU011,526,28,554
2025-04-22,14,2,SKU011,240,2,242
2025-04-22,14,3,SKU005,604,5,609
2025-04-22,15,1,SKU039,436,49,485
2025-04-22,15,2,SKU028,458,7,465
2025-04-22,15,3,SKU037,726,0,726
2025-04-23,1,2,SKU005,780,70,850
2025-04-23,1,3,SKU017,227,15,242
2025-04-23,2,3,SKU010,484,39,523
2025-04-23,3,1,SKU011,312,10,322
2025-04-23,3,2,SKU032,749,7,756
2025-04-23,3,3,SKU019,207,18,225
2025-04-23,4,1,SKU004,443,2,445
2025-04-23,4,2,SKU010,609,85,694
2025-04-23,4,3,SKU011,786,8,794
2025-04-23,5,1,SKU011,498,31,529
2025-04-23,5,2,SKU002,533,70,603
2025-04-23,5,3,SKU010,679,49,728
2025-04-23,6,2,SKU023,491,65,556
2025-04-23,7,2,SKU017,743,92,835
2025-04-23,7,3,SKU004,281,28,309
2025-04-23,8,1,SKU030,462,27,489
2025-04-23,8,2,SKU005,382,40,422
2025-04-23,8,3,SKU038,756,53,809
2025-04-23,9,1,SKU011,292,31,323
2025-04-23,9,3,SKU022,436,0,436
2025-04-23,10,1,SKU003,421,57,478
2025-04-23,10,3,SKU006,712,84,796
2025-04-23,11,1,SKU009,795,108,903
2025-04-23,11,2,SKU022,582,18,600
2025-04-23,11,3,SKU030,768,29,797
2025-04-23,12,1,SKU014,355,35,390
2025-04-23,12,2,SKU007,619,72,691
2025-04-23,12,3,SKU008,533,76,609
2025-04-23,13,1,SKU026,418,40,458
2025-04-23,13,2,SKU038,255,22,277
2025-04-23,13,3,SKU021,234,24,258
2025-04-23,14,2,SKU021,569,76,645
2025-04-23,14,3,SKU029,431,27,458
2025-04-23,15,1,SKU024,524,42,566
2025-04-23,15,2,SKU017,325,29,354
2025-04-23,15,3,SKU014,415,45,460
2025-04-24,1,1,SKU036,639,49,688
2025-04-24,1,2,SKU017,272,36,308
2025-04-24,1,3,SKU009,439,38,477
2025-04-24,2,1,SKU009,660,25,685
2025-04-24,2,2,SKU028,574,20,594
2025-04-24,2,3,SKU008,715,65,780
2025-04-24,3,1,SKU018,454,27,481
2025-04-24,3,2,SKU025,576,61,637
2025-04-24,4,1,SKU031,677,57,734
2025-04-24,4,2,SKU005,507,49,556
2025-04-24,5,1,SKU038,574,57,631
2025-04-24,5,2,SKU021,264,37,301
2025-04-24,5,3,SKU015,270,26,296
2025-04-24,6,1,SKU004,431,59,490
2025-04-24,6,2,SKU035,531,19,550
2025-04-24,6,3,SKU028,213,17,230
2025-04-24,7,1,SKU029,239,14,253
2025-04-24,7,2,SKU028,398,43,441
2025-04-24,7,3,SKU009,794,21,815
2025-04-24,8,1,SKU007,398,40,438
2025-04-24,8,2,SKU018,242,0,242
2025-04-24,8,3,SKU016,449,23,472
2025-04-24,9,1,SKU032,348,18,366
2025-04-24,9,2,SKU025,658,66,724
2025-04-24,9,3,SKU006,345,18,363
2025-04-24,10,1,SKU002,481,11,492
2025-04-24,10,2,SKU026,311,37,348
2025-04-24,10,3,SKU007,298,38,336
2025-04-24,11,1,SKU014,700,46,746
2025-04-24,11,2,SKU028,514,61,575
2025-04-24,11,3,SKU014,640,56,696
2025-04-24,12,1,SKU037,223,0,223
2025-04-24,12,2,SKU030,665,15,680
2025-04-24,12,3,SKU002,544,25,569
2025-04-24,13,1,SKU010,467,44,511
2025-04-24,13,2,SKU033,756,62,818
2025-04-24,13,3,SKU031,653,22,675
2025-04-24,14,1,SKU040,627,84,711
2025-04-24,14,2,SKU008,224,3,227
2025-04-24,15,1,SKU031,598,81,679
2025-04-24,15,2,SKU028,420,11,431
2025-04-24,15,3,SKU031,445,2,447
2025-04-25,1,1,SKU037,666,19,685
2025-04-25,1,2,SKU012,244,18,262
2025-04-25,1,3,SKU012,298,9,307
2025-04-25,2,1,SKU024,369,14,383
2025-04-25,2,2,SKU009,397,56,453
2025-04-25,2,3,SKU037,352,5,357
2025-04-25,3,1,SKU010,376,40,416
2025-04-25,3,2,SKU008,281,34,315
2025-04-25,3,3,SKU008,475,30,505
2025-04-25,4,1,SKU006,252,27,279
2025-04-25,4,2,SKU012,249,29,278
2025-04-25,4,3,SKU039,684,64,748
2025-04-25,5,1,SKU013,689,91,780
2025-04-25,5,2,SKU001,680,91,771
2025-04-25,5,3,SKU031,617,71,688
2025-04-25,6,1,SKU036,307,38,345
2025-04-25,6,3,SKU039,692,98,790
2025-04-25,7,1,SKU004,506,13,519
2025-04-25,7,3,SKU031,432,7,439
2025-04-25,8,1,SKU022,465,68,533
2025-04-25,8,2,SKU023,249,32,281
2025-04-25,8,3,SKU023,622,90,712
2025-04-25,9,1,SKU031,784,65,849
2025-04-25,9,2,SKU007,262,33,295
2025-04-25,9,3,SKU007,454,28,482
2025-04-25,10,1,SKU022,347,46,393
2025-04-25,10,2,SKU035,237,12,249
2025-04-25,10,3,SKU028,774,92,866
2025-04-25,11,2,SKU007,266,10,276
2025-04-25,11,3,SKU012,278,25,303
2025-04-25,12,1,SKU025,618,40,658
2025-04-25,12,2,SKU037,659,75,734
2025-04-25,12,3,SKU027,558,35,593
2025-04-25,13,1,SKU011,517,76,593
2025-04-25,13,2,SKU019,467,48,515
2025-04-25,13,3,SKU031,605,34,639
2025-04-25,14,1,SKU008,472,6,478
2025-04-25,14,3,SKU031,385,23,408
2025-04-25,15,1,SKU003,228,26,254
2025-04-25,15,3,SKU004,754,75,829
2025-04-26,1,1,SKU009,538,10,548
2025-04-26,1,2,SKU013,344,39,383
2025-04-26,1,3,SKU031,236,27,263
2025-04-26,2,1,SKU022,649,90,739
2025-04-26,2,2,SKU006,562,78,640
2025-04-26,2,3,SKU040,638,77,715
2025-04-26,3,1,SKU026,651,60,711
2025-04-26,3,2,SKU032,674,88,762
2025-04-26,4,1,SKU027,219,26,245
2025-04-26,4,2,SKU018,212,21,233
2025-04-26,5,1,SKU016,514,44,558
2025-04-26,5,2,SKU009,580,62,642
2025-04-26,5,3,SKU005,224,28,252
2025-04-26,6,1,SKU004,236,33,269
2025-04-26,6,2,SKU040,761,32,793
2025-04-26,6,3,SKU025,765,14,779
2025-04-26,7,1,SKU036,722,68,790
2025-04-26,7,2,SKU008,675,99,774
2025-04-26,7,3,SKU004,755,35,790
2025-04-26,8,1,SKU006,286,3,289
2025-04-26,8,2,SKU039,740,52,792
2025-04-26,8,3,SKU027,494,64,558
2025-04-26,9,1,SKU033,526,55,581
2025-04-26,9,2,SKU011,274,37,311
2025-04-26,9,3,SKU033,376,35,411
2025-04-26,10,2,SKU005,398,2,400
2025-04-26,10,3,SKU025,596,19,615
2025-04-26,11,2,SKU029,222,3,225
2025-04-26,11,3,SKU022,501,11,512
2025-04-26,12,1,SKU005,363,15,378
2025-04-26,12,2,SKU033,741,58,799
2025-04-26,12,3,SKU005,767,92,859
2025-04-26,13,1,SKU011,351,40,391
2025-04-26,13,2,SKU028,392,51,443
2025-04-26,13,3,SKU026,396,8,404
2025-04-26,14,1,SKU005,309,26,335
2025-04-26,14,2,SKU001,344,50,394
2025-04-26,14,3,SKU016,762,30,792
2025-04-26,15,2,SKU016,228,10,238
2025-04-26,15,3,SKU017,745,61,806
2025-04-27,1,1,SKU033,651,30,681
2025-04-27,1,3,SKU002,691,58,749
2025-04-27,2,2,SKU016,331,34,365
2025-04-27,2,3,SKU009,448,17,465
2025-04-27,3,1,SKU004,206,17,223
2025-04-27,3,2,SKU012,203,15,218
2025-04-27,3,3,SKU018,638,36,674
2025-04-27,4,1,SKU031,432,60,492
2025-04-27,4,2,SKU022,648,8,656
2025-04-27,4,3,SKU037,507,7,514
2025-04-27,5,1,SKU032,658,76,734
2025-04-27,5,2,SKU008,376,0,376
2025-04-27,5,3,SKU010,327,29,356
2025-04-27,6,3,SKU026,540,35,575
2025-04-27,7,1,SKU012,638,26,664
2025-04-27,7,3,SKU019,445,36,481
2025-04-27,8,1,SKU009,382,43,425
2025-04-27,8,2,SKU004,392,49,441
2025-04-27,9,2,SKU002,638,87,725
2025-04-27,9,3,SKU018,351,21,372
2025-04-27,10,1,SKU023,773,104,877
2025-04-27,10,3,SKU021,468,50,518
2025-04-27,11,3,SKU017,445,63,508
2025-04-27,12,1,SKU009,482,17,499
2025-04-27,12,3,SKU018,258,15,273
2025-04-27,13,1,SKU031,438,23,461
2025-04-27,13,2,SKU033,238,4,242
2025-04-27,13,3,SKU021,620,90,710
2025-04-27,14,1,SKU007,758,98,856
2025-04-27,14,2,SKU039,734,72,806
2025-04-27,14,3,SKU024,661,29,690
2025-04-27,15,1,SKU030,738,78,816
2025-04-27,15,2,SKU024,591,49,640
2025-04-27,15,3,SKU040,741,13,754
2025-04-28,1,1,SKU007,496,1,497
2025-04-28,1,2,SKU015,625,16,641
2025-04-28,2,1,SKU025,203,13,216
2025-04-28,2,2,SKU011,617,18,635
2025-04-28,3,1,SKU005,538,43,581
2025-04-28,3,2,SKU013,439,62,501
2025-04-28,3,3,SKU035,522,30,552
2025-04-28,4,1,SKU014,427,20,447
2025-04-28,4,2,SKU004,407,25,432
2025-04-28,4,3,SKU039,305,7,312
2025-04-28,5,1,SKU029,714,69,783
2025-04-28,5,2,SKU031,588,22,610
2025-04-28,5,3,SKU036,550,50,600
2025-04-28,6,1,SKU013,510,50,560
2025-04-28,6,2,SKU040,223,5,228
2025-04-28,6,3,SKU006,461,43,504
2025-04-28,7,1,SKU037,690,24,714
2025-04-28,7,3,SKU011,526,70,596
2025-04-28,8,1,SKU007,640,31,671
2025-04-28,8,2,SKU033,730,105,835
2025-04-28,8,3,SKU021,400,36,436
2025-04-28,9,1,SKU006,342,23,365
2025-04-28,9,2,SKU030,567,77,644
2025-04-28,9,3,SKU005,278,11,289
2025-04-28,10,1,SKU039,680,15,695
2025-04-28,10,2,SKU028,717,84,801
2025-04-28,10,3,SKU038,696,28,724
2025-04-28,11,1,SKU018,640,69,709
2025-04-28,11,2,SKU026,390,43,433
2025-04-28,12,1,SKU026,561,48,609
2025-04-28,12,2,SKU017,389,6,395
2025-04-28,13,1,SKU005,584,1,585
2025-04-28,13,2,SKU010,743,106,849
2025-04-28,13,3,SKU023,772,75,847
2025-04-28,14,1,SKU035,735,61,796
2025-04-28,14,2,SKU019,662,62,724
2025-04-28,14,3,SKU028,259,30,289
2025-04-28,15,1,SKU017,429,13,442
2025-04-28,15,2,SKU030,263,23,286
2025-04-28,15,3,SKU008,320,24,344
2025-04-29,1,1,SKU008,714,106,820
2025-04-29,1,3,SKU003,670,17,687
2025-04-29,2,1,SKU005,596,83,679
2025-04-29,2,2,SKU035,295,9,304
2025-04-29,2,3,SKU018,661,97,758
2025-04-29,3,1,SKU036,582,55,637
2025-04-29,3,2,SKU034,640,88,728
2025-04-29,3,3,SKU025,709,79,788
2025-04-29,4,1,SKU017,679,55,734
2025-04-29,4,2,SKU021,469,31,500
2025-04-29,4,3,SKU029,790,98,888
2025-04-29,5,1,SKU021,321,14,335
2025-04-29,5,2,SKU014,580,36,616
2025-04-29,5,3,SKU023,439,27,466
2025-04-29,6,1,SKU040,427,62,489
2025-04-29,6,2,SKU001,452,54,506
2025-04-29,6,3,SKU007,373,4,377
2025-04-29,7,1,SKU010,498,61,559
2025-04-29,7,2,SKU035,660,93,753
2025-04-29,7,3,SKU009,335,3,338
2025-04-29,8,2,SKU037,513,45,558
2025-04-29,8,3,SKU001,210,11,221
2025-04-29,9,1,SKU033,395,25,420
2025-04-29,9,2,SKU007,673,43,716
2025-04-29,9,3,SKU010,487,6,493
2025-04-29,10,2,SKU035,786,20,806
2025-04-29,10,3,SKU002,598,46,644
2025-04-29,11,1,SKU014,200,8,208
2025-04-29,11,2,SKU023,329,40,369
2025-04-29,11,3,SKU036,686,74,760
2025-04-29,12,2,SKU003,705,91,796
2025-04-29,13,1,SKU007,446,31,477
2025-04-29,13,2,SKU021,380,53,433
2025-04-29,13,3,SKU013,561,15,576
2025-04-29,14,1,SKU020,649,66,715
2025-04-29,14,2,SKU040,268,20,288
2025-04-29,14,3,SKU005,275,39,314
2025-04-29,15,1,SKU029,598,88,686
2025-04-29,15,3,SKU016,684,14,698
2025-04-30,1,1,SKU037,255,2,257
2025-04-30,1,2,SKU035,668,73,741
2025-04-30,2,1,SKU021,674,81,755
2025-04-30,2,2,SKU032,662,2,664
2025-04-30,2,3,SKU024,590,68,658
2025-04-30,3,2,SKU013,239,24,263
2025-04-30,3,3,SKU002,473,32,505
2025-04-30,4,2,SKU033,567,68,635
2025-04-30,5,1,SKU032,688,40,728
2025-04-30,5,2,SKU002,426,62,488
2025-04-30,5,3,SKU036,647,88,735
2025-04-30,6,1,SKU005,794,41,835
2025-04-30,6,2,SKU004,654,48,702
2025-04-30,6,3,SKU008,407,7,414
2025-04-30,7,1,SKU020,248,36,284
2025-04-30,7,2,SKU002,634,66,700
2025-04-30,7,3,SKU012,592,70,662
2025-04-30,8,1,SKU027,550,24,574
2025-04-30,8,2,SKU005,561,18,579
2025-04-30,8,3,SKU006,534,32,566
2025-04-30,9,1,SKU028,655,38,693
2025-04-30,9,2,SKU010,462,33,495
2025-04-30,9,3,SKU009,609,74,683
2025-04-30,10,3,SKU006,790,57,847
2025-04-30,11,1,SKU015,406,12,418
2025-04-30,11,2,SKU009,719,85,804
2025-04-30,11,3,SKU003,670,13,683
2025-04-30,12,1,SKU030,668,88,756
2025-04-30,12,2,SKU001,679,4,683
2025-04-30,13,1,SKU039,472,20,492
2025-04-30,13,2,SKU014,632,86,718
2025-04-30,13,3,SKU029,620,69,689
2025-04-30,14,1,SKU030,276,34,310
2025-04-30,14,3,SKU039,327,26,353
2025-04-30,15,1,SKU016,771,68,839
2025-04-30,15,2,SKU015,246,4,250
2025-04-30,15,3,SKU031,552,36,588
2025-05-01,1,2,SKU027,482,43,525
2025-05-01,1,3,SKU013,364,25,389
2025-05-01,2,1,SKU015,442,8,450
2025-05-01,2,2,SKU004,300,25,325
2025-05-01,2,3,SKU002,373,20,393
2025-05-01,3,1,SKU040,438,24,462
2025-05-01,3,3,SKU003,745,2,747
2025-05-01,4,1,SKU028,673,27,700
2025-05-01,4,3,SKU015,380,23,403
2025-05-01,5,1,SKU031,768,61,829
2025-05-01,5,2,SKU037,564,57,621
2025-05-01,5,3,SKU015,543,5,548
2025-05-01,6,1,SKU026,634,62,696
2025-05-01,6,2,SKU023,659,19,678
2025-05-01,6,3,SKU003,222,31,253
2025-05-01,7,1,SKU029,764,111,875
2025-05-01,7,2,SKU038,616,73,689
2025-05-01,7,3,SKU033,506,64,570
2025-05-01,8,1,SKU032,375,48,423
2025-05-01,8,2,SKU031,222,16,238
2025-05-01,8,3,SKU019,530,33,563
2025-05-01,9,1,SKU018,212,15,227
2025-05-01,9,3,SKU025,684,25,709
2025-05-01,10,1,SKU005,422,18,440
2025-05-01,10,2,SKU015,500,53,553
2025-05-01,10,3,SKU006,704,64,768
2025-05-01,11,1,SKU001,722,37,759
2025-05-01,11,2,SKU026,494,61,555
2025-05-01,11,3,SKU008,406,42,448
2025-05-01,12,2,SKU010,365,1,366
2025-05-01,12,3,SKU040,214,29,243
2025-05-01,13,1,SKU014,660,5,665
2025-05-01,13,2,SKU029,425,30,455
2025-05-01,13,3,SKU038,418,59,477
2025-05-01,14,1,SKU006,668,38,706
2025-05-01,14,3,SKU016,536,45,581
2025-05-01,15,1,SKU033,676,37,713
2025-05-01,15,2,SKU026,627,10,637
2025-05-01,15,3,SKU037,518,41,559
2025-05-02,1,1,SKU018,380,28,408
2025-05-02,1,2,SKU017,634,39,673
2025-05-02,1,3,SKU037,499,15,514
2025-05-02,2,1,SKU011,476,15,491
2025-05-02,2,2,SKU017,624,23,647
2025-05-02,3,1,SKU002,241,28,269
2025-05-02,3,2,SKU012,242,23,265
2025-05-02,3,3,SKU032,520,20,540
2025-05-02,4,1,SKU021,718,92,810
2025-05-02,4,2,SKU029,420,14,434
2025-05-02,4,3,SKU021,272,3,275
2025-05-02,5,1,SKU010,676,73,749
2025-05-02,5,2,SKU039,468,19,487
2025-05-02,5,3,SKU016,495,31,526
2025-05-02,6,1,SKU039,704,81,785
2025-05-02,6,2,SKU008,390,16,406
2025-05-02,6,3,SKU022,303,18,321
2025-05-02,7,1,SKU036,705,71,776
2025-05-02,7,2,SKU015,480,56,536
2025-05-02,7,3,SKU022,508,41,549
2025-05-02,8,1,SKU035,737,3,740
2025-05-02,8,2,SKU015,703,42,745
2025-05-02,8,3,SKU022,206,24,230
2025-05-02,9,2,SKU002,361,38,399
2025-05-02,9,3,SKU029,317,2,319
2025-05-02,10,1,SKU027,648,43,691
2025-05-02,10,2,SKU005,744,95,839
2025-05-02,10,3,SKU016,244,6,250
2025-05-02,11,1,SKU037,377,10,387
2025-05-02,11,2,SKU005,496,4,500
2025-05-02,11,3,SKU027,533,29,562
2025-05-02,12,1,SKU035,550,33,583
2025-05-02,12,3,SKU014,235,28,263
2025-05-02,13,1,SKU032,780,83,863
2025-05-02,13,2,SKU031,726,1,727
2025-05-02,13,3,SKU021,407,15,422
2025-05-02,14,2,SKU018,701,98,799
2025-05-02,14,3,SKU028,513,28,541
2025-05-02,15,1,SKU012,675,33,708
2025-05-03,1,1,SKU010,682,29,711
2025-05-03,1,2,SKU038,658,36,694
2025-05-03,1,3,SKU002,522,63,585
2025-05-03,2,1,SKU020,734,102,836
2025-05-03,2,2,SKU040,354,49,403
2025-05-03,3,1,SKU005,266,4,270
2025-05-03,3,2,SKU039,621,34,655
2025-05-03,3,3,SKU006,770,80,850
2025-05-03,4,1,SKU010,597,39,636
2025-05-03,4,2,SKU023,692,65,757
2025-05-03,4,3,SKU004,733,12,745
2025-05-03,5,1,SKU027,285,7,292
2025-05-03,5,2,SKU037,769,66,835
2025-05-03,5,3,SKU034,326,44,370
2025-05-03,7,1,SKU024,633,65,698
2025-05-03,7,2,SKU011,533,17,550
2025-05-03,7,3,SKU028,692,27,719
2025-05-03,8,1,SKU039,339,37,376
2025-05-03,8,2,SKU035,572,3,575
2025-05-03,8,3,SKU023,791,21,812
2025-05-03,9,1,SKU022,443,59,502
2025-05-03,9,2,SKU030,571,13,584
2025-05-03,9,3,SKU019,312,30,342
2025-05-03,10,1,SKU040,400,21,421
2025-05-03,10,3,SKU032,794,3,797
2025-05-03,11,1,SKU023,723,63,786
2025-05-03,11,2,SKU025,572,82,654
2025-05-03,12,1,SKU037,421,36,457
2025-05-03,12,2,SKU022,596,74,670
2025-05-03,13,1,SKU036,712,64,776
2025-05-03,13,2,SKU004,202,12,214
2025-05-03,13,3,SKU022,408,20,428
2025-05-03,14,1,SKU002,717,72,789
2025-05-03,14,2,SKU008,513,61,574
2025-05-03,14,3,SKU016,338,14,352
2025-05-03,15,1,SKU026,665,41,706
2025-05-03,15,2,SKU031,222,2,224
2025-05-03,15,3,SKU028,758,21,779
2025-05-04,1,1,SKU039,532,38,570
2025-05-04,1,2,SKU016,370,16,386
2025-05-04,1,3,SKU004,735,105,840
2025-05-04,2,1,SKU006,323,3,326
2025-05-04,2,2,SKU004,560,70,630
2025-05-04,2,3,SKU014,652,60,712
2025-05-04,3,1,SKU001,790,75,865
2025-05-04,3,2,SKU012,478,2,480
2025-05-04,3,3,SKU020,690,84,774
2025-05-04,4,1,SKU023,674,39,713
2025-05-04,4,2,SKU027,276,28,304
2025-05-04,4,3,SKU039,574,59,633
2025-05-04,5,1,SKU031,442,60,502
2025-05-04,5,2,SKU029,389,38,427
2025-05-04,6,1,SKU022,762,10,772
2025-05-04,6,2,SKU037,604,31,635
2025-05-04,6,3,SKU039,737,59,796
2025-05-04,7,1,SKU005,291,20,311
2025-05-04,7,2,SKU033,454,36,490
2025-05-04,7,3,SKU003,557,52,609
2025-05-04,8,1,SKU031,372,17,389
2025-05-04,8,2,SKU032,617,53,670
2025-05-04,9,1,SKU003,321,46,367
2025-05-04,9,3,SKU030,249,36,285
2025-05-04,10,1,SKU035,308,41,349
2025-05-04,10,3,SKU002,574,18,592
2025-05-04,11,2,SKU018,551,7,558
2025-05-04,11,3,SKU018,398,40,438
2025-05-04,12,1,SKU006,600,77,677
2025-05-04,12,2,SKU021,428,45,473
2025-05-04,12,3,SKU033,262,13,275
2025-05-04,13,1,SKU004,609,82,691
2025-05-04,13,2,SKU010,677,24,701
2025-05-04,13,3,SKU013,235,18,253
2025-05-04,14,1,SKU012,573,71,644
2025-05-04,14,2,SKU035,372,20,392
2025-05-04,14,3,SKU016,616,87,703
2025-05-04,15,1,SKU015,673,69,742
2025-05-04,15,2,SKU005,560,9,569
2025-05-04,15,3,SKU029,421,23,444
2025-05-05,1,1,SKU027,443,53,496
2025-05-05,1,3,SKU031,212,14,226
2025-05-05,2,1,SKU004,736,44,780
2025-05-05,2,2,SKU029,707,37,744
2025-05-05,2,3,SKU029,708,31,739
2025-05-05,3,1,SKU034,267,29,296
2025-05-05,3,2,SKU003,549,77,626
2025-05-05,3,3,SKU022,509,34,543
2025-05-05,4,3,SKU025,230,19,249
2025-05-05,5,1,SKU032,461,12,473
2025-05-05,5,2,SKU032,278,8,286
2025-05-05,5,3,SKU040,387,21,408
2025-05-05,6,1,SKU006,337,30,367
2025-05-05,6,2,SKU008,430,7,437
2025-05-05,6,3,SKU023,219,0,219
2025-05-05,7,1,SKU022,673,79,752
2025-05-05,7,2,SKU019,729,26,755
2025-05-05,7,3,SKU014,473,48,521
2025-05-05,8,1,SKU026,676,43,719
2025-05-05,8,2,SKU012,762,76,838
2025-05-05,8,3,SKU034,627,35,662
2025-05-05,9,1,SKU005,651,86,737
2025-05-05,9,2,SKU012,768,38,806
2025-05-05,9,3,SKU004,266,35,301
2025-05-05,10,1,SKU038,379,51,430
2025-05-05,10,2,SKU039,423,1,424
2025-05-05,10,3,SKU011,611,23,634
2025-05-05,11,1,SKU026,607,10,617
2025-05-05,11,2,SKU031,734,47,781
2025-05-05,11,3,SKU029,491,21,512
2025-05-05,12,1,SKU022,649,54,703
2025-05-05,12,2,SKU034,451,42,493
2025-05-05,12,3,SKU013,575,66,641
2025-05-05,13,1,SKU009,463,49,512
2025-05-05,13,2,SKU005,533,58,591
2025-05-05,13,3,SKU013,629,3,632
2025-05-05,14,1,SKU033,500,27,527
2025-05-05,14,2,SKU029,396,41,437
2025-05-05,14,3,SKU025,482,51,533
2025-05-05,15,1,SKU032,230,17,247
2025-05-05,15,2,SKU026,484,62,546
2025-05-05,15,3,SKU016,426,45,471
2025-05-06,1,1,SKU020,291,34,325
2025-05-06,1,2,SKU006,740,87,827
2025-05-06,2,1,SKU018,270,15,285
2025-05-06,2,3,SKU033,265,13,278
2025-05-06,3,1,SKU009,366,40,406
2025-05-06,3,2,SKU020,762,55,817
2025-05-06,4,1,SKU011,493,53,546
2025-05-06,4,2,SKU014,519,66,585
2025-05-06,4,3,SKU015,267,33,300
2025-05-06,5,1,SKU026,694,49,743
2025-05-06,5,2,SKU017,677,59,736
2025-05-06,6,1,SKU032,339,10,349
2025-05-06,6,3,SKU032,446,47,493
2025-05-06,7,1,SKU037,539,78,617
2025-05-06,7,2,SKU016,461,29,490
2025-05-06,7,3,SKU012,737,89,826
2025-05-06,8,1,SKU037,358,42,400
2025-05-06,8,2,SKU033,398,8,406
2025-05-06,8,3,SKU014,536,35,571
2025-05-06,9,1,SKU024,603,86,689
2025-05-06,9,2,SKU038,624,24,648
2025-05-06,9,3,SKU033,269,33,302
2025-05-06,10,1,SKU006,264,32,296
2025-05-06,10,2,SKU039,672,22,694
2025-05-06,10,3,SKU034,410,10,420
2025-05-06,11,1,SKU002,640,23,663
2025-05-06,11,3,SKU022,491,12,503
2025-05-06,12,1,SKU008,443,12,455
2025-05-06,12,2,SKU005,407,43,450
2025-05-06,12,3,SKU022,452,23,475
2025-05-06,13,1,SKU005,725,47,772
2025-05-06,13,2,SKU011,448,17,465
2025-05-06,13,3,SKU031,431,38,469
2025-05-06,14,1,SKU014,451,20,471
2025-05-06,14,2,SKU019,525,8,533
2025-05-06,14,3,SKU012,257,19,276
2025-05-06,15,1,SKU008,559,77,636
2025-05-06,15,3,SKU029,416,53,469
2025-05-07,1,1,SKU008,679,6,685
2025-05-07,1,2,SKU002,624,4,628
2025-05-07,2,1,SKU025,515,32,547
2025-05-07,2,2,SKU008,351,2,353
2025-05-07,3,1,SKU010,508,66,574
2025-05-07,3,2,SKU035,739,67,806
2025-05-07,3,3,SKU034,276,2,278
2025-05-07,4,1,SKU040,404,14,418
2025-05-07,4,2,SKU014,252,15,267
2025-05-07,4,3,SKU005,716,84,800
2025-05-07,5,1,SKU032,339,16,355
2025-05-07,5,3,SKU008,389,38,427
2025-05-07,6,1,SKU006,661,69,730
2025-05-07,6,3,SKU040,232,16,248
2025-05-07,7,1,SKU036,501,24,525
2025-05-07,7,2,SKU013,500,70,570
2025-05-07,7,3,SKU009,491,69,560
2025-05-07,8,1,SKU022,420,17,437
2025-05-07,8,2,SKU009,796,92,888
2025-05-07,9,1,SKU029,672,25,697
2025-05-07,9,2,SKU033,245,5,250
2025-05-07,9,3,SKU026,593,55,648
2025-05-07,10,1,SKU013,377,35,412
2025-05-07,10,2,SKU014,646,76,722
2025-05-07,10,3,SKU018,291,10,301
2025-05-07,11,1,SKU004,771,25,796
2025-05-07,11,2,SKU009,419,15,434
2025-05-07,11,3,SKU033,740,5,745
2025-05-07,12,1,SKU018,620,28,648
2025-05-07,12,2,SKU001,601,75,676
2025-05-07,12,3,SKU026,566,63,629
2025-05-07,13,1,SKU014,477,34,511
2025-05-07,13,2,SKU012,254,29,283
2025-05-07,13,3,SKU030,536,29,565
2025-05-07,14,2,SKU030,580,59,639
2025-05-07,14,3,SKU007,361,7,368
2025-05-07,15,1,SKU028,789,78,867
2025-05-07,15,2,SKU015,608,57,665
2025-05-07,15,3,SKU033,693,51,744
2025-05-08,1,2,SKU038,303,5,308
2025-05-08,1,3,SKU020,646,34,680
2025-05-08,2,2,SKU002,311,41,352
2025-05-08,2,3,SKU022,260,24,284
2025-05-08,3,1,SKU034,419,43,462
2025-05-08,3,2,SKU028,648,4,652
2025-05-08,3,3,SKU008,539,62,601
2025-05-08,4,1,SKU015,419,37,456
2025-05-08,4,2,SKU030,668,37,705
2025-05-08,4,3,SKU034,366,13,379
2025-05-08,5,1,SKU034,298,36,334
2025-05-08,5,2,SKU001,390,3,393
2025-05-08,5,3,SKU013,437,64,501
2025-05-08,6,2,SKU039,237,25,262
2025-05-08,6,3,SKU022,293,30,323
2025-05-08,7,1,SKU033,400,2,402
2025-05-08,7,2,SKU007,362,51,413
2025-05-08,7,3,SKU023,322,22,344
2025-05-08,8,1,SKU015,664,69,733
2025-05-08,8,2,SKU036,679,38,717
2025-05-08,9,1,SKU040,661,95,756
2025-05-08,9,2,SKU003,647,89,736
2025-05-08,9,3,SKU033,229,17,246
2025-05-08,10,2,SKU006,416,22,438
2025-05-08,11,1,SKU028,348,13,361
2025-05-08,11,3,SKU005,312,21,333
2025-05-08,12,1,SKU013,446,43,489
2025-05-08,12,3,SKU036,258,24,282
2025-05-08,13,1,SKU015,503,29,532
2025-05-08,13,2,SKU032,289,25,314
2025-05-08,13,3,SKU003,367,37,404
2025-05-08,14,1,SKU026,564,18,582
2025-05-08,14,2,SKU012,657,94,751
2025-05-08,14,3,SKU017,665,25,690
2025-05-08,15,1,SKU001,225,31,256
2025-05-08,15,2,SKU003,667,78,745
2025-05-08,15,3,SKU028,451,44,495
2025-05-09,1,1,SKU040,405,8,413
2025-05-09,1,2,SKU004,519,45,564
2025-05-09,1,3,SKU036,712,56,768
2025-05-09,2,1,SKU039,795,60,855
2025-05-09,2,2,SKU019,318,12,330
2025-05-09,2,3,SKU003,694,19,713
2025-05-09,3,1,SKU005,418,18,436
2025-05-09,3,2,SKU020,739,104,843
2025-05-09,3,3,SKU030,391,18,409
2025-05-09,4,1,SKU013,466,64,530
2025-05-09,4,3,SKU014,601,70,671
2025-05-09,5,1,SKU009,747,62,809
2025-05-09,5,3,SKU012,300,39,339
2025-05-09,6,1,SKU005,261,1,262
2025-05-09,6,3,SKU016,344,27,371
2025-05-09,7,1,SKU023,461,50,511
2025-05-09,7,2,SKU012,713,21,734
2025-05-09,7,3,SKU026,222,21,243
2025-05-09,8,2,SKU030,482,4,486
2025-05-09,8,3,SKU040,264,35,299
2025-05-09,9,1,SKU018,475,40,515
2025-05-09,9,2,SKU007,725,3,728
2025-05-09,9,3,SKU029,631,93,724
2025-05-09,10,1,SKU028,293,9,302
2025-05-09,10,2,SKU007,614,63,677
2025-05-09,10,3,SKU009,299,23,322
2025-05-09,11,1,SKU021,201,17,218
2025-05-09,11,3,SKU034,606,13,619
2025-05-09,12,1,SKU026,231,6,237
2025-05-09,12,2,SKU017,232,10,242
2025-05-09,12,3,SKU017,221,31,252
2025-05-09,13,1,SKU016,348,12,360
2025-05-09,13,2,SKU037,240,18,258
2025-05-09,14,1,SKU025,435,10,445
2025-05-09,14,2,SKU030,742,16,758
2025-05-09,14,3,SKU036,498,35,533
2025-05-09,15,1,SKU040,446,59,505
2025-05-09,15,2,SKU010,213,9,222
2025-05-09,15,3,SKU015,660,47,707
2025-05-10,1,1,SKU016,417,36,453
2025-05-10,1,2,SKU014,325,13,338
2025-05-10,1,3,SKU034,605,57,662
2025-05-10,2,2,SKU013,219,4,223
2025-05-10,2,3,SKU001,309,22,331
2025-05-10,3,1,SKU031,301,25,326
2025-05-10,3,2,SKU024,420,36,456
2025-05-10,3,3,SKU035,493,22,515
2025-05-10,4,1,SKU008,378,5,383
2025-05-10,4,2,SKU008,759,84,843
2025-05-10,4,3,SKU034,626,23,649
2025-05-10,5,1,SKU030,388,10,398
2025-05-10,5,2,SKU003,214,26,240
2025-05-10,5,3,SKU020,353,36,389
2025-05-10,6,1,SKU011,398,22,420
2025-05-10,6,2,SKU024,710,54,764
2025-05-10,6,3,SKU021,267,38,305
2025-05-10,7,1,SKU035,276,8,284
2025-05-10,7,2,SKU030,229,24,253
2025-05-10,7,3,SKU006,614,13,627
2025-05-10,8,1,SKU020,665,25,690
2025-05-10,8,3,SKU007,631,25,656
2025-05-10,9,1,SKU004,259,28,287
2025-05-10,9,2,SKU020,626,55,681
2025-05-10,10,1,SKU034,745,33,778
2025-05-10,10,2,SKU009,543,34,577
2025-05-10,10,3,SKU014,512,59,571
2025-05-10,11,1,SKU035,371,14,385
2025-05-10,11,2,SKU032,580,54,634
2025-05-10,11,3,SKU016,216,12,228
2025-05-10,12,3,SKU004,584,52,636
2025-05-10,13,1,SKU035,614,67,681
2025-05-10,13,2,SKU023,510,3,513
2025-05-10,13,3,SKU011,615,20,635
2025-05-10,14,1,SKU018,409,45,454
2025-05-10,14,2,SKU040,581,12,593
2025-05-10,14,3,SKU008,659,0,659
2025-05-10,15,1,SKU025,623,76,699
2025-05-10,15,2,SKU028,408,45,453
2025-05-10,15,3,SKU035,525,39,564
2025-05-11,1,1,SKU038,577,29,606
2025-05-11,1,2,SKU037,480,44,524
2025-05-11,1,3,SKU025,446,51,497
2025-05-11,2,1,SKU012,735,89,824
2025-05-11,2,2,SKU004,331,28,359
2025-05-11,2,3,SKU028,535,32,567
2025-05-11,3,1,SKU009,646,88,734
2025-05-11,3,2,SKU028,431,0,431
2025-05-11,3,3,SKU020,780,43,823
2025-05-11,4,1,SKU023,774,5,779
2025-05-11,4,2,SKU031,394,27,421
2025-05-11,4,3,SKU007,675,18,693
2025-05-11,5,2,SKU033,733,4,737
2025-05-11,5,3,SKU015,481,54,535
2025-05-11,6,1,SKU021,284,6,290
2025-05-11,6,2,SKU034,543,46,589
2025-05-11,6,3,SKU036,695,84,779
2025-05-11,7,1,SKU025,424,55,479
2025-05-11,7,2,SKU040,363,46,409
2025-05-11,7,3,SKU002,566,10,576
2025-05-11,8,1,SKU033,516,76,592
2025-05-11,8,2,SKU010,743,58,801
2025-05-11,8,3,SKU025,457,63,520
2025-05-11,9,1,SKU010,227,7,234
2025-05-11,9,2,SKU024,506,3,509
2025-05-11,9,3,SKU026,262,28,290
2025-05-11,10,1,SKU037,749,102,851
2025-05-11,10,2,SKU006,660,35,695
2025-05-11,10,3,SKU025,269,15,284
2025-05-11,11,1,SKU014,597,60,657
2025-05-11,11,2,SKU038,671,21,692
2025-05-11,11,3,SKU037,643,61,704
2025-05-11,12,2,SKU036,511,24,535
2025-05-11,12,3,SKU027,214,27,241
2025-05-11,13,1,SKU012,653,60,713
2025-05-11,13,2,SKU006,218,18,236
2025-05-11,13,3,SKU010,558,33,591
2025-05-11,14,2,SKU025,774,52,826
2025-05-11,15,1,SKU039,555,26,581
2025-05-11,15,3,SKU021,630,72,702
2025-05-12,1,1,SKU017,436,48,484
2025-05-12,1,2,SKU030,588,68,656
2025-05-12,2,1,SKU022,633,10,643
2025-05-12,2,2,SKU012,691,96,787
2025-05-12,2,3,SKU023,740,93,833
2025-05-12,3,2,SKU027,519,61,580
2025-05-12,3,3,SKU039,537,52,589
2025-05-12,4,1,SKU007,300,41,341
2025-05-12,4,2,SKU009,651,90,741
2025-05-12,4,3,SKU040,748,7,755
2025-05-12,5,1,SKU029,458,9,467
2025-05-12,5,2,SKU033,768,67,835
2025-05-12,5,3,SKU003,347,3,350
2025-05-12,6,1,SKU006,253,4,257
2025-05-12,6,2,SKU004,502,53,555
2025-05-12,6,3,SKU014,314,12,326
2025-05-12,7,1,SKU007,374,45,419
2025-05-12,7,2,SKU007,638,23,661
2025-05-12,7,3,SKU019,427,10,437
2025-05-12,8,1,SKU010,317,7,324
2025-05-12,9,1,SKU007,638,75,713
2025-05-12,9,2,SKU009,651,88,739
2025-05-12,9,3,SKU028,644,20,664
2025-05-12,10,1,SKU033,387,26,413
2025-05-12,10,2,SKU038,236,31,267
2025-05-12,10,3,SKU035,765,7,772
2025-05-12,11,1,SKU038,370,50,420
2025-05-12,11,2,SKU035,676,2,678
2025-05-12,12,2,SKU022,747,18,765
2025-05-12,12,3,SKU004,543,78,621
2025-05-12,13,2,SKU035,400,43,443
2025-05-12,13,3,SKU029,220,11,231
2025-05-12,14,2,SKU027,277,35,312
2025-05-12,14,3,SKU020,570,26,596
2025-05-12,15,1,SKU037,744,57,801
2025-05-12,15,2,SKU009,629,78,707
2025-05-12,15,3,SKU005,648,44,692
2025-05-13,1,1,SKU013,699,86,785
2025-05-13,1,2,SKU013,727,51,778
2025-05-13,1,3,SKU016,487,58,545
2025-05-13,2,1,SKU031,521,58,579
2025-05-13,2,2,SKU002,262,17,279
2025-05-13,2,3,SKU020,742,23,765
2025-05-13,3,1,SKU040,229,32,261
2025-05-13,3,2,SKU022,309,41,350
2025-05-13,3,3,SKU038,575,40,615
2025-05-13,4,1,SKU036,576,52,628
2025-05-13,4,2,SKU035,535,35,570
2025-05-13,4,3,SKU032,574,68,642
2025-05-13,5,1,SKU023,679,68,747
2025-05-13,5,2,SKU013,616,16,632
2025-05-13,5,3,SKU020,698,21,719
2025-05-13,6,1,SKU014,383,9,392
2025-05-13,6,2,SKU036,612,85,697
2025-05-13,6,3,SKU035,761,79,840
2025-05-13,7,2,SKU030,425,62,487
2025-05-13,7,3,SKU027,649,34,683
2025-05-13,8,1,SKU025,697,10,707
2025-05-13,8,2,SKU007,206,13,219
2025-05-13,8,3,SKU023,650,10,660
2025-05-13,9,1,SKU035,211,1,212
2025-05-13,9,2,SKU024,609,81,690
2025-05-13,9,3,SKU032,645,10,655
2025-05-13,10,1,SKU010,652,55,707
2025-05-13,10,2,SKU008,440,35,475
2025-05-13,10,3,SKU005,571,75,646
2025-05-13,11,1,SKU035,281,10,291
2025-05-13,11,2,SKU011,575,85,660
2025-05-13,11,3,SKU007,288,42,330
2025-05-13,12,1,SKU033,743,8,751
2025-05-13,12,2,SKU021,222,18,240
2025-05-13,12,3,SKU019,791,36,827
2025-05-13,13,1,SKU036,672,7,679
2025-05-13,13,2,SKU014,474,45,519
2025-05-13,13,3,SKU031,355,29,384
2025-05-13,14,1,SKU038,712,42,754
2025-05-13,14,2,SKU013,685,16,701
2025-05-13,15,1,SKU027,361,44,405
2025-05-13,15,2,SKU018,267,8,275
2025-05-13,15,3,SKU011,623,40,663
2025-05-14,1,1,SKU006,278,28,306
2025-05-14,1,2,SKU012,349,7,356
2025-05-14,1,3,SKU001,712,81,793
2025-05-14,2,1,SKU011,712,88,800
2025-05-14,2,2,SKU033,576,28,604
2025-05-14,2,3,SKU018,214,11,225
2025-05-14,3,1,SKU027,618,82,700
2025-05-14,3,2,SKU005,276,27,303
2025-05-14,3,3,SKU040,564,64,628
2025-05-14,4,1,SKU027,395,7,402
2025-05-14,4,2,SKU015,373,50,423
2025-05-14,4,3,SKU021,624,89,713
2025-05-14,5,1,SKU007,795,70,865
2025-05-14,5,2,SKU032,401,33,434
2025-05-14,5,3,SKU013,207,13,220
2025-05-14,6,1,SKU020,593,15,608
2025-05-14,6,2,SKU006,531,59,590
2025-05-14,7,1,SKU027,642,80,722
2025-05-14,7,2,SKU033,207,3,210
2025-05-14,8,1,SKU015,755,75,830
2025-05-14,8,2,SKU006,774,73,847
2025-05-14,8,3,SKU022,498,3,501
2025-05-14,9,1,SKU021,306,24,330
2025-05-14,9,3,SKU038,394,36,430
2025-05-14,10,1,SKU038,686,72,758
2025-05-14,10,2,SKU018,514,32,546
2025-05-14,10,3,SKU018,272,37,309
2025-05-14,11,1,SKU039,342,17,359
2025-05-14,11,2,SKU013,328,23,351
2025-05-14,12,1,SKU021,673,33,706
2025-05-14,12,2,SKU021,449,40,489
2025-05-14,12,3,SKU017,730,78,808
2025-05-14,13,1,SKU022,216,9,225
2025-05-14,13,2,SKU038,424,27,451
2025-05-14,13,3,SKU007,744,43,787
2025-05-14,14,1,SKU002,588,59,647
2025-05-14,14,2,SKU038,441,4,445
2025-05-14,14,3,SKU022,754,50,804
2025-05-14,15,2,SKU015,474,22,496
2025-05-14,15,3,SKU037,584,78,662
2025-05-15,1,1,SKU030,283,8,291
2025-05-15,1,2,SKU028,492,34,526
2025-05-15,1,3,SKU020,781,42,823
2025-05-15,2,1,SKU028,426,40,466
2025-05-15,2,2,SKU018,289,18,307
2025-05-15,2,3,SKU016,302,5,307
2025-05-15,3,1,SKU007,222,21,243
2025-05-15,3,2,SKU008,503,40,543
2025-05-15,3,3,SKU014,265,5,270
2025-05-15,4,1,SKU040,578,58,636
2025-05-15,4,2,SKU022,637,5,642
2025-05-15,4,3,SKU008,300,16,316
2025-05-15,5,1,SKU034,375,36,411
2025-05-15,5,2,SKU034,431,56,487
2025-05-15,6,2,SKU006,539,1,540
2025-05-15,6,3,SKU025,544,61,605
2025-05-15,7,1,SKU023,321,8,329
2025-05-15,7,2,SKU014,753,107,860
2025-05-15,7,3,SKU026,728,6,734
2025-05-15,8,1,SKU003,691,30,721
2025-05-15,8,3,SKU011,257,26,283
2025-05-15,9,1,SKU016,580,64,644
2025-05-15,9,2,SKU039,637,33,670
2025-05-15,9,3,SKU007,250,32,282
2025-05-15,10,1,SKU035,346,14,360
2025-05-15,10,2,SKU015,222,17,239
2025-05-15,10,3,SKU022,557,50,607
2025-05-15,11,1,SKU001,495,29,524
2025-05-15,11,2,SKU039,572,64,636
2025-05-15,11,3,SKU008,674,76,750
2025-05-15,12,1,SKU017,768,101,869
2025-05-15,12,2,SKU010,360,6,366
2025-05-15,13,2,SKU033,360,35,395
2025-05-15,13,3,SKU015,305,12,317
2025-05-15,14,1,SKU009,744,35,779
2025-05-15,14,2,SKU006,241,34,275
2025-05-15,15,1,SKU020,259,23,282
2025-05-15,15,2,SKU026,277,40,317
2025-05-15,15,3,SKU016,485,27,512
2025-05-16,1,2,SKU021,714,4,718
2025-05-16,1,3,SKU027,500,73,573
2025-05-16,2,1,SKU006,441,38,479
2025-05-16,2,2,SKU008,547,28,575
2025-05-16,2,3,SKU001,611,3,614
2025-05-16,3,1,SKU008,290,38,328
2025-05-16,3,2,SKU017,464,58,522
2025-05-16,4,1,SKU025,520,39,559
2025-05-16,4,2,SKU033,205,0,205
2025-05-16,5,1,SKU024,457,35,492
2025-05-16,5,3,SKU011,225,8,233
2025-05-16,6,2,SKU030,710,48,758
2025-05-16,7,1,SKU038,602,22,624
2025-05-16,7,2,SKU037,429,36,465
2025-05-16,7,3,SKU014,491,65,556
2025-05-16,8,1,SKU021,403,56,459
2025-05-16,8,2,SKU008,657,62,719
2025-05-16,8,3,SKU028,687,20,707
2025-05-16,9,1,SKU004,270,11,281
2025-05-16,9,2,SKU026,515,48,563
2025-05-16,10,2,SKU028,281,18,299
2025-05-16,10,3,SKU020,200,23,223
2025-05-16,11,1,SKU004,714,34,748
2025-05-16,11,2,SKU022,203,25,228
2025-05-16,11,3,SKU038,468,11,479
2025-05-16,12,1,SKU036,546,29,575
2025-05-16,12,3,SKU029,254,0,254
2025-05-16,13,1,SKU037,444,25,469
2025-05-16,13,2,SKU011,504,47,551
2025-05-16,13,3,SKU028,232,1,233
2025-05-16,14,1,SKU002,616,63,679
2025-05-16,14,2,SKU006,530,42,572
2025-05-16,14,3,SKU016,552,81,633
2025-05-16,15,1,SKU002,323,17,340
2025-05-16,15,2,SKU030,781,80,861
2025-05-16,15,3,SKU015,206,4,210
2025-05-17,1,1,SKU008,713,40,753
2025-05-17,1,3,SKU026,487,19,506
2025-05-17,2,1,SKU017,475,15,490
2025-05-17,2,3,SKU010,364,31,395
2025-05-17,3,1,SKU038,356,42,398
2025-05-17,3,2,SKU002,419,50,469
2025-05-17,3,3,SKU014,390,15,405
2025-05-17,4,1,SKU002,478,65,543
2025-05-17,4,2,SKU018,428,25,453
2025-05-17,4,3,SKU034,651,13,664
2025-05-17,5,1,SKU006,591,55,646
2025-05-17,5,2,SKU005,230,15,245
2025-05-17,5,3,SKU013,341,34,375
2025-05-17,6,1,SKU014,585,20,605
2025-05-17,6,3,SKU036,305,39,344
2025-05-17,7,1,SKU028,202,4,206
2025-05-17,7,3,SKU032,293,32,325
2025-05-17,8,1,SKU040,749,108,857
2025-05-17,8,2,SKU019,452,60,512
2025-05-17,8,3,SKU032,524,18,542
2025-05-17,9,1,SKU005,460,36,496
2025-05-17,9,3,SKU026,203,18,221
2025-05-17,10,1,SKU010,466,4,470
2025-05-17,10,2,SKU011,334,23,357
2025-05-17,10,3,SKU034,503,10,513
2025-05-17,11,1,SKU013,545,69,614
2025-05-17,11,2,SKU025,778,65,843
2025-05-17,11,3,SKU024,556,44,600
2025-05-17,12,1,SKU025,481,10,491
2025-05-17,12,2,SKU016,576,9,585
2025-05-17,12,3,SKU031,738,83,821
2025-05-17,13,1,SKU038,577,68,645
2025-05-17,13,2,SKU032,445,48,493
2025-05-17,13,3,SKU002,480,61,541
2025-05-17,14,1,SKU011,448,39,487
2025-05-17,14,2,SKU018,515,25,540
2025-05-17,14,3,SKU030,547,77,624
2025-05-17,15,2,SKU040,742,91,833
2025-05-18,1,1,SKU036,417,58,475
2025-05-18,1,3,SKU034,272,31,303
2025-05-18,2,2,SKU023,361,27,388
2025-05-18,3,1,SKU037,694,20,714
2025-05-18,3,2,SKU025,223,16,239
2025-05-18,3,3,SKU002,273,38,311
2025-05-18,4,1,SKU014,661,65,726
2025-05-18,4,2,SKU035,736,50,786
2025-05-18,5,1,SKU014,278,38,316
2025-05-18,5,3,SKU016,519,22,541
2025-05-18,6,1,SKU003,276,27,303
2025-05-18,6,2,SKU037,458,12,470
2025-05-18,6,3,SKU020,448,13,461
2025-05-18,7,1,SKU023,630,56,686
2025-05-18,7,3,SKU016,338,25,363
2025-05-18,8,1,SKU032,405,12,417
2025-05-18,8,2,SKU022,354,32,386
2025-05-18,8,3,SKU008,596,21,617
2025-05-18,9,2,SKU025,690,0,690
2025-05-18,9,3,SKU020,497,49,546
2025-05-18,10,1,SKU022,446,48,494
2025-05-18,10,3,SKU037,576,67,643
2025-05-18,11,1,SKU012,684,97,781
2025-05-18,11,2,SKU002,323,34,357
2025-05-18,11,3,SKU021,525,74,599
2025-05-18,12,3,SKU013,470,45,515
2025-05-18,13,2,SKU012,566,59,625
2025-05-18,13,3,SKU007,749,52,801
2025-05-18,14,1,SKU022,458,0,458
2025-05-18,14,2,SKU032,593,65,658
2025-05-18,14,3,SKU015,628,12,640
2025-05-18,15,1,SKU030,542,7,549
2025-05-18,15,3,SKU027,712,16,728
2025-05-19,1,1,SKU037,779,83,862
2025-05-19,1,2,SKU012,363,43,406
2025-05-19,1,3,SKU007,223,19,242
2025-05-19,2,1,SKU019,715,57,772
2025-05-19,2,2,SKU029,778,58,836
2025-05-19,2,3,SKU021,638,72,710
2025-05-19,3,1,SKU017,215,28,243
2025-05-19,4,2,SKU025,512,67,579
2025-05-19,4,3,SKU031,370,1,371
2025-05-19,5,1,SKU034,708,82,790
2025-05-19,5,2,SKU028,744,6,750
2025-05-19,5,3,SKU035,715,17,732
2025-05-19,6,1,SKU019,247,16,263
2025-05-19,6,2,SKU013,309,45,354
2025-05-19,7,1,SKU005,482,37,519
2025-05-19,7,2,SKU033,568,44,612
2025-05-19,8,2,SKU002,692,43,735
2025-05-19,8,3,SKU018,668,30,698
2025-05-19,9,2,SKU007,299,32,331
2025-05-19,9,3,SKU039,365,49,414
2025-05-19,10,1,SKU022,236,6,242
2025-05-19,10,2,SKU037,302,42,344
2025-05-19,10,3,SKU025,700,66,766
2025-05-19,11,1,SKU013,543,66,609
2025-05-19,11,2,SKU027,754,61,815
2025-05-19,11,3,SKU037,702,98,800
2025-05-19,12,1,SKU035,746,36,782
2025-05-19,12,2,SKU006,612,13,625
2025-05-19,12,3,SKU030,593,3,596
2025-05-19,13,1,SKU039,675,98,773
2025-05-19,13,2,SKU008,571,57,628
2025-05-19,13,3,SKU016,602,86,688
2025-05-19,14,3,SKU009,649,29,678
2025-05-19,15,1,SKU022,444,37,481
2025-05-19,15,2,SKU040,366,1,367
2025-05-19,15,3,SKU011,337,17,354
2025-05-20,1,1,SKU011,506,19,525
2025-05-20,1,2,SKU038,728,23,751
2025-05-20,2,3,SKU037,622,44,666
2025-05-20,3,1,SKU014,683,38,721
2025-05-20,3,2,SKU020,781,50,831
2025-05-20,3,3,SKU035,349,25,374
2025-05-20,4,1,SKU032,595,50,645
2025-05-20,4,2,SKU018,678,26,704
2025-05-20,4,3,SKU033,371,53,424
2025-05-20,5,1,SKU017,474,64,538
2025-05-20,5,2,SKU038,290,5,295
2025-05-20,5,3,SKU005,467,65,532
2025-05-20,6,1,SKU018,542,78,620
2025-05-20,6,2,SKU020,528,55,583
2025-05-20,6,3,SKU005,691,90,781
2025-05-20,7,1,SKU009,470,10,480
2025-05-20,7,2,SKU004,407,41,448
2025-05-20,7,3,SKU023,697,4,701
2025-05-20,8,1,SKU026,301,20,321
2025-05-20,8,3,SKU007,363,13,376
2025-05-20,9,1,SKU036,789,113,902
2025-05-20,9,2,SKU035,272,26,298
2025-05-20,9,3,SKU003,464,60,524
2025-05-20,10,1,SKU008,268,38,306
2025-05-20,10,2,SKU013,298,41,339
2025-05-20,10,3,SKU019,302,7,309
2025-05-20,11,1,SKU032,575,56,631
2025-05-20,11,2,SKU029,262,34,296
2025-05-20,12,1,SKU018,788,99,887
2025-05-20,12,2,SKU040,352,20,372
2025-05-20,12,3,SKU017,480,70,550
2025-05-20,13,1,SKU004,636,75,711
2025-05-20,13,2,SKU032,599,81,680
2025-05-20,13,3,SKU028,445,0,445
2025-05-20,14,1,SKU021,648,96,744
2025-05-20,15,1,SKU015,779,113,892
2025-05-20,15,2,SKU040,488,5,493
2025-05-20,15,3,SKU038,212,15,227
2025-05-21,1,1,SKU036,433,57,490
2025-05-21,1,2,SKU018,546,74,620
2025-05-21,1,3,SKU006,287,16,303
2025-05-21,2,1,SKU028,744,80,824
2025-05-21,2,2,SKU033,692,47,739
2025-05-21,2,3,SKU013,574,53,627
2025-05-21,3,1,SKU018,556,39,595
2025-05-21,3,2,SKU025,710,90,800
2025-05-21,3,3,SKU038,211,10,221
2025-05-21,4,1,SKU038,414,2,416
2025-05-21,4,2,SKU006,552,19,571
2025-05-21,4,3,SKU006,235,20,255
2025-05-21,5,1,SKU016,320,23,343
2025-05-21,5,2,SKU001,558,20,578
2025-05-21,5,3,SKU029,323,14,337
2025-05-21,6,1,SKU014,394,23,417
2025-05-21,6,2,SKU002,379,2,381
2025-05-21,7,1,SKU016,314,6,320
2025-05-21,7,2,SKU010,537,3,540
2025-05-21,7,3,SKU004,353,19,372
2025-05-21,8,2,SKU019,524,67,591
2025-05-21,8,3,SKU003,521,14,535
2025-05-21,9,3,SKU033,576,68,644
2025-05-21,10,1,SKU031,392,54,446
2025-05-21,10,2,SKU001,747,5,752
2025-05-21,10,3,SKU001,668,61,729
2025-05-21,11,1,SKU013,308,3,311
2025-05-21,11,3,SKU014,431,18,449
2025-05-21,12,1,SKU007,792,5,797
2025-05-21,12,2,SKU014,220,4,224
2025-05-21,13,1,SKU009,645,5,650
2025-05-21,13,2,SKU003,366,31,397
2025-05-21,13,3,SKU022,580,66,646
2025-05-21,14,1,SKU017,731,45,776
2025-05-21,14,2,SKU014,389,2,391
2025-05-21,15,1,SKU006,254,14,268
2025-05-21,15,2,SKU038,299,26,325
2025-05-21,15,3,SKU032,463,57,520
2025-05-22,1,1,SKU025,214,10,224
2025-05-22,1,2,SKU021,675,46,721
2025-05-22,2,1,SKU012,694,34,728
2025-05-22,2,2,SKU032,452,54,506
2025-05-22,3,1,SKU022,309,37,346
2025-05-22,3,2,SKU021,208,15,223
2025-05-22,3,3,SKU034,392,16,408
2025-05-22,4,2,SKU007,406,1,407
2025-05-22,4,3,SKU011,799,81,880
2025-05-22,5,2,SKU001,595,3,598
2025-05-22,6,1,SKU001,783,3,786
2025-05-22,6,2,SKU011,333,48,381
2025-05-22,6,3,SKU040,692,64,756
2025-05-22,7,1,SKU034,572,10,582
2025-05-22,7,2,SKU040,294,7,301
2025-05-22,7,3,SKU015,469,62,531
2025-05-22,8,1,SKU018,529,30,559
2025-05-22,8,2,SKU027,699,59,758
2025-05-22,8,3,SKU027,790,75,865
2025-05-22,9,1,SKU018,384,19,403
2025-05-22,9,2,SKU037,389,43,432
2025-05-22,9,3,SKU017,560,61,621
2025-05-22,10,1,SKU037,594,30,624
2025-05-22,10,2,SKU006,793,25,818
2025-05-22,10,3,SKU034,738,36,774
2025-05-22,11,2,SKU012,386,41,427
2025-05-22,11,3,SKU010,599,6,605
2025-05-22,12,1,SKU006,411,59,470
2025-05-22,12,2,SKU034,470,49,519
2025-05-22,13,1,SKU040,445,56,501
2025-05-22,13,2,SKU033,287,7,294
2025-05-22,13,3,SKU021,496,51,547
2025-05-22,14,1,SKU032,495,47,542
2025-05-22,14,2,SKU031,751,106,857
2025-05-22,14,3,SKU017,642,26,668
2025-05-22,15,1,SKU027,346,48,394
2025-05-22,15,2,SKU027,583,16,599
2025-05-22,15,3,SKU040,736,73,809
2025-05-23,1,1,SKU037,703,58,761
2025-05-23,1,2,SKU027,670,5,675
2025-05-23,2,1,SKU025,275,36,311
2025-05-23,2,2,SKU035,541,49,590
2025-05-23,2,3,SKU008,756,16,772
2025-05-23,3,1,SKU013,340,34,374
2025-05-23,3,2,SKU007,631,41,672
2025-05-23,3,3,SKU028,753,91,844
2025-05-23,4,1,SKU016,308,24,332
2025-05-23,4,2,SKU021,791,59,850
2025-05-23,4,3,SKU032,791,12,803
2025-05-23,5,1,SKU034,660,85,745
2025-05-23,5,2,SKU004,518,16,534
2025-05-23,5,3,SKU025,578,21,599
2025-05-23,6,1,SKU040,354,15,369
2025-05-23,6,2,SKU037,247,18,265
2025-05-23,6,3,SKU016,711,64,775
2025-05-23,7,1,SKU017,365,9,374
2025-05-23,7,2,SKU028,665,60,725
2025-05-23,7,3,SKU015,286,14,300
2025-05-23,8,2,SKU005,478,14,492
2025-05-23,8,3,SKU038,754,110,864
2025-05-23,9,1,SKU028,337,36,373
2025-05-23,9,2,SKU019,563,19,582
2025-05-23,9,3,SKU028,277,20,297
2025-05-23,10,1,SKU018,417,10,427
2025-05-23,10,2,SKU029,288,25,313
2025-05-23,10,3,SKU020,305,32,337
2025-05-23,11,1,SKU023,303,22,325
2025-05-23,11,2,SKU040,318,22,340
2025-05-23,11,3,SKU007,655,75,730
2025-05-23,12,1,SKU032,211,14,225
2025-05-23,12,2,SKU014,693,49,742
2025-05-23,12,3,SKU038,548,52,600
2025-05-23,13,1,SKU014,403,11,414
2025-05-23,13,2,SKU008,465,42,507
2025-05-23,13,3,SKU017,704,61,765
2025-05-23,14,1,SKU031,374,28,402
2025-05-23,14,2,SKU003,743,105,848
2025-05-23,14,3,SKU029,416,9,425
2025-05-23,15,3,SKU017,447,21,468
2025-05-24,1,1,SKU031,585,22,607
2025-05-24,1,2,SKU013,786,78,864
2025-05-24,1,3,SKU018,239,3,242
2025-05-24,2,1,SKU039,591,56,647
2025-05-24,2,2,SKU015,550,23,573
2025-05-24,2,3,SKU034,498,2,500
2025-05-24,3,1,SKU038,288,20,308
2025-05-24,3,3,SKU031,481,26,507
2025-05-24,4,1,SKU015,340,15,355
2025-05-24,4,2,SKU026,269,19,288
2025-05-24,4,3,SKU005,528,43,571
2025-05-24,5,1,SKU021,581,73,654
2025-05-24,5,2,SKU008,344,6,350
2025-05-24,6,1,SKU039,579,74,653
2025-05-24,6,2,SKU020,723,89,812
2025-05-24,6,3,SKU001,536,51,587
2025-05-24,7,1,SKU031,440,25,465
2025-05-24,7,2,SKU040,726,98,824
2025-05-24,7,3,SKU016,377,47,424
2025-05-24,8,1,SKU029,557,22,579
2025-05-24,8,2,SKU010,795,37,832
2025-05-24,9,1,SKU036,738,32,770
2025-05-24,9,2,SKU010,239,0,239
2025-05-24,9,3,SKU028,376,47,423
2025-05-24,10,1,SKU011,406,34,440
2025-05-24,10,2,SKU033,731,68,799
2025-05-24,10,3,SKU008,426,57,483
2025-05-24,11,1,SKU024,532,22,554
2025-05-24,11,2,SKU018,686,74,760
2025-05-24,11,3,SKU005,359,0,359
2025-05-24,12,2,SKU026,419,30,449
2025-05-24,12,3,SKU034,732,4,736
2025-05-24,13,1,SKU003,401,5,406
2025-05-24,13,2,SKU008,559,15,574
2025-05-24,13,3,SKU005,300,11,311
2025-05-24,14,1,SKU021,402,40,442
2025-05-24,14,3,SKU038,323,1,324
2025-05-24,15,1,SKU035,471,41,512
2025-05-24,15,2,SKU002,407,36,443
2025-05-24,15,3,SKU027,289,35,324
2025-05-25,1,1,SKU039,402,14,416
2025-05-25,1,3,SKU006,525,35,560
2025-05-25,2,1,SKU015,204,21,225
2025-05-25,3,1,SKU022,696,18,714
2025-05-25,3,2,SKU037,384,35,419
2025-05-25,3,3,SKU002,679,26,705
2025-05-25,4,1,SKU030,492,63,555
2025-05-25,4,2,SKU036,376,23,399
2025-05-25,4,3,SKU018,389,4,393
2025-05-25,5,1,SKU033,237,24,261
2025-05-25,5,2,SKU006,713,14,727
2025-05-25,5,3,SKU003,361,14,375
2025-05-25,6,1,SKU025,275,19,294
2025-05-25,6,3,SKU024,727,24,751
2025-05-25,7,1,SKU002,552,16,568
2025-05-25,7,2,SKU002,648,81,729
2025-05-25,7,3,SKU033,353,8,361
2025-05-25,8,1,SKU011,612,9,621
2025-05-25,8,2,SKU019,418,31,449
2025-05-25,9,1,SKU035,557,49,606
2025-05-25,9,2,SKU035,773,85,858
2025-05-25,9,3,SKU040,349,11,360
2025-05-25,10,1,SKU014,388,57,445
2025-05-25,11,1,SKU012,730,38,768
2025-05-25,11,2,SKU020,733,71,804
2025-05-25,11,3,SKU009,400,25,425
2025-05-25,12,1,SKU015,296,38,334
2025-05-25,12,2,SKU032,776,44,820
2025-05-25,12,3,SKU011,673,99,772
2025-05-25,13,1,SKU012,737,44,781
2025-05-25,13,2,SKU038,657,17,674
2025-05-25,13,3,SKU022,591,27,618
2025-05-25,14,1,SKU013,573,29,602
2025-05-25,14,2,SKU027,390,43,433
2025-05-25,14,3,SKU032,443,52,495
2025-05-25,15,1,SKU036,764,108,872
2025-05-25,15,2,SKU010,576,38,614
2025-05-25,15,3,SKU028,299,40,339
2025-05-26,1,1,SKU010,474,60,534
2025-05-26,1,2,SKU020,403,6,409
2025-05-26,1,3,SKU005,528,8,536
2025-05-26,2,1,SKU030,743,97,840
2025-05-26,2,2,SKU021,718,80,798
2025-05-26,2,3,SKU024,643,24,667
2025-05-26,3,1,SKU033,445,14,459
2025-05-26,3,2,SKU029,740,12,752
2025-05-26,4,1,SKU029,225,13,238
2025-05-26,4,2,SKU001,551,50,601
2025-05-26,4,3,SKU020,567,80,647
2025-05-26,5,1,SKU018,631,58,689
2025-05-26,5,2,SKU025,365,41,406
2025-05-26,5,3,SKU007,522,71,593
2025-05-26,6,1,SKU004,238,9,247
2025-05-26,6,2,SKU019,226,27,253
2025-05-26,6,3,SKU012,642,16,658
2025-05-26,7,1,SKU025,407,47,454
2025-05-26,7,2,SKU011,509,46,555
2025-05-26,7,3,SKU014,434,52,486
2025-05-26,8,1,SKU008,753,11,764
2025-05-26,8,2,SKU010,323,30,353
2025-05-26,8,3,SKU030,564,76,640
2025-05-26,9,1,SKU013,586,25,611
2025-05-26,9,2,SKU004,763,73,836
2025-05-26,9,3,SKU036,717,82,799
2025-05-26,10,2,SKU040,723,74,797
2025-05-26,10,3,SKU003,786,19,805
2025-05-26,11,1,SKU039,693,23,716
2025-05-26,11,2,SKU022,610,44,654
2025-05-26,11,3,SKU033,373,43,416
2025-05-26,12,1,SKU040,591,22,613
2025-05-26,12,2,SKU005,603,42,645
2025-05-26,12,3,SKU030,265,30,295
2025-05-26,13,1,SKU020,607,43,650
2025-05-26,13,3,SKU020,728,20,748
2025-05-26,14,1,SKU034,479,51,530
2025-05-26,14,2,SKU023,654,71,725
2025-05-26,14,3,SKU011,278,26,304
2025-05-26,15,1,SKU036,503,50,553
2025-05-26,15,2,SKU017,587,6,593
2025-05-26,15,3,SKU004,472,50,522
2025-05-27,1,1,SKU037,441,20,461
2025-05-27,1,2,SKU009,685,15,700
2025-05-27,1,3,SKU038,507,46,553
2025-05-27,2,1,SKU031,244,5,249
2025-05-27,2,2,SKU024,562,53,615
2025-05-27,2,3,SKU021,426,40,466
2025-05-27,3,1,SKU007,527,12,539
2025-05-27,3,2,SKU019,623,4,627
2025-05-27,4,2,SKU002,435,53,488
2025-05-27,4,3,SKU019,625,14,639
2025-05-27,5,1,SKU017,577,17,594
2025-05-27,5,2,SKU037,603,68,671
2025-05-27,5,3,SKU039,407,0,407
2025-05-27,6,1,SKU027,226,28,254
2025-05-27,6,2,SKU012,722,59,781
2025-05-27,6,3,SKU009,420,50,470
2025-05-27,7,1,SKU037,653,22,675
2025-05-27,7,2,SKU039,431,44,475
2025-05-27,7,3,SKU008,373,29,402
2025-05-27,8,1,SKU006,379,9,388
2025-05-27,8,2,SKU005,673,16,689
2025-05-27,8,3,SKU020,423,6,429
2025-05-27,9,1,SKU002,377,40,417
2025-05-27,9,2,SKU009,659,31,690
2025-05-27,9,3,SKU017,249,30,279
2025-05-27,10,1,SKU013,214,31,245
2025-05-27,10,3,SKU015,404,24,428
2025-05-27,11,1,SKU004,200,18,218
2025-05-27,11,2,SKU024,471,63,534
2025-05-27,11,3,SKU015,599,0,599
2025-05-27,12,1,SKU004,779,24,803
2025-05-27,12,2,SKU012,244,21,265
2025-05-27,12,3,SKU016,384,17,401
2025-05-27,13,1,SKU006,784,3,787
2025-05-27,13,2,SKU017,570,58,628
2025-05-27,13,3,SKU035,607,67,674
2025-05-27,14,1,SKU013,711,45,756
2025-05-27,14,2,SKU001,435,43,478
2025-05-27,14,3,SKU037,588,19,607
2025-05-27,15,2,SKU029,796,26,822
2025-05-27,15,3,SKU040,221,10,231
2025-05-28,1,1,SKU023,469,34,503
2025-05-28,1,2,SKU029,507,52,559
2025-05-28,1,3,SKU031,525,38,563
2025-05-28,2,1,SKU032,378,36,414
2025-05-28,2,2,SKU032,549,75,624
2025-05-28,3,2,SKU033,679,10,689
2025-05-28,3,3,SKU024,292,1,293
2025-05-28,4,1,SKU029,460,52,512
2025-05-28,4,2,SKU010,670,56,726
2025-05-28,4,3,SKU017,297,26,323
2025-05-28,5,1,SKU023,234,7,241
2025-05-28,5,2,SKU017,343,48,391
2025-05-28,5,3,SKU009,481,37,518
2025-05-28,6,1,SKU024,488,68,556
2025-05-28,6,2,SKU012,452,57,509
2025-05-28,6,3,SKU034,744,75,819
2025-05-28,7,1,SKU021,758,50,808
2025-05-28,7,2,SKU003,380,15,395
2025-05-28,8,1,SKU040,439,28,467
2025-05-28,8,2,SKU019,558,27,585
2025-05-28,8,3,SKU039,261,6,267
2025-05-28,9,1,SKU031,339,23,362
2025-05-28,9,2,SKU015,747,31,778
2025-05-28,9,3,SKU011,260,11,271
2025-05-28,10,3,SKU014,255,6,261
2025-05-28,11,1,SKU035,586,68,654
2025-05-28,11,2,SKU009,777,51,828
2025-05-28,11,3,SKU015,723,10,733
2025-05-28,12,2,SKU022,283,31,314
2025-05-28,12,3,SKU017,552,47,599
2025-05-28,13,1,SKU033,343,24,367
2025-05-28,13,2,SKU004,768,78,846
2025-05-28,13,3,SKU033,776,15,791
2025-05-28,14,1,SKU005,708,5,713
2025-05-28,14,3,SKU023,437,10,447
2025-05-28,15,1,SKU024,735,71,806
2025-05-28,15,2,SKU031,359,0,359
2025-05-28,15,3,SKU030,204,14,218
2025-05-29,1,1,SKU038,444,38,482
2025-05-29,1,3,SKU025,460,52,512
2025-05-29,2,1,SKU019,460,24,484
2025-05-29,2,2,SKU009,578,65,643
2025-05-29,2,3,SKU008,538,0,538
2025-05-29,3,1,SKU030,677,83,760
2025-05-29,3,2,SKU006,245,11,256
2025-05-29,3,3,SKU034,504,61,565
2025-05-29,4,1,SKU002,203,2,205
2025-05-29,4,2,SKU007,673,64,737
2025-05-29,4,3,SKU013,418,6,424
2025-05-29,5,1,SKU026,317,40,357
2025-05-29,5,2,SKU032,276,28,304
2025-05-29,5,3,SKU017,442,16,458
2025-05-29,6,1,SKU038,253,22,275
2025-05-29,6,2,SKU035,571,70,641
2025-05-29,6,3,SKU036,516,42,558
2025-05-29,7,1,SKU028,716,2,718
2025-05-29,7,2,SKU010,280,37,317
2025-05-29,7,3,SKU010,744,13,757
2025-05-29,8,1,SKU021,572,13,585
2025-05-29,8,3,SKU015,632,85,717
2025-05-29,9,1,SKU008,481,45,526
2025-05-29,9,2,SKU038,726,15,741
2025-05-29,9,3,SKU002,638,38,676
2025-05-29,10,1,SKU012,608,73,681
2025-05-29,10,3,SKU015,406,43,449
2025-05-29,11,1,SKU021,594,78,672
2025-05-29,11,2,SKU013,359,18,377
2025-05-29,12,1,SKU001,372,51,423
2025-05-29,12,3,SKU038,337,36,373
2025-05-29,13,1,SKU029,408,3,411
2025-05-29,13,2,SKU015,540,61,601
2025-05-29,13,3,SKU032,270,37,307
2025-05-29,14,1,SKU033,639,85,724
2025-05-29,14,2,SKU029,645,49,694
2025-05-29,14,3,SKU011,407,1,408
2025-05-29,15,2,SKU010,208,28,236
2025-05-29,15,3,SKU028,234,4,238
2025-05-30,1,1,SKU030,486,46,532
2025-05-30,1,2,SKU001,540,6,546
2025-05-30,2,1,SKU007,261,33,294
2025-05-30,2,3,SKU026,296,6,302
2025-05-30,3,1,SKU017,435,18,453
2025-05-30,3,2,SKU026,770,84,854
2025-05-30,3,3,SKU025,322,4,326
2025-05-30,4,1,SKU032,684,97,781
2025-05-30,4,3,SKU008,679,13,692
2025-05-30,5,1,SKU010,311,28,339
2025-05-30,5,2,SKU036,414,5,419
2025-05-30,5,3,SKU009,211,16,227
2025-05-30,6,1,SKU005,742,82,824
2025-05-30,6,2,SKU003,699,93,792
2025-05-30,6,3,SKU007,323,21,344
2025-05-30,7,2,SKU037,523,46,569
2025-05-30,7,3,SKU004,743,39,782
2025-05-30,8,1,SKU001,537,24,561
2025-05-30,8,2,SKU010,439,62,501
2025-05-30,8,3,SKU004,439,32,471
2025-05-30,9,1,SKU034,517,44,561
2025-05-30,9,2,SKU036,352,24,376
2025-05-30,9,3,SKU040,255,10,265
2025-05-30,10,2,SKU026,653,52,705
2025-05-30,10,3,SKU010,559,70,629
2025-05-30,11,1,SKU023,778,16,794
2025-05-30,11,2,SKU017,782,89,871
2025-05-30,11,3,SKU035,573,38,611
2025-05-30,12,1,SKU025,258,6,264
2025-05-30,12,2,SKU015,421,60,481
2025-05-30,12,3,SKU026,497,38,535
2025-05-30,13,1,SKU040,692,52,744
2025-05-30,13,2,SKU003,563,55,618
2025-05-30,13,3,SKU027,746,93,839
2025-05-30,14,1,SKU016,347,24,371
2025-05-30,14,2,SKU015,433,60,493
2025-05-30,14,3,SKU028,292,34,326
2025-05-30,15,1,SKU032,639,76,715
2025-05-30,15,2,SKU005,559,42,601
2025-05-30,15,3,SKU030,515,5,520
2025-05-31,1,1,SKU036,448,38,486
2025-05-31,1,3,SKU009,407,8,415
2025-05-31,2,1,SKU035,285,32,317
2025-05-31,2,2,SKU031,789,65,854
2025-05-31,2,3,SKU002,710,97,807
2025-05-31,3,1,SKU004,326,10,336
2025-05-31,3,2,SKU029,745,63,808
2025-05-31,3,3,SKU006,218,30,248
2025-05-31,4,1,SKU037,532,76,608
2025-05-31,4,2,SKU025,362,15,377
2025-05-31,4,3,SKU003,297,34,331
2025-05-31,5,2,SKU006,362,17,379
2025-05-31,6,1,SKU010,319,25,344
2025-05-31,6,3,SKU031,520,14,534
2025-05-31,7,1,SKU031,263,29,292
2025-05-31,7,2,SKU020,622,7,629
2025-05-31,7,3,SKU007,403,30,433
2025-05-31,8,1,SKU027,333,39,372
2025-05-31,8,2,SKU036,400,39,439
2025-05-31,9,1,SKU018,591,25,616
2025-05-31,9,2,SKU012,200,17,217
2025-05-31,9,3,SKU021,559,55,614
2025-05-31,10,1,SKU016,516,71,587
2025-05-31,10,2,SKU016,614,21,635
2025-05-31,10,3,SKU001,508,40,548
2025-05-31,11,1,SKU019,330,33,363
2025-05-31,11,2,SKU007,676,88,764
2025-05-31,11,3,SKU007,395,0,395
2025-05-31,12,1,SKU034,697,85,782
2025-05-31,12,2,SKU015,295,31,326
2025-05-31,12,3,SKU018,589,27,616
2025-05-31,13,1,SKU017,662,36,698
2025-05-31,13,2,SKU023,617,65,682
2025-05-31,13,3,SKU024,243,23,266
2025-05-31,14,1,SKU033,557,45,602
2025-05-31,14,2,SKU039,536,49,585
2025-05-31,14,3,SKU012,652,62,714
2025-05-31,15,1,SKU004,645,11,656
2025-05-31,15,2,SKU013,630,84,714
2025-05-31,15,3,SKU023,359,25,384
2025-06-01,1,1,SKU028,237,30,267
2025-06-01,1,2,SKU007,210,6,216
2025-06-01,1,3,SKU032,235,9,244
2025-06-01,2,1,SKU003,460,65,525
2025-06-01,2,2,SKU037,466,49,515
2025-06-01,2,3,SKU008,521,12,533
2025-06-01,3,1,SKU009,447,20,467
2025-06-01,3,2,SKU025,630,73,703
2025-06-01,3,3,SKU005,292,41,333
2025-06-01,4,1,SKU011,212,14,226
2025-06-01,4,2,SKU035,550,31,581
2025-06-01,4,3,SKU031,764,49,813
2025-06-01,5,2,SKU036,767,111,878
2025-06-01,5,3,SKU032,392,53,445
2025-06-01,6,1,SKU027,426,51,477
2025-06-01,6,2,SKU027,423,29,452
2025-06-01,6,3,SKU026,682,51,733
2025-06-01,7,2,SKU012,701,18,719
2025-06-01,7,3,SKU029,790,25,815
2025-06-01,8,1,SKU018,413,43,456
2025-06-01,8,2,SKU026,591,67,658
2025-06-01,9,3,SKU026,686,35,721
2025-06-01,10,1,SKU010,648,77,725
2025-06-01,10,3,SKU034,324,7,331
2025-06-01,11,2,SKU019,469,3,472
2025-06-01,11,3,SKU025,772,65,837
2025-06-01,12,1,SKU007,328,46,374
2025-06-01,12,2,SKU019,700,60,760
2025-06-01,13,1,SKU026,471,20,491
2025-06-01,13,2,SKU010,400,28,428
2025-06-01,13,3,SKU015,279,3,282
2025-06-01,14,1,SKU003,601,27,628
2025-06-01,14,2,SKU021,616,56,672
2025-06-01,14,3,SKU033,397,40,437
2025-06-01,15,1,SKU025,279,30,309
2025-06-01,15,2,SKU016,787,29,816
2025-06-02,1,1,SKU040,458,50,508
2025-06-02,1,2,SKU021,794,54,848
2025-06-02,1,3,SKU023,383,7,390
2025-06-02,2,1,SKU016,608,62,670
2025-06-02,2,2,SKU015,606,72,678
2025-06-02,2,3,SKU033,653,80,733
2025-06-02,3,1,SKU016,656,64,720
2025-06-02,3,2,SKU018,605,6,611
2025-06-02,3,3,SKU028,456,16,472
2025-06-02,4,1,SKU023,345,50,395
2025-06-02,4,2,SKU018,723,49,772
2025-06-02,5,1,SKU018,677,54,731
2025-06-02,5,2,SKU039,631,20,651
2025-06-02,5,3,SKU010,228,0,228
2025-06-02,6,1,SKU017,512,24,536
2025-06-02,6,2,SKU038,322,46,368
2025-06-02,6,3,SKU033,213,0,213
2025-06-02,7,1,SKU031,420,43,463
2025-06-02,7,2,SKU008,781,48,829
2025-06-02,7,3,SKU025,568,25,593
2025-06-02,8,1,SKU039,317,1,318
2025-06-02,8,2,SKU033,653,28,681
2025-06-02,8,3,SKU008,368,6,374
2025-06-02,9,2,SKU028,375,45,420
2025-06-02,9,3,SKU036,387,34,421
2025-06-02,10,2,SKU008,204,28,232
2025-06-02,10,3,SKU037,435,47,482
2025-06-02,11,1,SKU016,377,8,385
2025-06-02,11,2,SKU017,627,79,706
2025-06-02,11,3,SKU010,581,13,594
2025-06-02,12,1,SKU006,381,1,382
2025-06-02,12,2,SKU017,450,40,490
2025-06-02,12,3,SKU029,289,21,310
2025-06-02,13,1,SKU001,287,8,295
2025-06-02,13,2,SKU016,527,78,605
2025-06-02,13,3,SKU002,386,17,403
2025-06-02,14,1,SKU035,264,1,265
2025-06-02,14,2,SKU012,584,60,644
2025-06-02,14,3,SKU005,492,70,562
2025-06-02,15,1,SKU005,472,49,521
2025-06-02,15,2,SKU033,535,67,602
2025-06-02,15,3,SKU020,705,11,716
2025-06-03,1,1,SKU007,391,32,423
2025-06-03,1,2,SKU024,297,24,321
2025-06-03,1,3,SKU032,321,36,357
2025-06-03,2,1,SKU031,414,60,474
2025-06-03,2,2,SKU022,439,50,489
2025-06-03,2,3,SKU010,571,83,654
2025-06-03,3,1,SKU011,733,43,776
2025-06-03,3,3,SKU005,245,18,263
2025-06-03,4,1,SKU026,214,10,224
2025-06-03,4,2,SKU001,620,8,628
2025-06-03,4,3,SKU035,485,35,520
2025-06-03,5,1,SKU002,686,70,756
2025-06-03,5,2,SKU040,313,20,333
2025-06-03,5,3,SKU023,371,41,412
2025-06-03,6,1,SKU016,690,17,707
2025-06-03,6,2,SKU016,236,24,260
2025-06-03,6,3,SKU012,368,49,417
2025-06-03,7,1,SKU020,619,3,622
2025-06-03,7,3,SKU010,656,4,660
2025-06-03,8,2,SKU033,324,32,356
2025-06-03,8,3,SKU019,586,34,620
2025-06-03,9,1,SKU026,590,21,611
2025-06-03,9,3,SKU001,433,37,470
2025-06-03,10,1,SKU018,782,92,874
2025-06-03,10,2,SKU003,441,39,480
2025-06-03,10,3,SKU019,290,27,317
2025-06-03,11,1,SKU034,426,21,447
2025-06-03,11,2,SKU007,444,64,508
2025-06-03,11,3,SKU007,703,4,707
2025-06-03,12,1,SKU029,550,31,581
2025-06-03,12,2,SKU004,202,14,216
2025-06-03,12,3,SKU026,326,4,330
2025-06-03,13,1,SKU002,784,74,858
2025-06-03,13,2,SKU002,540,22,562
2025-06-03,13,3,SKU035,223,19,242
2025-06-03,14,1,SKU037,286,4,290
2025-06-03,14,2,SKU035,709,89,798
2025-06-03,15,1,SKU022,723,80,803
2025-06-03,15,2,SKU037,428,56,484
2025-06-03,15,3,SKU024,202,1,203
2025-06-04,2,1,SKU022,541,8,549
2025-06-04,2,2,SKU032,378,44,422
2025-06-04,2,3,SKU025,217,17,234
2025-06-04,3,1,SKU011,479,6,485
2025-06-04,3,2,SKU026,474,2,476
2025-06-04,3,3,SKU029,394,14,408
2025-06-04,4,1,SKU026,669,71,740
2025-06-04,4,2,SKU013,288,41,329
2025-06-04,4,3,SKU035,548,57,605
2025-06-04,5,1,SKU035,558,67,625
2025-06-04,5,2,SKU010,615,7,622
2025-06-04,6,1,SKU037,573,62,635
2025-06-04,6,2,SKU019,461,30,491
2025-06-04,6,3,SKU010,436,36,472
2025-06-04,7,1,SKU001,682,81,763
2025-06-04,7,2,SKU016,252,16,268
2025-06-04,7,3,SKU002,559,51,610
2025-06-04,8,1,SKU008,347,7,354
2025-06-04,8,2,SKU035,624,76,700
2025-06-04,8,3,SKU029,685,71,756
2025-06-04,9,1,SKU012,462,9,471
2025-06-04,9,2,SKU018,587,47,634
2025-06-04,9,3,SKU028,644,61,705
2025-06-04,10,2,SKU008,367,30,397
2025-06-04,10,3,SKU028,206,19,225
2025-06-04,11,1,SKU029,761,46,807
2025-06-04,11,2,SKU007,770,15,785
2025-06-04,12,2,SKU038,574,43,617
2025-06-04,12,3,SKU007,258,5,263
2025-06-04,13,1,SKU013,257,7,264
2025-06-04,13,2,SKU001,301,19,320
2025-06-04,13,3,SKU034,234,4,238
2025-06-04,14,1,SKU031,749,105,854
2025-06-04,14,2,SKU034,769,1,770
2025-06-04,14,3,SKU027,758,46,804
2025-06-04,15,1,SKU033,209,12,221
2025-06-04,15,2,SKU029,741,81,822
2025-06-05,1,1,SKU031,504,63,567
2025-06-05,1,3,SKU023,729,64,793
2025-06-05,2,1,SKU018,562,49,611
2025-06-05,2,2,SKU012,635,48,683
2025-06-05,2,3,SKU033,778,18,796
2025-06-05,3,1,SKU003,210,15,225
2025-06-05,3,2,SKU036,524,77,601
2025-06-05,3,3,SKU033,211,12,223
2025-06-05,4,1,SKU020,781,76,857
2025-06-05,4,2,SKU017,280,21,301
2025-06-05,5,1,SKU031,559,68,627
2025-06-05,5,3,SKU025,292,26,318
2025-06-05,6,1,SKU024,433,36,469
2025-06-05,6,2,SKU004,366,21,387
2025-06-05,6,3,SKU012,448,9,457
2025-06-05,7,1,SKU012,618,31,649
2025-06-05,7,2,SKU025,573,84,657
2025-06-05,7,3,SKU040,437,52,489
2025-06-05,8,1,SKU039,336,39,375
2025-06-05,8,2,SKU001,649,1,650
2025-06-05,8,3,SKU005,587,27,614
2025-06-05,9,1,SKU026,423,39,462
2025-06-05,9,2,SKU024,721,95,816
2025-06-05,9,3,SKU024,270,39,309
2025-06-05,10,1,SKU017,472,55,527
2025-06-05,10,2,SKU031,715,4,719
2025-06-05,10,3,SKU020,367,18,385
2025-06-05,11,1,SKU039,768,2,770
2025-06-05,11,3,SKU022,389,21,410
2025-06-05,12,1,SKU035,342,2,344
2025-06-05,12,2,SKU003,637,59,696
2025-06-05,12,3,SKU007,729,36,765
2025-06-05,13,1,SKU022,612,29,641
2025-06-05,13,2,SKU004,298,19,317
2025-06-05,13,3,SKU031,249,10,259
2025-06-05,14,1,SKU039,339,8,347
2025-06-05,14,2,SKU020,522,43,565
2025-06-05,14,3,SKU004,328,46,374
2025-06-05,15,2,SKU017,648,84,732
2025-06-05,15,3,SKU005,371,0,371
2025-06-06,1,1,SKU040,202,4,206
2025-06-06,1,3,SKU005,707,104,811
2025-06-06,2,1,SKU013,492,29,521
2025-06-06,2,2,SKU006,328,17,345
2025-06-06,2,3,SKU016,789,6,795
2025-06-06,3,1,SKU013,222,31,253
2025-06-06,3,2,SKU022,446,16,462
2025-06-06,3,3,SKU031,639,51,690
2025-06-06,4,1,SKU028,679,30,709
2025-06-06,4,2,SKU010,649,18,667
2025-06-06,4,3,SKU010,575,71,646
2025-06-06,5,2,SKU030,705,66,771
2025-06-06,5,3,SKU004,373,12,385
2025-06-06,6,1,SKU037,348,2,350
2025-06-06,6,2,SKU009,404,35,439
2025-06-06,6,3,SKU007,505,60,565
2025-06-06,8,1,SKU015,542,47,589
2025-06-06,8,2,SKU017,215,22,237
2025-06-06,8,3,SKU040,365,13,378
2025-06-06,9,1,SKU009,368,14,382
2025-06-06,9,2,SKU034,386,3,389
2025-06-06,9,3,SKU007,611,5,616
2025-06-06,10,1,SKU036,610,13,623
2025-06-06,10,2,SKU017,646,7,653
2025-06-06,11,1,SKU040,695,80,775
2025-06-06,11,2,SKU017,488,2,490
2025-06-06,11,3,SKU004,795,42,837
2025-06-06,12,2,SKU003,441,31,472
2025-06-06,12,3,SKU027,409,44,453
2025-06-06,13,1,SKU040,254,5,259
2025-06-06,13,2,SKU039,327,7,334
2025-06-06,13,3,SKU022,437,29,466
2025-06-06,14,1,SKU030,638,78,716
2025-06-06,14,2,SKU038,273,37,310
2025-06-06,14,3,SKU030,322,37,359
2025-06-06,15,1,SKU014,664,92,756
2025-06-06,15,2,SKU034,693,81,774
2025-06-06,15,3,SKU031,249,30,279
2025-06-07,1,1,SKU037,286,20,306
2025-06-07,1,2,SKU023,290,23,313
2025-06-07,2,1,SKU017,531,19,550
2025-06-07,2,2,SKU021,645,58,703
2025-06-07,2,3,SKU039,744,0,744
2025-06-07,3,1,SKU035,657,24,681
2025-06-07,3,2,SKU014,337,5,342
2025-06-07,3,3,SKU022,552,11,563
2025-06-07,4,1,SKU015,491,14,505
2025-06-07,4,2,SKU039,554,38,592
2025-06-07,4,3,SKU019,446,37,483
2025-06-07,5,1,SKU032,501,8,509
2025-06-07,6,1,SKU028,398,38,436
2025-06-07,6,2,SKU023,667,40,707
2025-06-07,6,3,SKU022,518,18,536
2025-06-07,7,2,SKU020,568,22,590
2025-06-07,7,3,SKU032,774,70,844
2025-06-07,8,1,SKU006,534,11,545
2025-06-07,8,2,SKU001,496,41,537
2025-06-07,8,3,SKU001,366,15,381
2025-06-07,9,1,SKU001,518,53,571
2025-06-07,9,2,SKU009,636,89,725
2025-06-07,9,3,SKU003,528,5,533
2025-06-07,10,2,SKU005,207,9,216
2025-06-07,10,3,SKU038,586,66,652
2025-06-07,11,1,SKU020,391,5,396
2025-06-07,11,2,SKU022,223,11,234
2025-06-07,11,3,SKU003,748,97,845
2025-06-07,12,2,SKU020,688,1,689
2025-06-07,12,3,SKU008,480,33,513
2025-06-07,13,1,SKU003,518,76,594
2025-06-07,13,2,SKU037,349,18,367
2025-06-07,13,3,SKU023,311,32,343
2025-06-07,14,1,SKU029,579,41,620
2025-06-07,14,2,SKU020,632,11,643
2025-06-07,14,3,SKU015,510,12,522
2025-06-07,15,1,SKU016,724,69,793
2025-06-07,15,2,SKU030,495,7,502
2025-06-07,15,3,SKU017,787,105,892
2025-06-08,1,1,SKU017,702,71,773
2025-06-08,1,3,SKU036,253,15,268
2025-06-08,2,2,SKU004,335,29,364
2025-06-08,2,3,SKU023,740,91,831
2025-06-08,3,1,SKU018,623,84,707
2025-06-08,3,2,SKU031,795,81,876
2025-06-08,3,3,SKU032,217,15,232
2025-06-08,4,1,SKU026,693,60,753
2025-06-08,4,2,SKU015,492,53,545
2025-06-08,5,1,SKU017,304,3,307
2025-06-08,5,2,SKU014,587,26,613
2025-06-08,5,3,SKU031,633,51,684
2025-06-08,6,1,SKU012,661,31,692
2025-06-08,6,2,SKU008,593,66,659
2025-06-08,6,3,SKU033,287,41,328
2025-06-08,7,3,SKU015,421,44,465
2025-06-08,8,2,SKU030,308,16,324
2025-06-08,8,3,SKU014,744,19,763
2025-06-08,9,1,SKU032,665,44,709
2025-06-08,9,2,SKU024,408,27,435
2025-06-08,10,1,SKU018,431,36,467
2025-06-08,10,2,SKU003,624,55,679
2025-06-08,10,3,SKU002,208,25,233
2025-06-08,11,1,SKU025,470,45,515
2025-06-08,11,2,SKU032,734,53,787
2025-06-08,12,1,SKU032,371,25,396
2025-06-08,12,2,SKU002,496,59,555
2025-06-08,12,3,SKU035,569,26,595
2025-06-08,13,1,SKU011,692,14,706
2025-06-08,13,2,SKU002,237,32,269
2025-06-08,13,3,SKU038,400,17,417
2025-06-08,14,1,SKU016,339,13,352
2025-06-08,14,2,SKU037,497,3,500
2025-06-08,14,3,SKU007,636,45,681
2025-06-08,15,1,SKU008,666,15,681
2025-06-09,1,1,SKU031,330,29,359
2025-06-09,1,2,SKU017,481,59,540
2025-06-09,2,2,SKU019,645,89,734
2025-06-09,2,3,SKU036,621,43,664
2025-06-09,3,1,SKU028,576,1,577
2025-06-09,3,2,SKU012,716,81,797
2025-06-09,3,3,SKU036,673,98,771
2025-06-09,4,1,SKU032,788,101,889
2025-06-09,4,2,SKU005,771,7,778
2025-06-09,4,3,SKU038,494,17,511
2025-06-09,5,1,SKU013,516,2,518
2025-06-09,5,2,SKU006,297,15,312
2025-06-09,5,3,SKU019,266,20,286
2025-06-09,6,1,SKU025,759,43,802
2025-06-09,6,2,SKU009,742,24,766
2025-06-09,7,1,SKU026,774,24,798
2025-06-09,7,2,SKU019,293,42,335
2025-06-09,7,3,SKU007,344,1,345
2025-06-09,8,1,SKU029,781,67,848
2025-06-09,8,2,SKU012,553,58,611
2025-06-09,8,3,SKU028,704,91,795
2025-06-09,9,1,SKU009,788,93,881
2025-06-09,9,2,SKU039,320,40,360
2025-06-09,9,3,SKU021,480,37,517
2025-06-09,10,1,SKU021,408,43,451
2025-06-09,10,3,SKU033,574,57,631
2025-06-09,11,1,SKU024,379,1,380
2025-06-09,11,2,SKU010,285,6,291
2025-06-09,11,3,SKU033,423,55,478
2025-06-09,12,1,SKU036,429,17,446
2025-06-09,12,2,SKU021,236,21,257
2025-06-09,12,3,SKU012,629,23,652
2025-06-09,13,1,SKU028,747,14,761
2025-06-09,13,2,SKU011,327,48,375
2025-06-09,13,3,SKU032,445,62,507
2025-06-09,14,1,SKU033,449,41,490
2025-06-09,14,2,SKU034,286,12,298
2025-06-09,14,3,SKU003,587,79,666
2025-06-09,15,1,SKU030,614,37,651
2025-06-09,15,3,SKU004,612,76,688
2025-06-10,1,2,SKU014,730,50,780
2025-06-10,1,3,SKU040,729,5,734
2025-06-10,2,1,SKU013,551,50,601
2025-06-10,2,2,SKU010,541,53,594
2025-06-10,2,3,SKU026,230,13,243
2025-06-10,3,1,SKU040,608,8,616
2025-06-10,3,2,SKU010,726,13,739
2025-06-10,3,3,SKU015,259,2,261
2025-06-10,4,1,SKU002,785,80,865
2025-06-10,4,2,SKU030,530,31,561
2025-06-10,4,3,SKU031,462,46,508
2025-06-10,5,1,SKU040,728,47,775
2025-06-10,5,2,SKU014,241,8,249
2025-06-10,5,3,SKU014,217,10,227
2025-06-10,6,1,SKU032,491,14,505
2025-06-10,6,2,SKU014,233,5,238
2025-06-10,6,3,SKU033,560,24,584
2025-06-10,7,1,SKU011,487,69,556
2025-06-10,7,2,SKU034,489,64,553
2025-06-10,8,1,SKU020,766,53,819
2025-06-10,8,2,SKU009,518,27,545
2025-06-10,8,3,SKU014,494,14,508
2025-06-10,9,1,SKU007,706,67,773
2025-06-10,9,2,SKU030,409,47,456
2025-06-10,9,3,SKU005,427,22,449
2025-06-10,10,2,SKU012,518,60,578
2025-06-10,10,3,SKU022,526,13,539
2025-06-10,11,2,SKU029,575,6,581
2025-06-10,12,2,SKU001,377,47,424
2025-06-10,12,3,SKU036,665,0,665
2025-06-10,13,1,SKU017,792,72,864
2025-06-10,13,3,SKU006,288,26,314
2025-06-10,14,1,SKU023,783,34,817
2025-06-10,14,2,SKU040,360,44,404
2025-06-10,14,3,SKU004,217,15,232
2025-06-10,15,1,SKU021,430,37,467
2025-06-10,15,2,SKU010,718,70,788
2025-06-10,15,3,SKU018,412,24,436
2025-06-11,1,2,SKU035,690,42,732
2025-06-11,1,3,SKU038,302,38,340
2025-06-11,2,1,SKU034,315,14,329
2025-06-11,2,2,SKU030,365,51,416
2025-06-11,2,3,SKU031,308,10,318
2025-06-11,3,2,SKU017,382,17,399
2025-06-11,3,3,SKU040,638,83,721
2025-06-11,4,1,SKU005,765,49,814
2025-06-11,4,3,SKU014,660,53,713
2025-06-11,5,1,SKU002,476,3,479
2025-06-11,5,2,SKU031,302,35,337
2025-06-11,5,3,SKU020,552,25,577
2025-06-11,6,1,SKU029,664,10,674
2025-06-11,6,2,SKU031,299,15,314
2025-06-11,6,3,SKU005,236,3,239
2025-06-11,7,2,SKU024,683,47,730
2025-06-11,8,1,SKU017,334,6,340
2025-06-11,8,2,SKU039,797,63,860
2025-06-11,8,3,SKU003,348,40,388
2025-06-11,9,1,SKU038,722,59,781
2025-06-11,9,2,SKU010,755,111,866
2025-06-11,9,3,SKU018,458,37,495
2025-06-11,10,1,SKU008,711,11,722
2025-06-11,10,2,SKU017,233,8,241
2025-06-11,10,3,SKU038,315,25,340
2025-06-11,11,1,SKU025,252,20,272
2025-06-11,11,3,SKU025,523,26,549
2025-06-11,12,1,SKU018,541,20,561
2025-06-11,12,2,SKU007,792,35,827
2025-06-11,12,3,SKU022,798,32,830
2025-06-11,13,1,SKU022,471,50,521
2025-06-11,13,2,SKU014,668,74,742
2025-06-11,13,3,SKU012,636,15,651
2025-06-11,14,1,SKU021,230,2,232
2025-06-11,14,2,SKU029,699,94,793
2025-06-11,15,1,SKU030,740,73,813
2025-06-11,15,2,SKU007,440,41,481
2025-06-11,15,3,SKU011,610,74,684
2025-06-12,1,1,SKU009,671,42,713
2025-06-12,1,2,SKU030,404,30,434
2025-06-12,2,1,SKU014,238,1,239
2025-06-12,2,2,SKU021,520,19,539
2025-06-12,2,3,SKU037,767,59,826
2025-06-12,3,1,SKU021,764,37,801
2025-06-12,3,2,SKU035,421,28,449
2025-06-12,3,3,SKU008,546,45,591
2025-06-12,4,1,SKU026,710,8,718
2025-06-12,4,2,SKU019,514,58,572
2025-06-12,4,3,SKU011,501,64,565
2025-06-12,5,1,SKU017,229,33,262
2025-06-12,5,2,SKU024,737,77,814
2025-06-12,5,3,SKU022,779,82,861
2025-06-12,6,1,SKU035,275,19,294
2025-06-12,6,2,SKU009,362,2,364
2025-06-12,6,3,SKU007,495,3,498
2025-06-12,7,1,SKU024,538,66,604
2025-06-12,7,2,SKU032,773,103,876
2025-06-12,7,3,SKU031,406,3,409
2025-06-12,8,1,SKU013,568,64,632
2025-06-12,8,2,SKU023,352,35,387
2025-06-12,8,3,SKU025,672,40,712
2025-06-12,9,1,SKU030,367,3,370
2025-06-12,9,2,SKU016,250,26,276
2025-06-12,9,3,SKU023,200,4,204
2025-06-12,10,1,SKU028,440,47,487
2025-06-12,10,2,SKU026,690,73,763
2025-06-12,10,3,SKU011,513,59,572
2025-06-12,11,1,SKU019,470,44,514
2025-06-12,11,2,SKU039,450,12,462
2025-06-12,12,1,SKU032,776,86,862
2025-06-12,13,1,SKU001,604,43,647
2025-06-12,13,2,SKU007,312,15,327
2025-06-12,14,1,SKU013,297,2,299
2025-06-12,14,2,SKU026,545,50,595
2025-06-12,14,3,SKU013,227,33,260
2025-06-12,15,1,SKU024,281,8,289
2025-06-12,15,2,SKU024,640,73,713
2025-06-12,15,3,SKU027,330,7,337
2025-06-13,1,1,SKU036,722,75,797
2025-06-13,1,2,SKU019,330,14,344
2025-06-13,1,3,SKU025,575,14,589
2025-06-13,2,1,SKU018,254,7,261
2025-06-13,2,2,SKU002,711,48,759
2025-06-13,2,3,SKU008,793,87,880
2025-06-13,3,1,SKU008,511,0,511
2025-06-13,3,3,SKU013,464,35,499
2025-06-13,4,1,SKU020,680,84,764
2025-06-13,4,2,SKU012,210,18,228
2025-06-13,4,3,SKU002,326,10,336
2025-06-13,5,1,SKU029,492,71,563
2025-06-13,5,3,SKU030,430,19,449
2025-06-13,6,1,SKU030,749,92,841
2025-06-13,6,2,SKU028,384,2,386
2025-06-13,6,3,SKU036,573,20,593
2025-06-13,7,1,SKU033,749,41,790
2025-06-13,7,3,SKU006,337,34,371
2025-06-13,8,1,SKU015,722,58,780
2025-06-13,8,2,SKU040,710,48,758
2025-06-13,9,1,SKU013,303,26,329
2025-06-13,9,2,SKU020,350,9,359
2025-06-13,10,1,SKU006,683,48,731
2025-06-13,10,2,SKU003,518,34,552
2025-06-13,10,3,SKU014,404,55,459
2025-06-13,11,2,SKU012,510,48,558
2025-06-13,11,3,SKU033,377,47,424
2025-06-13,12,3,SKU018,481,56,537
2025-06-13,13,1,SKU040,592,86,678
2025-06-13,13,3,SKU013,500,63,563
2025-06-13,14,1,SKU014,502,14,516
2025-06-13,14,2,SKU010,750,37,787
2025-06-13,14,3,SKU027,279,34,313
2025-06-13,15,1,SKU018,769,78,847
2025-06-13,15,2,SKU014,406,45,451
2025-06-14,1,1,SKU011,783,21,804
2025-06-14,1,3,SKU028,650,34,684
2025-06-14,2,1,SKU004,770,69,839
2025-06-14,2,2,SKU021,345,7,352
2025-06-14,2,3,SKU015,370,9,379
2025-06-14,3,1,SKU038,434,64,498
2025-06-14,3,2,SKU027,363,30,393
2025-06-14,3,3,SKU031,755,101,856
2025-06-14,4,1,SKU013,388,44,432
2025-06-14,4,2,SKU036,517,16,533
2025-06-14,4,3,SKU009,655,0,655
2025-06-14,5,2,SKU028,487,15,502
2025-06-14,6,1,SKU038,506,70,576
2025-06-14,6,3,SKU006,458,40,498
2025-06-14,7,1,SKU016,433,41,474
2025-06-14,7,2,SKU005,598,62,660
2025-06-14,7,3,SKU025,785,3,788
2025-06-14,8,1,SKU040,426,11,437
2025-06-14,8,2,SKU029,434,16,450
2025-06-14,8,3,SKU016,625,35,660
2025-06-14,9,1,SKU015,275,36,311
2025-06-14,9,2,SKU010,347,26,373
2025-06-14,9,3,SKU012,794,98,892
2025-06-14,10,1,SKU024,450,19,469
2025-06-14,10,2,SKU009,209,21,230
2025-06-14,10,3,SKU018,446,14,460
2025-06-14,11,1,SKU034,366,12,378
2025-06-14,11,2,SKU008,211,5,216
2025-06-14,11,3,SKU022,647,65,712
2025-06-14,12,1,SKU033,277,19,296
2025-06-14,12,2,SKU030,213,17,230
2025-06-14,12,3,SKU040,760,61,821
2025-06-14,13,1,SKU036,792,111,903
2025-06-14,13,2,SKU029,643,53,696
2025-06-14,13,3,SKU034,565,38,603
2025-06-14,14,1,SKU038,568,56,624
2025-06-14,14,2,SKU002,305,32,337
2025-06-14,14,3,SKU007,571,46,617
2025-06-14,15,1,SKU013,452,25,477
2025-06-14,15,2,SKU019,350,47,397
2025-06-14,15,3,SKU011,265,6,271
2025-06-15,1,1,SKU019,692,59,751
2025-06-15,1,2,SKU023,514,26,540
2025-06-15,1,3,SKU013,647,0,647
2025-06-15,2,1,SKU039,201,2,203
2025-06-15,2,2,SKU023,783,43,826
2025-06-15,2,3,SKU009,601,36,637
2025-06-15,3,1,SKU033,359,16,375
2025-06-15,3,2,SKU023,303,4,307
2025-06-15,3,3,SKU010,768,3,771
2025-06-15,4,1,SKU008,617,20,637
2025-06-15,4,2,SKU020,258,6,264
2025-06-15,4,3,SKU013,711,62,773
2025-06-15,5,1,SKU016,745,90,835
2025-06-15,5,2,SKU023,715,13,728
2025-06-15,5,3,SKU026,444,39,483
2025-06-15,6,2,SKU014,540,23,563
2025-06-15,6,3,SKU016,554,77,631
2025-06-15,7,1,SKU010,664,32,696
2025-06-15,7,2,SKU030,217,10,227
2025-06-15,8,1,SKU033,618,70,688
2025-06-15,8,2,SKU012,410,4,414
2025-06-15,8,3,SKU012,437,23,460
2025-06-15,9,1,SKU011,693,44,737
2025-06-15,9,2,SKU017,289,17,306
2025-06-15,9,3,SKU001,649,58,707
2025-06-15,10,1,SKU007,658,74,732
2025-06-15,10,2,SKU040,290,37,327
2025-06-15,10,3,SKU015,235,11,246
2025-06-15,11,1,SKU011,357,38,395
2025-06-15,11,2,SKU013,271,25,296
2025-06-15,11,3,SKU037,252,22,274
2025-06-15,12,1,SKU011,482,26,508
2025-06-15,13,1,SKU002,680,74,754
2025-06-15,13,2,SKU037,699,51,750
2025-06-15,13,3,SKU040,763,64,827
2025-06-15,14,1,SKU025,319,16,335
2025-06-15,14,2,SKU021,659,42,701
2025-06-15,14,3,SKU033,305,0,305
2025-06-16,1,1,SKU013,793,34,827
2025-06-16,1,2,SKU011,514,64,578
2025-06-16,1,3,SKU028,359,6,365
2025-06-16,2,1,SKU024,472,10,482
2025-06-16,3,1,SKU038,591,7,598
2025-06-16,3,2,SKU029,323,24,347
2025-06-16,3,3,SKU040,215,16,231
2025-06-16,4,1,SKU039,799,56,855
2025-06-16,4,2,SKU020,363,9,372
2025-06-16,4,3,SKU025,377,39,416
2025-06-16,5,1,SKU015,431,37,468
2025-06-16,5,2,SKU012,572,59,631
2025-06-16,6,1,SKU035,344,23,367
2025-06-16,6,2,SKU027,729,92,821
2025-06-16,6,3,SKU037,608,22,630
2025-06-16,7,1,SKU013,253,20,273
2025-06-16,7,2,SKU027,674,10,684
2025-06-16,7,3,SKU018,783,50,833
2025-06-16,8,1,SKU034,422,22,444
2025-06-16,8,2,SKU038,761,42,803
2025-06-16,8,3,SKU001,364,40,404
2025-06-16,9,1,SKU017,384,23,407
2025-06-16,9,2,SKU021,543,46,589
2025-06-16,9,3,SKU006,783,89,872
2025-06-16,10,2,SKU008,428,3,431
2025-06-16,10,3,SKU009,782,31,813
2025-06-16,11,1,SKU023,660,62,722
2025-06-16,11,2,SKU006,666,75,741
2025-06-16,11,3,SKU005,265,29,294
2025-06-16,12,3,SKU023,666,83,749
2025-06-16,14,1,SKU019,460,67,527
2025-06-16,14,3,SKU027,532,32,564
2025-06-16,15,1,SKU012,619,52,671
2025-06-16,15,2,SKU012,673,85,758
2025-06-16,15,3,SKU027,709,51,760
2025-06-17,1,1,SKU003,612,33,645
2025-06-17,1,2,SKU033,333,44,377
2025-06-17,1,3,SKU039,261,3,264
2025-06-17,2,1,SKU007,715,70,785
2025-06-17,2,2,SKU005,392,14,406
2025-06-17,2,3,SKU024,320,0,320
2025-06-17,3,1,SKU020,754,51,805
2025-06-17,3,2,SKU009,268,32,300
2025-06-17,3,3,SKU014,690,49,739
2025-06-17,4,2,SKU012,754,11,765
2025-06-17,4,3,SKU009,698,80,778
2025-06-17,5,2,SKU039,571,37,608
2025-06-17,5,3,SKU038,511,74,585
2025-06-17,6,2,SKU008,492,71,563
2025-06-17,6,3,SKU013,737,6,743
2025-06-17,7,1,SKU040,202,6,208
2025-06-17,7,2,SKU003,353,11,364
2025-06-17,7,3,SKU025,747,100,847
2025-06-17,8,1,SKU008,409,47,456
2025-06-17,8,2,SKU015,575,63,638
2025-06-17,8,3,SKU008,262,32,294
2025-06-17,9,1,SKU026,583,5,588
2025-06-17,9,2,SKU028,785,60,845
2025-06-17,9,3,SKU039,365,31,396
2025-06-17,10,2,SKU004,317,33,350
2025-06-17,10,3,SKU012,557,45,602
2025-06-17,11,1,SKU030,475,33,508
2025-06-17,11,3,SKU017,645,93,738
2025-06-17,12,1,SKU005,387,0,387
2025-06-17,12,2,SKU015,740,4,744
2025-06-17,12,3,SKU030,481,6,487
2025-06-17,13,1,SKU017,705,52,757
2025-06-17,13,2,SKU020,649,58,707
2025-06-17,13,3,SKU038,278,16,294
2025-06-17,14,1,SKU029,640,61,701
2025-06-17,14,2,SKU030,397,41,438
2025-06-17,14,3,SKU033,463,10,473
2025-06-17,15,1,SKU030,326,41,367
2025-06-17,15,3,SKU034,672,43,715
2025-06-18,1,1,SKU010,542,71,613
2025-06-18,1,2,SKU026,607,83,690
2025-06-18,1,3,SKU026,219,19,238
2025-06-18,2,1,SKU031,238,27,265
2025-06-18,2,2,SKU028,324,40,364
2025-06-18,2,3,SKU021,769,67,836
2025-06-18,3,1,SKU013,614,38,652
2025-06-18,3,2,SKU001,233,4,237
2025-06-18,3,3,SKU039,450,20,470
2025-06-18,4,1,SKU040,634,86,720
2025-06-18,4,2,SKU030,500,37,537
2025-06-18,5,1,SKU035,638,47,685
2025-06-18,5,2,SKU036,517,65,582
2025-06-18,5,3,SKU035,515,63,578
2025-06-18,6,1,SKU021,257,29,286
2025-06-18,6,2,SKU008,461,61,522
2025-06-18,6,3,SKU030,762,40,802
2025-06-18,7,1,SKU020,342,35,377
2025-06-18,7,2,SKU038,460,65,525
2025-06-18,8,1,SKU023,563,20,583
2025-06-18,8,2,SKU038,492,47,539
2025-06-18,8,3,SKU015,463,39,502
2025-06-18,9,1,SKU016,457,8,465
2025-06-18,9,2,SKU003,601,76,677
2025-06-18,9,3,SKU020,594,77,671
2025-06-18,10,1,SKU031,239,2,241
2025-06-18,10,2,SKU009,725,104,829
2025-06-18,10,3,SKU020,313,45,358
2025-06-18,11,1,SKU028,730,30,760
2025-06-18,11,2,SKU004,775,87,862
2025-06-18,11,3,SKU009,497,19,516
2025-06-18,12,1,SKU003,526,20,546
2025-06-18,12,2,SKU026,209,26,235
2025-06-18,12,3,SKU004,219,31,250
2025-06-18,13,1,SKU001,516,37,553
2025-06-18,13,2,SKU020,332,26,358
2025-06-18,13,3,SKU008,224,18,242
2025-06-18,14,1,SKU001,602,11,613
2025-06-18,14,2,SKU020,289,4,293
2025-06-18,14,3,SKU032,218,20,238
2025-06-18,15,1,SKU035,619,27,646
2025-06-18,15,2,SKU011,597,77,674
2025-06-18,15,3,SKU005,629,89,718
2025-06-19,1,1,SKU018,236,4,240
2025-06-19,1,2,SKU022,219,29,248
2025-06-19,2,1,SKU029,487,70,557
2025-06-19,2,2,SKU009,409,38,447
2025-06-19,2,3,SKU025,463,1,464
2025-06-19,3,3,SKU016,377,5,382
2025-06-19,4,1,SKU026,717,55,772
2025-06-19,4,3,SKU019,270,35,305
2025-06-19,5,3,SKU014,603,6,609
2025-06-19,6,1,SKU036,330,3,333
2025-06-19,6,2,SKU010,575,7,582
2025-06-19,6,3,SKU012,714,46,760
2025-06-19,7,1,SKU014,760,15,775
2025-06-19,7,2,SKU007,293,32,325
2025-06-19,7,3,SKU005,677,37,714
2025-06-19,8,1,SKU022,584,58,642
2025-06-19,8,2,SKU026,724,46,770
2025-06-19,8,3,SKU026,260,30,290
2025-06-19,9,2,SKU039,343,41,384
2025-06-19,9,3,SKU031,774,18,792
2025-06-19,10,2,SKU025,317,26,343
2025-06-19,10,3,SKU036,703,39,742
2025-06-19,11,1,SKU005,683,72,755
2025-06-19,11,3,SKU037,612,22,634
2025-06-19,12,1,SKU015,427,0,427
2025-06-19,12,2,SKU030,313,9,322
2025-06-19,12,3,SKU020,716,101,817
2025-06-19,13,1,SKU011,717,90,807
2025-06-19,13,3,SKU031,670,8,678
2025-06-19,14,1,SKU023,649,68,717
2025-06-19,14,2,SKU012,632,40,672
2025-06-19,15,1,SKU004,254,32,286
2025-06-19,15,2,SKU034,777,46,823
2025-06-19,15,3,SKU001,350,12,362
2025-06-20,1,1,SKU038,432,48,480
2025-06-20,1,3,SKU028,316,16,332
2025-06-20,2,1,SKU005,617,67,684
2025-06-20,2,2,SKU032,786,67,853
2025-06-20,3,2,SKU025,502,57,559
2025-06-20,3,3,SKU005,799,22,821
2025-06-20,4,1,SKU020,405,41,446
2025-06-20,4,3,SKU015,651,45,696
2025-06-20,5,1,SKU034,445,28,473
2025-06-20,5,3,SKU017,683,16,699
2025-06-20,6,1,SKU036,221,10,231
2025-06-20,6,2,SKU002,320,47,367
2025-06-20,6,3,SKU035,796,32,828
2025-06-20,7,1,SKU025,370,43,413
2025-06-20,8,1,SKU012,252,29,281
2025-06-20,8,2,SKU014,409,11,420
2025-06-20,8,3,SKU033,566,17,583
2025-06-20,9,1,SKU003,636,41,677
2025-06-20,9,2,SKU016,237,7,244
2025-06-20,9,3,SKU001,285,38,323
2025-06-20,10,1,SKU005,596,87,683
2025-06-20,10,2,SKU004,460,17,477
2025-06-20,10,3,SKU006,740,70,810
2025-06-20,11,1,SKU011,487,24,511
2025-06-20,12,1,SKU034,683,54,737
2025-06-20,12,2,SKU040,204,23,227
2025-06-20,12,3,SKU012,574,30,604
2025-06-20,13,1,SKU024,788,46,834
2025-06-20,13,2,SKU032,211,7,218
2025-06-20,14,1,SKU015,628,51,679
2025-06-20,14,2,SKU026,773,35,808
2025-06-20,15,1,SKU011,447,17,464
2025-06-20,15,2,SKU007,253,1,254
2025-06-20,15,3,SKU003,342,40,382
2025-06-21,1,1,SKU007,573,12,585
2025-06-21,1,2,SKU024,241,26,267
2025-06-21,1,3,SKU036,634,91,725
2025-06-21,2,2,SKU040,731,84,815
2025-06-21,2,3,SKU001,647,51,698
2025-06-21,3,1,SKU005,799,3,802
2025-06-21,3,2,SKU007,203,20,223
2025-06-21,3,3,SKU037,752,79,831
2025-06-21,4,1,SKU007,308,34,342
2025-06-21,4,3,SKU028,691,100,791
2025-06-21,5,1,SKU017,724,58,782
2025-06-21,5,2,SKU032,521,13,534
2025-06-21,5,3,SKU023,619,13,632
2025-06-21,6,1,SKU011,414,31,445
2025-06-21,6,3,SKU022,342,1,343
2025-06-21,7,1,SKU039,481,18,499
2025-06-21,7,2,SKU024,233,31,264
2025-06-21,7,3,SKU009,357,25,382
2025-06-21,8,2,SKU011,676,35,711
2025-06-21,8,3,SKU027,431,60,491
2025-06-21,9,1,SKU033,523,74,597
2025-06-21,9,2,SKU002,223,26,249
2025-06-21,9,3,SKU008,467,60,527
2025-06-21,10,1,SKU009,701,38,739
2025-06-21,10,2,SKU012,372,14,386
2025-06-21,10,3,SKU017,783,99,882
2025-06-21,11,1,SKU026,552,42,594
2025-06-21,12,2,SKU012,618,68,686
2025-06-21,13,1,SKU034,669,7,676
2025-06-21,13,2,SKU016,780,49,829
2025-06-21,13,3,SKU028,789,104,893
2025-06-21,14,1,SKU005,435,45,480
2025-06-21,14,2,SKU022,325,27,352
2025-06-21,14,3,SKU035,537,25,562
2025-06-21,15,1,SKU015,579,47,626
2025-06-21,15,2,SKU027,578,83,661
2025-06-21,15,3,SKU038,756,8,764
2025-06-22,1,1,SKU027,297,5,302
2025-06-22,1,2,SKU017,784,107,891
2025-06-22,1,3,SKU037,542,20,562
2025-06-22,2,1,SKU012,568,60,628
2025-06-22,2,2,SKU017,745,36,781
2025-06-22,2,3,SKU036,579,85,664
2025-06-22,3,2,SKU009,506,70,576
2025-06-22,3,3,SKU012,398,49,447
2025-06-22,4,1,SKU006,242,28,270
2025-06-22,4,2,SKU015,591,62,653
2025-06-22,4,3,SKU006,559,50,609
2025-06-22,5,1,SKU005,262,29,291
2025-06-22,5,2,SKU037,531,33,564
2025-06-22,5,3,SKU024,761,67,828
2025-06-22,6,1,SKU009,332,33,365
2025-06-22,6,2,SKU029,541,43,584
2025-06-22,6,3,SKU026,707,77,784
2025-06-22,7,2,SKU017,783,90,873
2025-06-22,7,3,SKU001,229,33,262
2025-06-22,8,1,SKU013,370,43,413
2025-06-22,8,2,SKU021,505,49,554
2025-06-22,8,3,SKU031,526,26,552
2025-06-22,9,1,SKU011,644,48,692
2025-06-22,9,3,SKU012,247,20,267
2025-06-22,10,2,SKU019,207,22,229
2025-06-22,10,3,SKU028,464,64,528
2025-06-22,11,1,SKU022,220,9,229
2025-06-22,11,2,SKU024,708,24,732
2025-06-22,11,3,SKU005,514,44,558
2025-06-22,12,3,SKU025,345,3,348
2025-06-22,13,1,SKU014,206,17,223
2025-06-22,13,3,SKU009,381,41,422
2025-06-22,14,1,SKU015,267,24,291
2025-06-22,14,2,SKU030,430,0,430
2025-06-22,15,1,SKU003,485,2,487
2025-06-22,15,2,SKU020,313,45,358
2025-06-22,15,3,SKU015,684,37,721
2025-06-23,1,1,SKU036,246,0,246
2025-06-23,1,2,SKU011,226,16,242
2025-06-23,1,3,SKU003,285,1,286
2025-06-23,2,1,SKU010,246,19,265
2025-06-23,2,2,SKU006,248,33,281
2025-06-23,3,1,SKU012,699,69,768
2025-06-23,3,2,SKU035,259,7,266
2025-06-23,3,3,SKU040,667,80,747
2025-06-23,4,1,SKU040,571,34,605
2025-06-23,4,2,SKU019,469,27,496
2025-06-23,4,3,SKU010,356,30,386
2025-06-23,5,1,SKU037,623,15,638
2025-06-23,5,2,SKU032,446,25,471
2025-06-23,5,3,SKU015,647,11,658
2025-06-23,6,1,SKU003,464,53,517
2025-06-23,6,2,SKU031,326,23,349
2025-06-23,6,3,SKU016,501,38,539
2025-06-23,7,1,SKU008,323,44,367
2025-06-23,7,2,SKU017,525,65,590
2025-06-23,7,3,SKU040,636,88,724
2025-06-23,8,1,SKU018,730,68,798
2025-06-23,8,2,SKU013,270,28,298
2025-06-23,9,1,SKU035,468,25,493
2025-06-23,9,2,SKU031,570,66,636
2025-06-23,9,3,SKU024,267,31,298
2025-06-23,10,1,SKU029,723,60,783
2025-06-23,10,2,SKU038,626,56,682
2025-06-23,10,3,SKU018,337,18,355
2025-06-23,11,1,SKU039,372,28,400
2025-06-23,11,2,SKU004,438,33,471
2025-06-23,12,2,SKU004,234,34,268
2025-06-23,13,1,SKU037,214,10,224
2025-06-23,13,2,SKU039,574,45,619
2025-06-23,13,3,SKU040,577,13,590
2025-06-23,14,1,SKU030,459,24,483
2025-06-23,14,2,SKU033,438,3,441
2025-06-23,14,3,SKU004,710,92,802
2025-06-23,15,1,SKU002,505,39,544
2025-06-23,15,2,SKU028,243,20,263
2025-06-24,1,2,SKU020,660,25,685
2025-06-24,1,3,SKU016,665,39,704
2025-06-24,2,1,SKU026,336,12,348
2025-06-24,2,2,SKU036,531,12,543
2025-06-24,3,1,SKU009,658,64,722
2025-06-24,3,2,SKU022,297,6,303
2025-06-24,3,3,SKU014,598,16,614
2025-06-24,4,1,SKU027,281,34,315
2025-06-24,4,2,SKU036,294,43,337
2025-06-24,5,1,SKU003,773,66,839
2025-06-24,5,2,SKU031,271,30,301
2025-06-24,6,1,SKU036,416,14,430
2025-06-24,6,3,SKU022,316,5,321
2025-06-24,7,1,SKU039,783,43,826
2025-06-24,7,2,SKU009,637,22,659
2025-06-24,7,3,SKU015,362,20,382
2025-06-24,8,1,SKU019,336,21,357
2025-06-24,8,2,SKU019,628,56,684
2025-06-24,8,3,SKU007,404,13,417
2025-06-24,9,1,SKU031,597,30,627
2025-06-24,9,2,SKU013,270,39,309
2025-06-24,10,1,SKU011,790,92,882
2025-06-24,10,2,SKU031,581,11,592
2025-06-24,10,3,SKU032,775,41,816
2025-06-24,11,1,SKU009,333,14,347
2025-06-24,11,2,SKU010,480,69,549
2025-06-24,11,3,SKU022,674,67,741
2025-06-24,12,1,SKU030,497,36,533
2025-06-24,12,2,SKU038,308,15,323
2025-06-24,12,3,SKU036,714,76,790
2025-06-24,13,2,SKU033,418,39,457
2025-06-24,13,3,SKU035,704,79,783
2025-06-24,14,1,SKU037,620,32,652
2025-06-24,14,3,SKU009,511,8,519
2025-06-24,15,1,SKU018,406,33,439
2025-06-24,15,2,SKU004,235,2,237
2025-06-24,15,3,SKU034,315,18,333
2025-06-25,1,2,SKU017,229,33,262
2025-06-25,1,3,SKU015,450,13,463
2025-06-25,2,2,SKU032,262,26,288
2025-06-25,2,3,SKU008,250,34,284
2025-06-25,3,1,SKU040,364,37,401
2025-06-25,3,2,SKU028,345,8,353
2025-06-25,3,3,SKU012,248,32,280
2025-06-25,4,1,SKU015,592,50,642
2025-06-25,4,2,SKU014,461,24,485
2025-06-25,4,3,SKU009,478,21,499
2025-06-25,5,1,SKU017,625,70,695
2025-06-25,6,1,SKU010,548,49,597
2025-06-25,6,3,SKU007,751,1,752
2025-06-25,7,1,SKU026,603,27,630
2025-06-25,7,3,SKU005,335,44,379
2025-06-25,8,2,SKU024,560,53,613
2025-06-25,8,3,SKU016,565,69,634
2025-06-25,9,1,SKU027,447,34,481
2025-06-25,9,2,SKU034,760,89,849
2025-06-25,9,3,SKU025,699,90,789
2025-06-25,10,1,SKU011,441,11,452
2025-06-25,10,2,SKU011,447,6,453
2025-06-25,10,3,SKU004,381,21,402
2025-06-25,11,1,SKU024,420,7,427
2025-06-25,11,2,SKU002,515,32,547
2025-06-25,11,3,SKU030,402,13,415
2025-06-25,12,1,SKU020,240,21,261
2025-06-25,13,1,SKU022,421,18,439
2025-06-25,13,2,SKU001,671,27,698
2025-06-25,13,3,SKU026,326,16,342
2025-06-25,14,1,SKU025,367,9,376
2025-06-25,14,2,SKU024,488,67,555
2025-06-25,14,3,SKU005,584,23,607
2025-06-25,15,1,SKU025,207,29,236
2025-06-25,15,2,SKU005,586,36,622
2025-06-25,15,3,SKU012,616,81,697
2025-06-26,1,1,SKU025,466,58,524
2025-06-26,1,2,SKU036,388,50,438
2025-06-26,1,3,SKU001,244,31,275
2025-06-26,2,1,SKU029,712,2,714
2025-06-26,2,2,SKU025,330,4,334
2025-06-26,2,3,SKU038,772,28,800
2025-06-26,3,2,SKU007,592,12,604
2025-06-26,3,3,SKU033,708,38,746
2025-06-26,4,1,SKU035,627,89,716
2025-06-26,4,2,SKU025,757,25,782
2025-06-26,4,3,SKU016,315,15,330
2025-06-26,5,1,SKU004,382,3,385
2025-06-26,5,3,SKU006,789,112,901
2025-06-26,6,1,SKU037,575,61,636
2025-06-26,6,3,SKU018,291,26,317
2025-06-26,7,1,SKU039,232,32,264
2025-06-26,7,2,SKU019,610,26,636
2025-06-26,7,3,SKU006,696,70,766
2025-06-26,8,2,SKU008,214,28,242
2025-06-26,9,1,SKU035,714,99,813
2025-06-26,9,2,SKU011,437,47,484
2025-06-26,9,3,SKU022,711,22,733
2025-06-26,10,2,SKU023,595,36,631
2025-06-26,10,3,SKU011,796,77,873
2025-06-26,11,1,SKU014,760,92,852
2025-06-26,11,2,SKU028,293,10,303
2025-06-26,11,3,SKU023,628,10,638
2025-06-26,12,1,SKU010,435,22,457
2025-06-26,12,2,SKU005,674,42,716
2025-06-26,12,3,SKU034,616,83,699
2025-06-26,13,1,SKU002,770,36,806
2025-06-26,13,3,SKU020,245,24,269
2025-06-26,14,2,SKU014,785,102,887
2025-06-26,14,3,SKU040,673,47,720
2025-06-26,15,2,SKU029,526,8,534
2025-06-27,1,2,SKU032,740,58,798
2025-06-27,1,3,SKU033,632,43,675
2025-06-27,2,1,SKU011,604,78,682
2025-06-27,2,2,SKU030,737,83,820
2025-06-27,2,3,SKU015,341,39,380
2025-06-27,3,1,SKU038,689,27,716
2025-06-27,3,2,SKU024,565,3,568
2025-06-27,3,3,SKU019,266,18,284
2025-06-27,4,1,SKU014,263,26,289
2025-06-27,4,2,SKU015,728,66,794
2025-06-27,4,3,SKU028,231,3,234
2025-06-27,5,1,SKU028,743,106,849
2025-06-27,5,2,SKU003,608,69,677
2025-06-27,5,3,SKU002,650,6,656
2025-06-27,6,1,SKU035,580,8,588
2025-06-27,6,2,SKU029,776,56,832
2025-06-27,6,3,SKU025,351,28,379
2025-06-27,7,2,SKU033,606,48,654
2025-06-27,7,3,SKU037,369,12,381
2025-06-27,8,1,SKU032,574,53,627
2025-06-27,8,3,SKU015,744,37,781
2025-06-27,9,1,SKU005,798,13,811
2025-06-27,9,2,SKU002,524,8,532
2025-06-27,10,1,SKU003,472,68,540
2025-06-27,10,2,SKU034,354,11,365
2025-06-27,10,3,SKU009,356,30,386
2025-06-27,11,1,SKU005,361,44,405
2025-06-27,11,2,SKU005,714,95,809
2025-06-27,11,3,SKU025,216,0,216
2025-06-27,12,1,SKU038,740,3,743
2025-06-27,12,2,SKU005,429,49,478
2025-06-27,12,3,SKU040,667,99,766
2025-06-27,13,1,SKU004,439,61,500
2025-06-27,13,2,SKU017,404,18,422
2025-06-27,13,3,SKU024,675,11,686
2025-06-27,14,1,SKU013,233,11,244
2025-06-27,14,2,SKU028,200,20,220
2025-06-27,14,3,SKU022,572,66,638
2025-06-27,15,1,SKU034,593,8,601
2025-06-27,15,3,SKU007,693,53,746
2025-06-28,1,1,SKU004,362,21,383
2025-06-28,1,2,SKU011,339,22,361
2025-06-28,1,3,SKU004,725,72,797
2025-06-28,2,1,SKU029,305,41,346
2025-06-28,2,2,SKU010,481,23,504
2025-06-28,2,3,SKU035,603,8,611
2025-06-28,3,2,SKU028,469,61,530
2025-06-28,3,3,SKU040,740,102,842
2025-06-28,4,1,SKU038,730,22,752
2025-06-28,4,2,SKU001,345,47,392
2025-06-28,4,3,SKU001,608,2,610
2025-06-28,5,1,SKU020,560,60,620
2025-06-28,5,2,SKU027,630,72,702
2025-06-28,5,3,SKU033,348,12,360
2025-06-28,6,1,SKU022,327,18,345
2025-06-28,6,2,SKU015,261,31,292
2025-06-28,6,3,SKU004,305,13,318
2025-06-28,7,1,SKU033,795,39,834
2025-06-28,7,2,SKU034,265,32,297
2025-06-28,7,3,SKU007,203,23,226
2025-06-28,8,1,SKU036,365,52,417
2025-06-28,8,2,SKU021,602,18,620
2025-06-28,8,3,SKU009,798,76,874
2025-06-28,9,2,SKU021,350,7,357
2025-06-28,9,3,SKU023,462,38,500
2025-06-28,10,1,SKU033,391,36,427
2025-06-28,10,3,SKU002,271,5,276
2025-06-28,11,1,SKU020,475,47,522
2025-06-28,11,3,SKU011,262,33,295
2025-06-28,12,1,SKU014,216,9,225
2025-06-28,12,2,SKU019,527,68,595
2025-06-28,12,3,SKU012,360,25,385
2025-06-28,13,1,SKU003,681,49,730
2025-06-28,13,2,SKU010,499,62,561
2025-06-28,13,3,SKU032,717,42,759
2025-06-28,14,1,SKU015,570,46,616
2025-06-28,14,3,SKU025,610,87,697
2025-06-28,15,1,SKU002,288,7,295
2025-06-28,15,2,SKU020,331,10,341
2025-06-28,15,3,SKU012,456,41,497
2025-06-29,1,1,SKU025,414,16,430
2025-06-29,1,2,SKU007,715,96,811
2025-06-29,2,3,SKU003,511,63,574
2025-06-29,3,1,SKU009,444,38,482
2025-06-29,3,2,SKU014,236,7,243
2025-06-29,3,3,SKU008,221,17,238
2025-06-29,4,1,SKU014,269,3,272
2025-06-29,4,3,SKU028,669,97,766
2025-06-29,5,1,SKU023,636,32,668
2025-06-29,5,2,SKU022,763,40,803
2025-06-29,5,3,SKU011,654,87,741
2025-06-29,6,3,SKU001,476,9,485
2025-06-29,7,1,SKU003,687,102,789
2025-06-29,7,2,SKU017,590,69,659
2025-06-29,7,3,SKU040,425,0,425
2025-06-29,8,1,SKU034,558,76,634
2025-06-29,8,3,SKU032,755,103,858
2025-06-29,9,1,SKU010,424,36,460
2025-06-29,9,2,SKU018,572,14,586
2025-06-29,10,1,SKU010,668,74,742
2025-06-29,10,2,SKU037,736,84,820
2025-06-29,10,3,SKU036,415,34,449
2025-06-29,11,1,SKU028,759,0,759
2025-06-29,11,2,SKU012,281,16,297
2025-06-29,11,3,SKU024,357,43,400
2025-06-29,12,1,SKU032,638,13,651
2025-06-29,12,2,SKU027,721,41,762
2025-06-29,12,3,SKU019,580,41,621
2025-06-29,13,1,SKU019,487,41,528
2025-06-29,13,2,SKU010,564,78,642
2025-06-29,13,3,SKU002,642,29,671
2025-06-29,14,1,SKU014,527,27,554
2025-06-29,14,2,SKU024,505,17,522
2025-06-29,14,3,SKU027,388,40,428
2025-06-29,15,1,SKU032,676,25,701
2025-06-29,15,3,SKU031,761,7,768
2025-06-30,1,1,SKU020,438,9,447
2025-06-30,1,3,SKU035,526,70,596
2025-06-30,2,1,SKU005,603,47,650
2025-06-30,2,2,SKU027,348,29,377
2025-06-30,2,3,SKU009,609,70,679
2025-06-30,3,1,SKU034,340,44,384
2025-06-30,3,2,SKU004,232,29,261
2025-06-30,3,3,SKU024,478,52,530
2025-06-30,4,1,SKU007,586,34,620
2025-06-30,4,2,SKU008,665,59,724
2025-06-30,4,3,SKU033,219,23,242
2025-06-30,5,1,SKU019,210,13,223
2025-06-30,5,2,SKU035,651,86,737
2025-06-30,5,3,SKU028,651,81,732
2025-06-30,6,1,SKU024,796,83,879
2025-06-30,6,3,SKU027,749,50,799
2025-06-30,7,1,SKU024,641,92,733
2025-06-30,8,1,SKU018,246,19,265
2025-06-30,8,2,SKU017,584,13,597
2025-06-30,8,3,SKU018,300,44,344
2025-06-30,9,1,SKU026,720,14,734
2025-06-30,9,2,SKU006,723,83,806
2025-06-30,9,3,SKU004,596,15,611
2025-06-30,10,2,SKU010,373,12,385
2025-06-30,10,3,SKU008,639,36,675
2025-06-30,11,1,SKU034,659,90,749
2025-06-30,11,2,SKU026,339,5,344
2025-06-30,11,3,SKU025,357,32,389
2025-06-30,12,1,SKU035,753,63,816
2025-06-30,12,2,SKU029,528,74,602
2025-06-30,12,3,SKU020,522,8,530
2025-06-30,13,1,SKU026,249,12,261
2025-06-30,13,2,SKU013,456,33,489
2025-06-30,13,3,SKU030,649,43,692
2025-06-30,14,1,SKU010,311,9,320
2025-06-30,14,3,SKU022,736,55,791
2025-06-30,15,1,SKU021,544,22,566
2025-06-30,15,2,SKU017,442,47,489
2025-07-01,1,1,SKU017,311,19,330
2025-07-01,1,2,SKU028,456,57,513
2025-07-01,1,3,SKU030,413,4,417
2025-07-01,2,1,SKU033,350,36,386
2025-07-01,2,2,SKU038,366,52,418
2025-07-01,2,3,SKU035,280,28,308
2025-07-01,3,2,SKU001,291,39,330
2025-07-01,3,3,SKU006,572,5,577
2025-07-01,4,1,SKU015,595,1,596
2025-07-01,4,2,SKU028,302,14,316
2025-07-01,4,3,SKU034,307,21,328
2025-07-01,5,1,SKU033,456,7,463
2025-07-01,5,2,SKU020,565,1,566
2025-07-01,5,3,SKU037,512,66,578
2025-07-01,6,2,SKU019,769,98,867
2025-07-01,6,3,SKU011,598,80,678
2025-07-01,7,1,SKU028,286,26,312
2025-07-01,7,2,SKU023,239,11,250
2025-07-01,8,2,SKU030,338,41,379
2025-07-01,8,3,SKU012,588,38,626
2025-07-01,9,1,SKU010,374,3,377
2025-07-01,9,2,SKU017,447,57,504
2025-07-01,10,1,SKU006,269,29,298
2025-07-01,10,2,SKU012,228,33,261
2025-07-01,10,3,SKU037,239,29,268
2025-07-01,11,1,SKU014,317,26,343
2025-07-01,11,2,SKU036,468,40,508
2025-07-01,11,3,SKU012,464,54,518
2025-07-01,12,1,SKU004,242,6,248
2025-07-01,12,2,SKU009,734,96,830
2025-07-01,12,3,SKU009,763,73,836
2025-07-01,13,1,SKU039,656,77,733
2025-07-01,13,2,SKU030,627,46,673
2025-07-01,13,3,SKU039,427,13,440
2025-07-01,14,1,SKU027,565,42,607
2025-07-01,14,2,SKU010,786,59,845
2025-07-01,14,3,SKU037,423,24,447
2025-07-01,15,1,SKU037,640,39,679
2025-07-01,15,2,SKU024,576,37,613
2025-07-01,15,3,SKU035,491,59,550
2025-07-02,1,1,SKU040,637,66,703
2025-07-02,1,2,SKU029,578,55,633
2025-07-02,1,3,SKU034,745,23,768
2025-07-02,2,1,SKU023,299,32,331
2025-07-02,2,2,SKU004,241,19,260
2025-07-02,2,3,SKU023,223,23,246
2025-07-02,3,1,SKU018,626,81,707
2025-07-02,3,2,SKU016,262,13,275
2025-07-02,3,3,SKU030,213,9,222
2025-07-02,4,2,SKU004,554,46,600
2025-07-02,5,1,SKU005,646,19,665
2025-07-02,5,2,SKU002,284,25,309
2025-07-02,5,3,SKU014,365,50,415
2025-07-02,6,1,SKU025,653,81,734
2025-07-02,6,2,SKU025,731,5,736
2025-07-02,6,3,SKU029,449,49,498
2025-07-02,7,1,SKU009,530,5,535
2025-07-02,7,3,SKU035,417,13,430
2025-07-02,8,1,SKU009,752,60,812
2025-07-02,8,2,SKU023,785,94,879
2025-07-02,8,3,SKU002,778,38,816
2025-07-02,9,2,SKU027,404,52,456
2025-07-02,9,3,SKU038,245,23,268
2025-07-02,10,3,SKU031,564,46,610
2025-07-02,11,1,SKU023,388,57,445
2025-07-02,11,2,SKU030,468,60,528
2025-07-02,11,3,SKU009,457,31,488
2025-07-02,12,1,SKU021,455,32,487
2025-07-02,12,2,SKU024,397,45,442
2025-07-02,12,3,SKU001,369,24,393
2025-07-02,13,2,SKU024,659,23,682
2025-07-02,13,3,SKU013,738,35,773
2025-07-02,14,1,SKU040,588,64,652
2025-07-02,14,2,SKU009,685,56,741
2025-07-02,15,1,SKU029,471,66,537
2025-07-02,15,2,SKU025,379,5,384
2025-07-02,15,3,SKU019,508,24,532
2025-07-03,1,1,SKU036,776,30,806
2025-07-03,1,2,SKU016,691,62,753
2025-07-03,1,3,SKU036,368,12,380
2025-07-03,2,1,SKU029,398,57,455
2025-07-03,2,2,SKU025,665,33,698
2025-07-03,2,3,SKU035,241,26,267
2025-07-03,3,1,SKU037,608,74,682
2025-07-03,3,3,SKU031,280,20,300
2025-07-03,4,1,SKU028,221,14,235
2025-07-03,4,2,SKU010,636,70,706
2025-07-03,4,3,SKU030,633,47,680
2025-07-03,5,1,SKU025,308,25,333
2025-07-03,5,2,SKU009,442,12,454
2025-07-03,5,3,SKU012,285,40,325
2025-07-03,6,1,SKU038,695,96,791
2025-07-03,6,2,SKU035,532,1,533
2025-07-03,6,3,SKU022,763,37,800
2025-07-03,7,1,SKU014,459,55,514
2025-07-03,7,2,SKU033,315,45,360
2025-07-03,7,3,SKU021,585,63,648
2025-07-03,8,2,SKU010,285,1,286
2025-07-03,8,3,SKU012,788,70,858
2025-07-03,9,1,SKU011,743,35,778
2025-07-03,9,2,SKU008,674,12,686
2025-07-03,9,3,SKU004,244,15,259
2025-07-03,10,1,SKU027,289,31,320
2025-07-03,10,2,SKU013,582,52,634
2025-07-03,10,3,SKU005,567,5,572
2025-07-03,11,1,SKU017,676,11,687
2025-07-03,11,2,SKU014,640,19,659
2025-07-03,11,3,SKU008,602,22,624
2025-07-03,12,1,SKU004,646,0,646
2025-07-03,12,2,SKU032,622,58,680
2025-07-03,12,3,SKU032,678,40,718
2025-07-03,13,1,SKU001,670,79,749
2025-07-03,13,3,SKU034,694,91,785
2025-07-03,14,1,SKU008,535,75,610
2025-07-03,14,2,SKU035,365,38,403
2025-07-03,14,3,SKU026,233,28,261
2025-07-03,15,1,SKU015,305,0,305
2025-07-03,15,2,SKU004,741,72,813
2025-07-03,15,3,SKU013,360,5,365
2025-07-04,1,1,SKU008,391,46,437
2025-07-04,1,2,SKU023,388,1,389
2025-07-04,1,3,SKU032,773,19,792
2025-07-04,2,1,SKU003,655,22,677
2025-07-04,2,2,SKU029,731,87,818
2025-07-04,2,3,SKU038,461,5,466
2025-07-04,3,1,SKU020,206,12,218
2025-07-04,3,2,SKU033,509,57,566
2025-07-04,3,3,SKU003,397,56,453
2025-07-04,4,1,SKU030,391,5,396
2025-07-04,4,2,SKU036,763,65,828
2025-07-04,4,3,SKU018,552,57,609
2025-07-04,5,1,SKU027,690,92,782
2025-07-04,5,2,SKU023,293,26,319
2025-07-04,5,3,SKU024,643,25,668
2025-07-04,6,2,SKU018,405,27,432
2025-07-04,7,1,SKU003,602,50,652
2025-07-04,7,2,SKU012,729,38,767
2025-07-04,7,3,SKU002,629,77,706
2025-07-04,8,1,SKU010,462,37,499
2025-07-04,8,2,SKU037,706,22,728
2025-07-04,8,3,SKU036,681,97,778
2025-07-04,9,1,SKU040,530,47,577
2025-07-04,9,2,SKU017,651,68,719
2025-07-04,9,3,SKU023,359,31,390
2025-07-04,10,1,SKU024,760,3,763
2025-07-04,10,3,SKU015,730,70,800
2025-07-04,11,1,SKU036,619,90,709
2025-07-04,11,3,SKU015,204,25,229
2025-07-04,12,1,SKU021,684,17,701
2025-07-04,12,2,SKU021,503,46,549
2025-07-04,13,1,SKU008,768,6,774
2025-07-04,13,2,SKU029,624,85,709
2025-07-04,13,3,SKU025,619,48,667
2025-07-04,14,1,SKU037,277,7,284
2025-07-04,14,2,SKU001,409,42,451
2025-07-04,14,3,SKU007,544,3,547
2025-07-04,15,1,SKU007,273,27,300
2025-07-04,15,2,SKU002,286,11,297
2025-07-04,15,3,SKU007,511,63,574
2025-07-05,1,1,SKU017,662,65,727
2025-07-05,1,2,SKU027,493,71,564
2025-07-05,1,3,SKU037,762,83,845
2025-07-05,2,1,SKU037,344,30,374
2025-07-05,2,2,SKU016,588,25,613
2025-07-05,2,3,SKU001,697,55,752
2025-07-05,3,1,SKU035,404,29,433
2025-07-05,3,2,SKU026,613,4,617
2025-07-05,3,3,SKU021,694,50,744
2025-07-05,4,1,SKU024,511,9,520
2025-07-05,4,3,SKU005,351,22,373
2025-07-05,5,1,SKU033,536,51,587
2025-07-05,5,3,SKU003,285,35,320
2025-07-05,6,1,SKU011,406,4,410
2025-07-05,6,2,SKU017,240,25,265
2025-07-05,6,3,SKU004,569,74,643
2025-07-05,7,1,SKU013,622,61,683
2025-07-05,7,2,SKU011,440,22,462
2025-07-05,7,3,SKU017,333,11,344
2025-07-05,8,1,SKU005,523,4,527
2025-07-05,8,2,SKU040,364,9,373
2025-07-05,8,3,SKU022,604,10,614
2025-07-05,9,1,SKU015,732,71,803
2025-07-05,9,2,SKU026,561,5,566
2025-07-05,9,3,SKU020,229,8,237
2025-07-05,10,1,SKU005,700,48,748
2025-07-05,10,2,SKU028,333,38,371
2025-07-05,10,3,SKU034,559,74,633
2025-07-05,11,1,SKU034,489,63,552
2025-07-05,11,2,SKU005,770,83,853
2025-07-05,11,3,SKU012,431,61,492
2025-07-05,12,1,SKU023,371,0,371
2025-07-05,12,2,SKU040,716,76,792
2025-07-05,12,3,SKU008,509,75,584
2025-07-05,13,3,SKU032,599,73,672
2025-07-05,14,1,SKU025,423,30,453
2025-07-05,14,2,SKU023,519,72,591
2025-07-05,15,1,SKU023,752,41,793
2025-07-05,15,2,SKU015,217,4,221
2025-07-06,1,1,SKU001,784,1,785
2025-07-06,1,2,SKU011,559,23,582
2025-07-06,1,3,SKU007,252,9,261
2025-07-06,2,1,SKU032,386,29,415
2025-07-06,2,2,SKU003,488,71,559
2025-07-06,2,3,SKU019,753,33,786
2025-07-06,3,1,SKU003,378,10,388
2025-07-06,3,3,SKU018,303,40,343
2025-07-06,4,1,SKU016,791,14,805
2025-07-06,4,3,SKU033,328,38,366
2025-07-06,5,1,SKU001,435,50,485
2025-07-06,5,2,SKU005,214,21,235
2025-07-06,5,3,SKU024,587,33,620
2025-07-06,6,1,SKU015,622,58,680
2025-07-06,6,2,SKU040,744,53,797
2025-07-06,6,3,SKU029,364,33,397
2025-07-06,7,1,SKU019,412,19,431
2025-07-06,7,2,SKU025,360,53,413
2025-07-06,7,3,SKU005,660,7,667
2025-07-06,8,2,SKU030,506,19,525
2025-07-06,8,3,SKU023,509,15,524
2025-07-06,9,1,SKU007,205,1,206
2025-07-06,9,2,SKU001,414,61,475
2025-07-06,9,3,SKU013,519,30,549
2025-07-06,10,1,SKU022,597,24,621
2025-07-06,10,2,SKU002,517,76,593
2025-07-06,10,3,SKU002,278,4,282
2025-07-06,11,2,SKU038,252,0,252
2025-07-06,11,3,SKU008,431,26,457
2025-07-06,12,1,SKU008,350,14,364
2025-07-06,12,2,SKU034,347,28,375
2025-07-06,12,3,SKU037,314,0,314
2025-07-06,13,1,SKU003,333,22,355
2025-07-06,13,3,SKU002,702,73,775
2025-07-06,14,1,SKU031,685,78,763
2025-07-06,14,2,SKU034,672,24,696
2025-07-06,14,3,SKU011,551,38,589
2025-07-06,15,2,SKU017,215,16,231
2025-07-06,15,3,SKU005,360,9,369
2025-07-07,1,1,SKU003,449,19,468
2025-07-07,1,3,SKU008,579,12,591
2025-07-07,2,1,SKU035,607,81,688
2025-07-07,2,2,SKU028,311,44,355
2025-07-07,2,3,SKU009,795,53,848
2025-07-07,3,1,SKU004,688,102,790
2025-07-07,3,2,SKU012,428,58,486
2025-07-07,3,3,SKU013,401,53,454
2025-07-07,4,1,SKU023,380,17,397
2025-07-07,4,2,SKU014,329,7,336
2025-07-07,4,3,SKU027,570,19,589
2025-07-07,5,1,SKU021,357,46,403
2025-07-07,5,2,SKU032,304,5,309
2025-07-07,6,1,SKU032,257,25,282
2025-07-07,6,2,SKU020,773,58,831
2025-07-07,6,3,SKU030,751,78,829
2025-07-07,7,1,SKU018,654,53,707
2025-07-07,7,3,SKU034,622,53,675
2025-07-07,8,2,SKU013,315,1,316
2025-07-07,8,3,SKU037,622,85,707
2025-07-07,9,1,SKU017,380,42,422
2025-07-07,9,2,SKU020,442,29,471
2025-07-07,9,3,SKU040,763,100,863
2025-07-07,10,1,SKU037,334,23,357
2025-07-07,10,2,SKU036,783,1,784
2025-07-07,10,3,SKU008,521,43,564
2025-07-07,11,2,SKU033,432,8,440
2025-07-07,11,3,SKU025,713,54,767
2025-07-07,12,1,SKU030,222,17,239
2025-07-07,12,2,SKU012,243,30,273
2025-07-07,12,3,SKU018,341,14,355
2025-07-07,13,1,SKU040,730,50,780
2025-07-07,13,2,SKU007,418,41,459
2025-07-07,13,3,SKU032,734,64,798
2025-07-07,14,3,SKU010,550,34,584
2025-07-07,15,2,SKU003,777,18,795
2025-07-07,15,3,SKU006,602,15,617
2025-07-08,1,1,SKU025,460,55,515
2025-07-08,1,2,SKU019,597,18,615
2025-07-08,1,3,SKU008,563,74,637
2025-07-08,2,1,SKU002,203,17,220
2025-07-08,2,2,SKU028,318,22,340
2025-07-08,3,1,SKU003,440,36,476
2025-07-08,3,2,SKU036,213,14,227
2025-07-08,3,3,SKU040,225,14,239
2025-07-08,4,1,SKU015,392,40,432
2025-07-08,4,2,SKU005,631,39,670
2025-07-08,4,3,SKU018,278,31,309
2025-07-08,5,2,SKU035,617,13,630
2025-07-08,5,3,SKU017,400,29,429
2025-07-08,6,1,SKU011,458,12,470
2025-07-08,6,3,SKU029,329,8,337
2025-07-08,7,1,SKU040,767,87,854
2025-07-08,7,2,SKU019,462,50,512
2025-07-08,7,3,SKU027,626,67,693
2025-07-08,8,1,SKU027,276,9,285
2025-07-08,8,2,SKU016,459,48,507
2025-07-08,8,3,SKU021,219,8,227
2025-07-08,9,1,SKU023,740,4,744
2025-07-08,9,2,SKU017,474,63,537
2025-07-08,9,3,SKU008,470,12,482
2025-07-08,10,1,SKU020,667,2,669
2025-07-08,10,2,SKU039,420,8,428
2025-07-08,11,1,SKU009,613,77,690
2025-07-08,11,3,SKU001,766,6,772
2025-07-08,12,1,SKU007,286,26,312
2025-07-08,12,2,SKU026,502,22,524
2025-07-08,12,3,SKU013,365,8,373
2025-07-08,13,1,SKU033,273,0,273
2025-07-08,14,1,SKU005,588,6,594
2025-07-08,14,2,SKU004,522,4,526
2025-07-08,14,3,SKU014,764,56,820
2025-07-08,15,1,SKU006,246,21,267
2025-07-08,15,2,SKU024,776,66,842
2025-07-08,15,3,SKU021,542,62,604
2025-07-09,1,1,SKU035,304,25,329
2025-07-09,1,2,SKU015,437,32,469
2025-07-09,1,3,SKU001,202,26,228
2025-07-09,2,1,SKU004,354,51,405
2025-07-09,2,2,SKU009,343,0,343
2025-07-09,2,3,SKU019,385,50,435
2025-07-09,3,1,SKU023,614,68,682
2025-07-09,3,2,SKU006,384,45,429
2025-07-09,3,3,SKU020,286,8,294
2025-07-09,4,2,SKU035,378,33,411
2025-07-09,4,3,SKU026,411,2,413
2025-07-09,5,1,SKU018,514,41,555
2025-07-09,5,2,SKU022,558,42,600
2025-07-09,5,3,SKU033,473,5,478
2025-07-09,6,1,SKU008,434,50,484
2025-07-09,6,2,SKU038,265,30,295
2025-07-09,6,3,SKU017,279,5,284
2025-07-09,7,1,SKU037,755,97,852
2025-07-09,7,2,SKU003,492,2,494
2025-07-09,7,3,SKU034,360,17,377
2025-07-09,8,1,SKU037,425,3,428
2025-07-09,8,2,SKU009,296,35,331
2025-07-09,8,3,SKU023,624,75,699
2025-07-09,9,1,SKU037,744,16,760
2025-07-09,9,2,SKU034,467,13,480
2025-07-09,10,1,SKU036,604,80,684
2025-07-09,10,2,SKU028,594,22,616
2025-07-09,10,3,SKU010,339,47,386
2025-07-09,11,1,SKU030,747,44,791
2025-07-09,11,2,SKU028,541,28,569
2025-07-09,11,3,SKU031,379,22,401
2025-07-09,12,1,SKU027,663,89,752
2025-07-09,12,2,SKU040,278,4,282
2025-07-09,12,3,SKU004,602,64,666
2025-07-09,13,1,SKU033,583,11,594
2025-07-09,13,2,SKU037,587,18,605
2025-07-09,13,3,SKU039,703,75,778
2025-07-09,14,1,SKU022,307,27,334
2025-07-09,14,2,SKU035,595,78,673
2025-07-09,14,3,SKU010,723,33,756
2025-07-09,15,1,SKU006,757,42,799
2025-07-09,15,2,SKU014,298,4,302
2025-07-09,15,3,SKU002,246,17,263
2025-07-10,1,2,SKU021,372,15,387
2025-07-10,2,1,SKU009,580,19,599
2025-07-10,2,2,SKU029,286,40,326
2025-07-10,3,1,SKU017,231,6,237
2025-07-10,3,2,SKU030,414,43,457
2025-07-10,3,3,SKU027,475,2,477
2025-07-10,4,1,SKU018,241,19,260
2025-07-10,4,2,SKU017,468,32,500
2025-07-10,4,3,SKU040,267,31,298
2025-07-10,5,1,SKU030,311,25,336
2025-07-10,5,2,SKU027,244,17,261
2025-07-10,5,3,SKU039,798,0,798
2025-07-10,6,1,SKU038,510,36,546
2025-07-10,6,2,SKU003,546,70,616
2025-07-10,6,3,SKU026,760,16,776
2025-07-10,7,2,SKU010,760,15,775
2025-07-10,7,3,SKU009,764,95,859
2025-07-10,8,1,SKU020,262,15,277
2025-07-10,8,2,SKU028,638,38,676
2025-07-10,8,3,SKU014,704,93,797
2025-07-10,9,1,SKU001,635,59,694
2025-07-10,9,2,SKU008,319,39,358
2025-07-10,9,3,SKU014,444,53,497
2025-07-10,10,1,SKU032,505,72,577
2025-07-10,10,3,SKU013,332,17,349
2025-07-10,11,1,SKU028,490,6,496
2025-07-10,11,2,SKU002,577,12,589
2025-07-10,11,3,SKU010,795,76,871
2025-07-10,12,1,SKU034,437,42,479
2025-07-10,12,2,SKU001,732,88,820
2025-07-10,12,3,SKU026,358,15,373
2025-07-10,13,1,SKU006,649,45,694
2025-07-10,13,2,SKU032,274,39,313
2025-07-10,13,3,SKU023,742,82,824
2025-07-10,14,2,SKU003,603,8,611
2025-07-10,14,3,SKU021,343,31,374
2025-07-10,15,1,SKU037,231,11,242
2025-07-10,15,2,SKU002,631,46,677
2025-07-10,15,3,SKU016,323,30,353
2025-07-11,1,1,SKU029,724,9,733
2025-07-11,1,2,SKU004,660,76,736
2025-07-11,1,3,SKU001,679,100,779
2025-07-11,2,1,SKU036,264,7,271
2025-07-11,2,2,SKU003,528,51,579
2025-07-11,3,1,SKU040,541,50,591
2025-07-11,3,2,SKU026,582,55,637
2025-07-11,4,2,SKU001,707,15,722
2025-07-11,4,3,SKU033,719,5,724
2025-07-11,5,1,SKU013,321,41,362
2025-07-11,5,2,SKU008,380,20,400
2025-07-11,6,1,SKU025,363,44,407
2025-07-11,6,3,SKU018,604,55,659
2025-07-11,7,2,SKU023,746,2,748
2025-07-11,7,3,SKU016,664,90,754
2025-07-11,8,1,SKU025,533,24,557
2025-07-11,8,2,SKU036,290,20,310
2025-07-11,9,1,SKU002,387,6,393
2025-07-11,9,2,SKU011,709,84,793
2025-07-11,9,3,SKU034,798,91,889
2025-07-11,10,1,SKU013,311,0,311
2025-07-11,10,2,SKU023,474,55,529
2025-07-11,11,2,SKU007,414,34,448
2025-07-11,11,3,SKU014,342,23,365
2025-07-11,12,1,SKU023,228,15,243
2025-07-11,12,2,SKU005,639,24,663
2025-07-11,12,3,SKU030,516,65,581
2025-07-11,13,2,SKU007,694,3,697
2025-07-11,14,1,SKU001,299,27,326
2025-07-11,14,2,SKU032,363,26,389
2025-07-11,14,3,SKU039,795,39,834
2025-07-11,15,3,SKU039,741,5,746
2025-07-12,1,1,SKU029,609,4,613
2025-07-12,1,2,SKU002,359,2,361
2025-07-12,1,3,SKU029,605,40,645
2025-07-12,2,1,SKU010,251,36,287
2025-07-12,2,2,SKU024,361,40,401
2025-07-12,2,3,SKU027,464,36,500
2025-07-12,3,1,SKU010,355,35,390
2025-07-12,3,2,SKU033,626,14,640
2025-07-12,3,3,SKU021,649,2,651
2025-07-12,5,2,SKU037,752,70,822
2025-07-12,5,3,SKU015,798,68,866
2025-07-12,6,1,SKU009,608,69,677
2025-07-12,6,2,SKU020,225,1,226
2025-07-12,7,1,SKU022,203,23,226
2025-07-12,7,2,SKU022,669,74,743
2025-07-12,7,3,SKU014,464,51,515
2025-07-12,8,1,SKU027,459,31,490
2025-07-12,8,2,SKU015,703,92,795
2025-07-12,8,3,SKU011,662,29,691
2025-07-12,9,1,SKU039,414,44,458
2025-07-12,9,2,SKU020,498,39,537
2025-07-12,9,3,SKU028,339,30,369
2025-07-12,10,1,SKU032,758,74,832
2025-07-12,10,2,SKU008,388,22,410
2025-07-12,10,3,SKU024,797,98,895
2025-07-12,11,1,SKU031,228,3,231
2025-07-12,11,2,SKU035,467,4,471
2025-07-12,11,3,SKU012,788,100,888
2025-07-12,12,2,SKU009,652,43,695
2025-07-12,12,3,SKU034,730,107,837
2025-07-12,13,1,SKU027,261,26,287
2025-07-12,13,2,SKU018,655,74,729
2025-07-12,13,3,SKU018,226,25,251
2025-07-12,14,1,SKU010,774,105,879
2025-07-12,14,2,SKU020,720,60,780
2025-07-12,15,1,SKU008,683,81,764
2025-07-13,1,1,SKU028,729,40,769
2025-07-13,1,2,SKU030,419,12,431
2025-07-13,1,3,SKU039,618,0,618
2025-07-13,2,1,SKU006,369,30,399
2025-07-13,2,2,SKU004,698,42,740
2025-07-13,3,1,SKU019,200,8,208
2025-07-13,3,2,SKU014,377,47,424
2025-07-13,3,3,SKU038,394,31,425
2025-07-13,4,2,SKU022,505,24,529
2025-07-13,5,1,SKU018,426,23,449
2025-07-13,5,2,SKU020,376,28,404
2025-07-13,5,3,SKU032,575,73,648
2025-07-13,6,1,SKU015,344,21,365
2025-07-13,6,2,SKU005,201,17,218
2025-07-13,6,3,SKU021,764,27,791
2025-07-13,7,1,SKU008,467,17,484
2025-07-13,7,2,SKU035,272,6,278
2025-07-13,7,3,SKU032,438,9,447
2025-07-13,8,1,SKU015,450,2,452
2025-07-13,8,2,SKU013,290,7,297
2025-07-13,8,3,SKU022,755,110,865
2025-07-13,9,1,SKU014,458,12,470
2025-07-13,9,3,SKU019,325,45,370
2025-07-13,10,1,SKU024,403,2,405
2025-07-13,10,2,SKU009,328,16,344
2025-07-13,10,3,SKU017,770,56,826
2025-07-13,11,1,SKU018,603,40,643
2025-07-13,11,2,SKU009,361,27,388
2025-07-13,11,3,SKU008,796,5,801
2025-07-13,12,1,SKU010,594,75,669
2025-07-13,12,2,SKU034,422,7,429
2025-07-13,13,1,SKU031,380,45,425
2025-07-13,14,1,SKU032,230,7,237
2025-07-13,14,2,SKU021,574,20,594
2025-07-13,14,3,SKU034,219,6,225
2025-07-13,15,1,SKU035,294,2,296
2025-07-13,15,2,SKU012,734,92,826
2025-07-13,15,3,SKU008,299,14,313
2025-07-14,1,1,SKU007,312,21,333
2025-07-14,1,2,SKU010,235,21,256
2025-07-14,1,3,SKU033,787,90,877
2025-07-14,2,1,SKU014,229,21,250
2025-07-14,2,3,SKU035,713,41,754
2025-07-14,3,1,SKU017,204,22,226
2025-07-14,3,2,SKU015,465,39,504
2025-07-14,3,3,SKU005,314,3,317
2025-07-14,4,1,SKU029,336,45,381
2025-07-14,4,2,SKU022,235,0,235
2025-07-14,5,1,SKU027,641,14,655
2025-07-14,5,2,SKU037,557,27,584
2025-07-14,5,3,SKU035,379,18,397
2025-07-14,6,1,SKU019,390,12,402
2025-07-14,6,2,SKU003,666,91,757
2025-07-14,6,3,SKU016,442,19,461
2025-07-14,7,1,SKU037,776,67,843
2025-07-14,7,2,SKU035,534,9,543
2025-07-14,7,3,SKU001,491,34,525
2025-07-14,8,2,SKU013,388,24,412
2025-07-14,9,1,SKU010,523,11,534
2025-07-14,9,2,SKU001,288,35,323
2025-07-14,9,3,SKU038,300,36,336
2025-07-14,10,1,SKU025,233,17,250
2025-07-14,10,2,SKU001,674,75,749
2025-07-14,10,3,SKU014,219,12,231
2025-07-14,11,1,SKU019,599,63,662
2025-07-14,11,2,SKU031,241,33,274
2025-07-14,12,2,SKU016,768,36,804
2025-07-14,12,3,SKU012,439,26,465
2025-07-14,13,1,SKU038,783,38,821
2025-07-14,13,2,SKU022,246,4,250
2025-07-14,13,3,SKU023,368,9,377
2025-07-14,14,1,SKU018,653,63,716
2025-07-14,14,2,SKU021,542,80,622
2025-07-14,14,3,SKU018,330,43,373
2025-07-14,15,1,SKU003,563,75,638
2025-07-14,15,2,SKU024,494,61,555
2025-07-14,15,3,SKU036,705,92,797
2025-07-15,1,1,SKU003,781,36,817
2025-07-15,1,2,SKU019,773,95,868
2025-07-15,2,1,SKU027,403,20,423
2025-07-15,2,2,SKU017,265,0,265
2025-07-15,2,3,SKU025,358,29,387
2025-07-15,3,1,SKU031,381,0,381
2025-07-15,3,2,SKU036,383,13,396
2025-07-15,3,3,SKU015,617,58,675
2025-07-15,4,1,SKU037,608,21,629
2025-07-15,4,2,SKU026,399,32,431
2025-07-15,4,3,SKU017,223,2,225
2025-07-15,5,1,SKU011,645,61,706
2025-07-15,5,2,SKU008,744,9,753
2025-07-15,5,3,SKU037,553,36,589
2025-07-15,6,1,SKU038,360,35,395
2025-07-15,6,2,SKU013,689,61,750
2025-07-15,6,3,SKU021,530,0,530
2025-07-15,7,2,SKU011,750,17,767
2025-07-15,7,3,SKU006,466,47,513
2025-07-15,8,1,SKU027,536,40,576
2025-07-15,8,2,SKU039,499,18,517
2025-07-15,8,3,SKU005,514,31,545
2025-07-15,9,1,SKU014,268,38,306
2025-07-15,9,2,SKU036,764,50,814
2025-07-15,9,3,SKU032,451,24,475
2025-07-15,10,1,SKU034,284,24,308
2025-07-15,10,2,SKU001,695,22,717
2025-07-15,10,3,SKU006,383,52,435
2025-07-15,11,1,SKU014,770,99,869
2025-07-15,11,3,SKU032,291,27,318
2025-07-15,12,2,SKU015,279,32,311
2025-07-15,12,3,SKU030,662,95,757
2025-07-15,13,1,SKU032,347,42,389
2025-07-15,13,2,SKU040,702,39,741
2025-07-15,13,3,SKU036,576,41,617
2025-07-15,14,2,SKU022,397,53,450
2025-07-15,14,3,SKU034,668,80,748
2025-07-15,15,1,SKU040,798,60,858
2025-07-15,15,2,SKU007,774,47,821
2025-07-15,15,3,SKU018,708,61,769
2025-07-16,1,1,SKU040,736,2,738
2025-07-16,1,2,SKU016,769,73,842
2025-07-16,1,3,SKU021,258,4,262
2025-07-16,2,1,SKU033,252,6,258
2025-07-16,2,2,SKU033,453,42,495
2025-07-16,2,3,SKU040,477,51,528
2025-07-16,3,1,SKU032,589,59,648
2025-07-16,3,2,SKU002,778,29,807
2025-07-16,3,3,SKU020,750,30,780
2025-07-16,4,1,SKU020,232,6,238
2025-07-16,4,3,SKU003,294,6,300
2025-07-16,5,2,SKU002,697,83,780
2025-07-16,6,1,SKU032,345,12,357
2025-07-16,6,3,SKU026,359,25,384
2025-07-16,7,1,SKU011,401,33,434
2025-07-16,7,3,SKU020,317,21,338
2025-07-16,8,1,SKU030,638,29,667
2025-07-16,8,2,SKU001,536,2,538
2025-07-16,9,1,SKU021,319,7,326
2025-07-16,9,2,SKU011,595,38,633
2025-07-16,10,1,SKU016,314,9,323
2025-07-16,10,2,SKU017,622,77,699
2025-07-16,10,3,SKU023,457,61,518
2025-07-16,11,2,SKU002,378,0,378
2025-07-16,11,3,SKU003,624,61,685
2025-07-16,12,2,SKU010,341,32,373
2025-07-16,13,1,SKU038,695,90,785
2025-07-16,13,2,SKU009,267,1,268
2025-07-16,13,3,SKU031,381,18,399
2025-07-16,14,1,SKU025,458,13,471
2025-07-16,14,2,SKU036,462,16,478
2025-07-16,14,3,SKU022,710,103,813
2025-07-16,15,1,SKU016,634,92,726
2025-07-16,15,2,SKU002,332,34,366
2025-07-17,1,3,SKU028,278,14,292
2025-07-17,2,1,SKU008,662,73,735
2025-07-17,2,2,SKU035,374,18,392
2025-07-17,3,1,SKU028,675,78,753
2025-07-17,3,3,SKU017,665,72,737
2025-07-17,4,2,SKU024,709,54,763
2025-07-17,4,3,SKU013,214,16,230
2025-07-17,5,1,SKU006,675,46,721
2025-07-17,5,2,SKU003,554,23,577
2025-07-17,6,2,SKU016,421,55,476
2025-07-17,6,3,SKU008,525,6,531
2025-07-17,7,2,SKU036,321,5,326
2025-07-17,7,3,SKU004,388,2,390
2025-07-17,8,1,SKU030,694,84,778
2025-07-17,8,2,SKU037,704,11,715
2025-07-17,8,3,SKU025,212,29,241
2025-07-17,9,1,SKU033,592,26,618
2025-07-17,10,2,SKU023,401,7,408
2025-07-17,11,1,SKU004,753,92,845
2025-07-17,11,3,SKU030,709,18,727
2025-07-17,12,2,SKU018,394,55,449
2025-07-17,12,3,SKU027,719,98,817
2025-07-17,13,1,SKU016,731,3,734
2025-07-17,13,2,SKU028,260,12,272
2025-07-17,13,3,SKU010,724,69,793
2025-07-17,14,1,SKU017,570,14,584
2025-07-17,14,2,SKU011,754,86,840
2025-07-17,14,3,SKU028,723,101,824
2025-07-17,15,1,SKU037,786,22,808
2025-07-17,15,2,SKU005,469,65,534
2025-07-17,15,3,SKU012,396,27,423
2025-07-18,1,1,SKU023,407,21,428
2025-07-18,1,2,SKU032,575,73,648
2025-07-18,1,3,SKU006,709,45,754
2025-07-18,2,1,SKU033,643,28,671
2025-07-18,2,3,SKU002,576,77,653
2025-07-18,3,1,SKU037,650,6,656
2025-07-18,3,2,SKU031,517,6,523
2025-07-18,4,1,SKU038,510,8,518
2025-07-18,4,2,SKU009,451,63,514
2025-07-18,4,3,SKU031,328,7,335
2025-07-18,5,1,SKU027,313,37,350
2025-07-18,5,2,SKU032,578,64,642
2025-07-18,5,3,SKU011,799,37,836
2025-07-18,6,1,SKU018,468,55,523
2025-07-18,6,2,SKU025,763,20,783
2025-07-18,6,3,SKU007,625,88,713
2025-07-18,7,1,SKU004,687,11,698
2025-07-18,7,2,SKU006,486,70,556
2025-07-18,7,3,SKU039,581,42,623
2025-07-18,8,2,SKU024,250,9,259
2025-07-18,8,3,SKU008,686,84,770
2025-07-18,9,1,SKU011,405,12,417
2025-07-18,9,2,SKU008,260,0,260
2025-07-18,10,2,SKU024,462,0,462
2025-07-18,10,3,SKU022,675,56,731
2025-07-18,11,1,SKU033,460,44,504
2025-07-18,11,2,SKU025,390,20,410
2025-07-18,12,1,SKU022,373,39,412
2025-07-18,12,3,SKU022,746,11,757
2025-07-18,13,1,SKU016,633,39,672
2025-07-18,13,2,SKU037,563,1,564
2025-07-18,13,3,SKU003,536,10,546
2025-07-18,14,1,SKU003,326,47,373
2025-07-18,14,2,SKU026,680,88,768
2025-07-19,1,1,SKU001,436,15,451
2025-07-19,1,2,SKU018,345,8,353
2025-07-19,2,1,SKU028,728,2,730
2025-07-19,2,2,SKU036,720,39,759
2025-07-19,2,3,SKU028,461,10,471
2025-07-19,3,1,SKU040,786,62,848
2025-07-19,3,2,SKU020,689,16,705
2025-07-19,3,3,SKU034,502,47,549
2025-07-19,4,2,SKU016,499,1,500
2025-07-19,4,3,SKU018,713,53,766
2025-07-19,5,1,SKU027,503,61,564
2025-07-19,5,3,SKU018,604,81,685
2025-07-19,6,1,SKU008,752,16,768
2025-07-19,6,3,SKU038,694,70,764
2025-07-19,7,1,SKU029,771,49,820
2025-07-19,7,2,SKU035,591,71,662
2025-07-19,7,3,SKU009,237,14,251
2025-07-19,8,1,SKU013,665,63,728
2025-07-19,8,3,SKU039,269,6,275
2025-07-19,9,1,SKU003,551,79,630
2025-07-19,9,3,SKU036,398,19,417
2025-07-19,10,1,SKU036,380,27,407
2025-07-19,10,2,SKU036,794,1,795
2025-07-19,11,1,SKU014,419,59,478
2025-07-19,11,2,SKU039,394,17,411
2025-07-19,11,3,SKU022,303,17,320
2025-07-19,12,1,SKU013,214,17,231
2025-07-19,12,3,SKU022,560,22,582
2025-07-19,13,1,SKU025,318,29,347
2025-07-19,13,3,SKU018,297,36,333
2025-07-19,14,3,SKU022,633,52,685
2025-07-19,15,1,SKU015,267,25,292
2025-07-19,15,2,SKU028,358,31,389
2025-07-20,1,1,SKU013,400,20,420
2025-07-20,1,2,SKU015,250,31,281
2025-07-20,1,3,SKU013,745,62,807
2025-07-20,2,1,SKU022,245,4,249
2025-07-20,2,2,SKU018,331,47,378
2025-07-20,2,3,SKU020,391,26,417
2025-07-20,3,1,SKU011,405,16,421
2025-07-20,3,2,SKU033,562,25,587
2025-07-20,3,3,SKU023,241,35,276
2025-07-20,4,1,SKU015,707,105,812
2025-07-20,4,2,SKU028,289,29,318
2025-07-20,4,3,SKU034,761,44,805
2025-07-20,5,3,SKU025,333,13,346
2025-07-20,6,1,SKU001,708,63,771
2025-07-20,6,2,SKU006,650,21,671
2025-07-20,6,3,SKU033,384,29,413
2025-07-20,7,2,SKU005,302,41,343
2025-07-20,7,3,SKU018,588,73,661
2025-07-20,8,2,SKU023,397,13,410
2025-07-20,8,3,SKU017,795,15,810
2025-07-20,9,1,SKU009,785,32,817
2025-07-20,9,2,SKU023,702,20,722
2025-07-20,9,3,SKU018,703,93,796
2025-07-20,10,1,SKU003,770,106,876
2025-07-20,10,2,SKU007,239,4,243
2025-07-20,10,3,SKU011,469,63,532
2025-07-20,11,1,SKU036,387,46,433
2025-07-20,11,2,SKU040,248,10,258
2025-07-20,11,3,SKU025,674,77,751
2025-07-20,12,1,SKU038,425,53,478
2025-07-20,12,2,SKU008,700,96,796
2025-07-20,13,1,SKU009,321,41,362
2025-07-20,13,2,SKU035,693,51,744
2025-07-20,13,3,SKU031,654,41,695
2025-07-20,14,1,SKU039,703,20,723
2025-07-20,14,2,SKU007,313,13,326
2025-07-20,14,3,SKU006,210,13,223
2025-07-20,15,1,SKU030,774,27,801
2025-07-20,15,2,SKU040,624,28,652
2025-07-20,15,3,SKU024,754,106,860
2025-07-21,1,2,SKU033,419,20,439
2025-07-21,1,3,SKU008,341,10,351
2025-07-21,2,1,SKU039,528,46,574
2025-07-21,2,2,SKU017,224,28,252
2025-07-21,3,1,SKU012,251,10,261
2025-07-21,3,2,SKU011,328,29,357
2025-07-21,3,3,SKU031,539,71,610
2025-07-21,4,1,SKU002,285,15,300
2025-07-21,4,2,SKU028,522,71,593
2025-07-21,5,2,SKU003,640,45,685
2025-07-21,5,3,SKU032,601,21,622
2025-07-21,6,1,SKU023,477,44,521
2025-07-21,6,2,SKU006,608,19,627
2025-07-21,6,3,SKU010,590,37,627
2025-07-21,7,1,SKU015,359,0,359
2025-07-21,7,3,SKU028,388,55,443
2025-07-21,8,3,SKU017,263,25,288
2025-07-21,9,1,SKU026,633,17,650
2025-07-21,9,2,SKU031,670,14,684
2025-07-21,9,3,SKU020,697,36,733
2025-07-21,10,1,SKU019,484,60,544
2025-07-21,10,2,SKU006,304,43,347
2025-07-21,10,3,SKU040,519,74,593
2025-07-21,11,1,SKU037,657,42,699
2025-07-21,11,2,SKU036,652,63,715
2025-07-21,12,1,SKU002,469,47,516
2025-07-21,12,2,SKU010,664,55,719
2025-07-21,12,3,SKU013,244,31,275
2025-07-21,13,1,SKU002,744,95,839
2025-07-21,13,2,SKU008,237,24,261
2025-07-21,13,3,SKU003,492,13,505
2025-07-21,14,1,SKU003,316,41,357
2025-07-21,14,2,SKU037,444,50,494
2025-07-21,14,3,SKU008,204,1,205
2025-07-21,15,1,SKU007,268,13,281
2025-07-21,15,2,SKU033,311,44,355
2025-07-21,15,3,SKU018,217,24,241
2025-07-22,1,2,SKU016,376,46,422
2025-07-22,1,3,SKU009,566,56,622
2025-07-22,2,1,SKU023,321,18,339
2025-07-22,2,2,SKU004,512,58,570
2025-07-22,2,3,SKU032,483,46,529
2025-07-22,3,1,SKU031,399,35,434
2025-07-22,3,3,SKU015,517,56,573
2025-07-22,4,2,SKU040,544,40,584
2025-07-22,4,3,SKU023,473,8,481
2025-07-22,5,1,SKU012,236,8,244
2025-07-22,5,3,SKU028,597,16,613
2025-07-22,6,1,SKU002,649,96,745
2025-07-22,6,2,SKU024,255,30,285
2025-07-22,7,1,SKU028,344,31,375
2025-07-22,7,2,SKU035,676,18,694
2025-07-22,7,3,SKU025,508,71,579
2025-07-22,8,1,SKU004,679,49,728
2025-07-22,8,2,SKU018,613,85,698
2025-07-22,8,3,SKU040,727,106,833
2025-07-22,9,1,SKU019,589,52,641
2025-07-22,9,2,SKU002,214,15,229
2025-07-22,9,3,SKU040,374,25,399
2025-07-22,10,1,SKU034,549,41,590
2025-07-22,10,3,SKU019,320,34,354
2025-07-22,11,1,SKU001,661,21,682
2025-07-22,11,2,SKU029,453,27,480
2025-07-22,11,3,SKU005,740,71,811
2025-07-22,12,1,SKU007,303,20,323
2025-07-22,12,2,SKU009,344,26,370
2025-07-22,12,3,SKU020,677,59,736
2025-07-22,13,1,SKU008,699,12,711
2025-07-22,13,2,SKU034,535,69,604
2025-07-22,13,3,SKU004,412,35,447
2025-07-22,14,2,SKU024,516,61,577
2025-07-22,14,3,SKU021,599,27,626
2025-07-22,15,1,SKU023,611,40,651
2025-07-22,15,2,SKU037,209,16,225
2025-07-22,15,3,SKU004,421,26,447
2025-07-23,1,1,SKU009,578,35,613
2025-07-23,1,2,SKU039,439,21,460
2025-07-23,1,3,SKU027,514,42,556
2025-07-23,2,1,SKU003,238,12,250
2025-07-23,2,2,SKU016,589,37,626
2025-07-23,2,3,SKU038,496,34,530
2025-07-23,3,3,SKU002,695,75,770
2025-07-23,4,1,SKU002,767,34,801
2025-07-23,4,2,SKU025,579,16,595
2025-07-23,5,1,SKU017,381,3,384
2025-07-23,5,3,SKU020,710,15,725
2025-07-23,6,1,SKU013,233,25,258
2025-07-23,6,3,SKU009,608,73,681
2025-07-23,7,1,SKU016,725,52,777
2025-07-23,7,2,SKU009,733,30,763
2025-07-23,7,3,SKU034,450,4,454
2025-07-23,8,1,SKU014,287,7,294
2025-07-23,8,2,SKU009,594,25,619
2025-07-23,8,3,SKU030,634,61,695
2025-07-23,9,1,SKU024,356,35,391
2025-07-23,9,2,SKU025,201,19,220
2025-07-23,9,3,SKU035,318,23,341
2025-07-23,10,1,SKU001,234,0,234
2025-07-23,10,2,SKU006,306,41,347
2025-07-23,11,2,SKU038,450,22,472
2025-07-23,11,3,SKU022,353,7,360
2025-07-23,12,1,SKU023,266,15,281
2025-07-23,12,2,SKU019,565,2,567
2025-07-23,12,3,SKU019,431,20,451
2025-07-23,13,1,SKU020,244,31,275
2025-07-23,13,2,SKU024,307,12,319
2025-07-23,14,1,SKU026,790,55,845
2025-07-23,14,2,SKU038,205,18,223
2025-07-23,14,3,SKU038,260,27,287
2025-07-23,15,1,SKU031,619,52,671
2025-07-23,15,2,SKU029,239,28,267
2025-07-24,1,1,SKU023,222,10,232
2025-07-24,1,2,SKU012,537,71,608
2025-07-24,2,1,SKU021,567,5,572
2025-07-24,2,2,SKU009,600,18,618
2025-07-24,2,3,SKU016,257,10,267
2025-07-24,3,1,SKU032,722,85,807
2025-07-24,3,2,SKU009,599,49,648
2025-07-24,4,1,SKU013,381,6,387
2025-07-24,4,2,SKU001,258,19,277
2025-07-24,4,3,SKU028,522,18,540
2025-07-24,5,1,SKU031,266,4,270
2025-07-24,5,3,SKU040,607,61,668
2025-07-24,6,1,SKU037,381,43,424
2025-07-24,6,3,SKU014,772,103,875
2025-07-24,7,1,SKU027,530,6,536
2025-07-24,7,2,SKU021,269,7,276
2025-07-24,7,3,SKU022,266,38,304
2025-07-24,8,1,SKU018,487,70,557
2025-07-24,8,2,SKU009,410,5,415
2025-07-24,9,1,SKU038,787,9,796
2025-07-24,9,2,SKU020,415,15,430
2025-07-24,9,3,SKU034,369,16,385
2025-07-24,10,1,SKU008,225,32,257
2025-07-24,10,2,SKU007,587,62,649
2025-07-24,10,3,SKU022,689,54,743
2025-07-24,11,1,SKU038,718,20,738
2025-07-24,11,2,SKU037,777,19,796
2025-07-24,11,3,SKU005,356,1,357
2025-07-24,12,2,SKU022,594,41,635
2025-07-24,12,3,SKU025,665,11,676
2025-07-24,13,1,SKU038,532,50,582
2025-07-24,13,2,SKU023,658,92,750
2025-07-24,13,3,SKU029,453,24,477
2025-07-24,14,1,SKU002,403,58,461
2025-07-24,14,2,SKU004,213,4,217
2025-07-24,15,1,SKU030,676,85,761
2025-07-24,15,3,SKU020,261,35,296
2025-07-25,1,2,SKU015,235,10,245
2025-07-25,1,3,SKU037,699,17,716
2025-07-25,2,1,SKU025,274,13,287
2025-07-25,2,2,SKU032,660,8,668
2025-07-25,2,3,SKU021,413,1,414
2025-07-25,3,1,SKU021,540,69,609
2025-07-25,3,2,SKU024,527,32,559
2025-07-25,3,3,SKU031,294,7,301
2025-07-25,4,1,SKU014,561,24,585
2025-07-25,4,3,SKU015,297,36,333
2025-07-25,5,1,SKU019,201,3,204
2025-07-25,5,2,SKU023,302,12,314
2025-07-25,6,1,SKU008,239,15,254
2025-07-25,6,2,SKU022,242,7,249
2025-07-25,6,3,SKU014,443,31,474
2025-07-25,7,1,SKU027,507,36,543
2025-07-25,7,2,SKU021,624,4,628
2025-07-25,7,3,SKU028,515,20,535
2025-07-25,8,1,SKU021,658,91,749
2025-07-25,8,2,SKU027,494,0,494
2025-07-25,8,3,SKU009,708,61,769
2025-07-25,9,1,SKU030,604,82,686
2025-07-25,9,2,SKU031,259,3,262
2025-07-25,9,3,SKU027,663,13,676
2025-07-25,10,2,SKU009,455,4,459
2025-07-25,10,3,SKU017,799,39,838
2025-07-25,11,2,SKU040,451,58,509
2025-07-25,11,3,SKU009,723,106,829
2025-07-25,12,1,SKU021,215,1,216
2025-07-25,12,2,SKU011,601,85,686
2025-07-25,12,3,SKU008,796,29,825
2025-07-25,13,1,SKU035,405,7,412
2025-07-25,13,2,SKU007,688,68,756
2025-07-25,13,3,SKU023,253,28,281
2025-07-25,14,1,SKU013,371,34,405
2025-07-25,14,3,SKU019,467,58,525
2025-07-25,15,1,SKU020,768,113,881
2025-07-25,15,2,SKU040,270,24,294
2025-07-25,15,3,SKU003,277,27,304
2025-07-26,1,1,SKU005,454,17,471
2025-07-26,1,2,SKU010,348,12,360
2025-07-26,1,3,SKU025,604,52,656
2025-07-26,2,1,SKU001,628,43,671
2025-07-26,2,2,SKU002,313,37,350
2025-07-26,2,3,SKU039,347,16,363
2025-07-26,3,1,SKU001,328,27,355
2025-07-26,3,2,SKU038,670,58,728
2025-07-26,3,3,SKU009,746,9,755
2025-07-26,4,1,SKU038,548,54,602
2025-07-26,4,2,SKU025,596,35,631
2025-07-26,4,3,SKU010,536,61,597
2025-07-26,5,2,SKU022,670,59,729
2025-07-26,5,3,SKU038,404,52,456
2025-07-26,6,1,SKU003,509,66,575
2025-07-26,6,2,SKU003,735,43,778
2025-07-26,6,3,SKU039,335,6,341
2025-07-26,7,2,SKU040,702,11,713
2025-07-26,7,3,SKU022,317,33,350
2025-07-26,8,1,SKU031,507,45,552
2025-07-26,8,2,SKU018,776,70,846
2025-07-26,8,3,SKU018,566,43,609
2025-07-26,9,1,SKU005,269,21,290
2025-07-26,9,2,SKU036,546,0,546
2025-07-26,10,1,SKU027,434,48,482
2025-07-26,10,2,SKU032,518,46,564
2025-07-26,10,3,SKU024,276,4,280
2025-07-26,11,1,SKU039,258,1,259
2025-07-26,11,2,SKU011,318,34,352
2025-07-26,12,1,SKU034,695,9,704
2025-07-26,12,2,SKU030,426,13,439
2025-07-26,12,3,SKU040,308,28,336
2025-07-26,13,3,SKU030,458,45,503
2025-07-26,14,1,SKU021,517,66,583
2025-07-26,14,3,SKU033,686,87,773
2025-07-26,15,1,SKU035,654,96,750
2025-07-26,15,2,SKU024,210,1,211
2025-07-26,15,3,SKU011,279,15,294
2025-07-27,1,1,SKU011,673,93,766
2025-07-27,1,2,SKU013,247,27,274
2025-07-27,1,3,SKU034,756,5,761
2025-07-27,2,1,SKU034,630,47,677
2025-07-27,2,2,SKU006,740,8,748
2025-07-27,2,3,SKU040,692,42,734
2025-07-27,3,1,SKU020,796,8,804
2025-07-27,3,2,SKU011,562,74,636
2025-07-27,3,3,SKU005,492,25,517
2025-07-27,4,2,SKU026,445,3,448
2025-07-27,5,3,SKU027,379,49,428
2025-07-27,6,1,SKU002,412,56,468
2025-07-27,6,2,SKU039,266,24,290
2025-07-27,6,3,SKU006,584,20,604
2025-07-27,7,1,SKU017,555,31,586
2025-07-27,7,2,SKU016,423,52,475
2025-07-27,8,1,SKU011,667,92,759
2025-07-27,8,2,SKU025,521,15,536
2025-07-27,8,3,SKU032,773,36,809
2025-07-27,9,1,SKU030,394,24,418
2025-07-27,9,2,SKU025,322,38,360
2025-07-27,9,3,SKU018,370,27,397
2025-07-27,10,1,SKU007,597,88,685
2025-07-27,10,2,SKU005,269,6,275
2025-07-27,10,3,SKU036,242,9,251
2025-07-27,11,1,SKU010,676,10,686
2025-07-27,11,2,SKU002,571,83,654
2025-07-27,11,3,SKU024,670,54,724
2025-07-27,12,2,SKU022,425,50,475
2025-07-27,12,3,SKU002,290,3,293
2025-07-27,13,1,SKU001,313,39,352
2025-07-27,13,2,SKU031,492,21,513
2025-07-27,13,3,SKU005,247,23,270
2025-07-27,14,1,SKU022,799,21,820
2025-07-27,14,3,SKU015,350,33,383
2025-07-27,15,1,SKU014,656,19,675
2025-07-27,15,2,SKU010,361,18,379
2025-07-28,1,1,SKU025,567,1,568
2025-07-28,1,2,SKU017,526,6,532
2025-07-28,2,1,SKU033,504,61,565
2025-07-28,2,2,SKU002,587,6,593
2025-07-28,2,3,SKU022,679,32,711
2025-07-28,3,1,SKU009,355,49,404
2025-07-28,3,2,SKU001,654,26,680
2025-07-28,4,1,SKU011,616,12,628
2025-07-28,4,3,SKU021,646,12,658
2025-07-28,5,1,SKU040,696,94,790
2025-07-28,5,2,SKU028,682,70,752
2025-07-28,5,3,SKU010,244,33,277
2025-07-28,6,1,SKU010,475,20,495
2025-07-28,6,2,SKU040,687,8,695
2025-07-28,7,2,SKU040,432,6,438
2025-07-28,7,3,SKU015,395,35,430
2025-07-28,8,1,SKU036,330,48,378
2025-07-28,8,2,SKU035,368,7,375
2025-07-28,8,3,SKU028,386,38,424
2025-07-28,9,1,SKU040,492,33,525
2025-07-28,9,2,SKU003,318,2,320
2025-07-28,9,3,SKU007,683,77,760
2025-07-28,10,2,SKU011,241,13,254
2025-07-28,10,3,SKU027,731,108,839
2025-07-28,11,1,SKU037,239,0,239
2025-07-28,11,2,SKU032,718,50,768
2025-07-28,11,3,SKU037,307,6,313
2025-07-28,12,1,SKU018,365,21,386
2025-07-28,12,3,SKU017,547,22,569
2025-07-28,13,1,SKU008,686,7,693
2025-07-28,13,2,SKU039,576,24,600
2025-07-28,13,3,SKU019,328,7,335
2025-07-28,14,1,SKU024,374,47,421
2025-07-28,14,2,SKU023,513,15,528
2025-07-28,14,3,SKU024,299,2,301
2025-07-28,15,1,SKU026,224,20,244
2025-07-28,15,2,SKU016,616,44,660
2025-07-28,15,3,SKU031,547,23,570
2025-07-29,1,2,SKU029,799,7,806
2025-07-29,1,3,SKU023,533,60,593
2025-07-29,2,1,SKU007,698,28,726
2025-07-29,2,2,SKU019,462,15,477
2025-07-29,2,3,SKU024,321,24,345
2025-07-29,3,1,SKU020,533,6,539
2025-07-29,3,2,SKU016,673,44,717
2025-07-29,3,3,SKU010,719,55,774
2025-07-29,4,1,SKU020,247,0,247
2025-07-29,4,2,SKU029,768,96,864
2025-07-29,5,1,SKU022,683,16,699
2025-07-29,5,3,SKU023,486,13,499
2025-07-29,6,1,SKU027,393,38,431
2025-07-29,6,2,SKU028,529,23,552
2025-07-29,6,3,SKU022,227,16,243
2025-07-29,7,1,SKU003,472,40,512
2025-07-29,7,2,SKU007,691,55,746
2025-07-29,7,3,SKU037,616,15,631
2025-07-29,8,1,SKU013,510,75,585
2025-07-29,8,3,SKU035,357,39,396
2025-07-29,9,3,SKU030,401,45,446
2025-07-29,10,2,SKU018,255,20,275
2025-07-29,11,1,SKU031,620,28,648
2025-07-29,11,2,SKU033,203,21,224
2025-07-29,12,1,SKU030,493,42,535
2025-07-29,12,2,SKU002,580,33,613
2025-07-29,12,3,SKU039,370,34,404
2025-07-29,13,1,SKU010,401,4,405
2025-07-29,13,2,SKU014,489,10,499
2025-07-29,13,3,SKU040,269,26,295
2025-07-29,14,1,SKU028,422,23,445
2025-07-29,14,2,SKU039,735,30,765
2025-07-29,14,3,SKU003,362,24,386
2025-07-29,15,1,SKU009,219,24,243
2025-07-29,15,3,SKU016,330,7,337
2025-07-30,1,1,SKU016,523,50,573
2025-07-30,2,2,SKU026,586,38,624
2025-07-30,2,3,SKU027,568,69,637
2025-07-30,3,1,SKU011,769,102,871
2025-07-30,3,2,SKU015,726,95,821
2025-07-30,3,3,SKU025,299,30,329
2025-07-30,4,1,SKU009,434,36,470
2025-07-30,4,2,SKU034,681,60,741
2025-07-30,4,3,SKU017,693,23,716
2025-07-30,5,1,SKU023,634,46,680
2025-07-30,5,2,SKU038,419,27,446
2025-07-30,5,3,SKU015,740,40,780
2025-07-30,6,1,SKU006,427,10,437
2025-07-30,6,2,SKU024,704,3,707
2025-07-30,6,3,SKU002,358,32,390
2025-07-30,7,1,SKU035,756,97,853
2025-07-30,7,2,SKU023,591,57,648
2025-07-30,7,3,SKU031,720,11,731
2025-07-30,8,3,SKU032,304,38,342
2025-07-30,9,1,SKU034,548,64,612
2025-07-30,9,2,SKU002,334,45,379
2025-07-30,10,1,SKU008,689,54,743
2025-07-30,10,2,SKU033,610,33,643
2025-07-30,10,3,SKU011,668,92,760
2025-07-30,11,1,SKU031,643,71,714
2025-07-30,11,2,SKU018,370,50,420
2025-07-30,11,3,SKU032,665,54,719
2025-07-30,12,1,SKU012,351,18,369
2025-07-30,12,2,SKU002,721,1,722
2025-07-30,12,3,SKU004,473,24,497
2025-07-30,13,1,SKU011,619,59,678
2025-07-30,13,2,SKU033,497,50,547
2025-07-30,13,3,SKU012,534,56,590
2025-07-30,14,1,SKU036,474,38,512
2025-07-30,14,3,SKU023,586,60,646
2025-07-30,15,1,SKU027,592,68,660
2025-07-30,15,2,SKU012,283,18,301
2025-07-30,15,3,SKU026,722,91,813
2025-07-31,1,1,SKU026,267,5,272
2025-07-31,1,2,SKU029,367,43,410
2025-07-31,1,3,SKU018,213,29,242
2025-07-31,2,1,SKU016,380,22,402
2025-07-31,2,2,SKU002,200,5,205
2025-07-31,2,3,SKU019,348,49,397
2025-07-31,3,1,SKU012,396,41,437
2025-07-31,3,2,SKU019,664,33,697
2025-07-31,3,3,SKU031,439,58,497
2025-07-31,4,1,SKU030,374,6,380
2025-07-31,4,2,SKU020,467,12,479
2025-07-31,4,3,SKU023,513,24,537
2025-07-31,5,1,SKU021,661,15,676
2025-07-31,5,2,SKU002,304,34,338
2025-07-31,5,3,SKU015,474,66,540
2025-07-31,6,1,SKU008,716,43,759
2025-07-31,6,2,SKU035,579,3,582
2025-07-31,6,3,SKU003,353,3,356
2025-07-31,7,2,SKU037,316,40,356
2025-07-31,7,3,SKU005,257,20,277
2025-07-31,8,1,SKU006,633,10,643
2025-07-31,8,2,SKU040,607,27,634
2025-07-31,8,3,SKU005,290,37,327
2025-07-31,9,1,SKU029,522,77,599
2025-07-31,9,2,SKU030,634,7,641
2025-07-31,9,3,SKU038,646,13,659
2025-07-31,10,1,SKU037,598,56,654
2025-07-31,10,2,SKU005,391,3,394
2025-07-31,10,3,SKU005,284,23,307
2025-07-31,11,1,SKU032,371,45,416
2025-07-31,11,2,SKU001,296,5,301
2025-07-31,11,3,SKU031,755,14,769
2025-07-31,12,1,SKU024,376,4,380
2025-07-31,12,2,SKU025,709,42,751
2025-07-31,12,3,SKU001,524,76,600
2025-07-31,13,1,SKU040,730,85,815
2025-07-31,13,2,SKU039,654,88,742
2025-07-31,13,3,SKU018,654,62,716
2025-07-31,14,1,SKU015,703,63,766
2025-07-31,14,3,SKU019,516,1,517
2025-07-31,15,1,SKU020,549,22,571
2025-07-31,15,2,SKU037,362,33,395
2025-07-31,15,3,SKU003,333,47,380
2025-08-01,1,2,SKU020,408,23,431
2025-08-01,1,3,SKU004,727,53,780
2025-08-01,2,1,SKU008,369,40,409
2025-08-01,2,2,SKU014,366,4,370
2025-08-01,2,3,SKU006,378,51,429
2025-08-01,3,2,SKU039,431,0,431
2025-08-01,3,3,SKU012,356,28,384
2025-08-01,4,1,SKU012,540,65,605
2025-08-01,4,2,SKU022,235,31,266
2025-08-01,4,3,SKU030,315,22,337
2025-08-01,5,1,SKU035,613,8,621
2025-08-01,5,2,SKU040,538,6,544
2025-08-01,5,3,SKU029,548,72,620
2025-08-01,6,1,SKU002,684,45,729
2025-08-01,6,3,SKU013,389,46,435
2025-08-01,7,1,SKU038,669,7,676
2025-08-01,7,2,SKU032,661,9,670
2025-08-01,7,3,SKU016,725,80,805
2025-08-01,8,1,SKU001,621,76,697
2025-08-01,8,3,SKU022,605,56,661
2025-08-01,9,1,SKU023,582,31,613
2025-08-01,9,2,SKU022,461,38,499
2025-08-01,9,3,SKU025,465,68,533
2025-08-01,10,1,SKU038,544,12,556
2025-08-01,10,2,SKU006,650,11,661
2025-08-01,10,3,SKU002,421,38,459
2025-08-01,11,1,SKU006,473,69,542
2025-08-01,11,2,SKU022,279,8,287
2025-08-01,11,3,SKU035,425,59,484
2025-08-01,12,1,SKU012,592,15,607
2025-08-01,12,2,SKU033,431,34,465
2025-08-01,12,3,SKU010,215,2,217
2025-08-01,13,1,SKU028,563,17,580
2025-08-01,13,2,SKU031,791,42,833
2025-08-01,14,1,SKU037,665,68,733
2025-08-01,14,2,SKU039,241,8,249
2025-08-01,14,3,SKU032,596,70,666
2025-08-01,15,1,SKU033,762,109,871
2025-08-01,15,2,SKU029,438,26,464
2025-08-01,15,3,SKU032,236,8,244
2025-08-02,1,1,SKU036,793,98,891
2025-08-02,1,3,SKU035,560,62,622
2025-08-02,2,1,SKU031,205,26,231
2025-08-02,2,2,SKU029,569,60,629
2025-08-02,2,3,SKU022,694,94,788
2025-08-02,3,1,SKU025,497,54,551
2025-08-02,3,2,SKU016,268,37,305
2025-08-02,3,3,SKU040,654,27,681
2025-08-02,4,2,SKU007,397,13,410
2025-08-02,4,3,SKU024,528,42,570
2025-08-02,5,1,SKU025,756,102,858
2025-08-02,5,2,SKU024,453,5,458
2025-08-02,5,3,SKU004,460,18,478
2025-08-02,6,1,SKU024,547,25,572
2025-08-02,6,2,SKU040,340,20,360
2025-08-02,6,3,SKU037,667,83,750
2025-08-02,7,2,SKU029,542,47,589
2025-08-02,7,3,SKU024,254,9,263
2025-08-02,8,1,SKU019,656,80,736
2025-08-02,8,3,SKU020,778,52,830
2025-08-02,9,1,SKU002,631,6,637
2025-08-02,9,2,SKU020,416,26,442
2025-08-02,9,3,SKU034,417,0,417
2025-08-02,10,1,SKU001,432,32,464
2025-08-02,10,2,SKU005,461,51,512
2025-08-02,10,3,SKU025,387,52,439
2025-08-02,11,1,SKU019,324,34,358
2025-08-02,11,2,SKU026,332,44,376
2025-08-02,11,3,SKU025,437,24,461
2025-08-02,12,1,SKU020,711,26,737
2025-08-02,12,2,SKU002,275,13,288
2025-08-02,12,3,SKU011,474,49,523
2025-08-02,13,1,SKU030,392,20,412
2025-08-02,13,2,SKU001,632,78,710
2025-08-02,13,3,SKU038,463,63,526
2025-08-02,14,1,SKU005,666,15,681
2025-08-02,14,2,SKU006,590,86,676
2025-08-02,15,1,SKU028,689,15,704
2025-08-02,15,2,SKU019,689,9,698
2025-08-02,15,3,SKU037,378,42,420
2025-08-03,1,1,SKU023,692,100,792
2025-08-03,1,2,SKU029,651,94,745
2025-08-03,1,3,SKU031,428,4,432
2025-08-03,2,1,SKU010,719,45,764
2025-08-03,2,2,SKU017,557,10,567
2025-08-03,2,3,SKU017,796,83,879
2025-08-03,3,2,SKU035,441,24,465
2025-08-03,3,3,SKU026,301,0,301
2025-08-03,4,1,SKU004,332,23,355
2025-08-03,4,2,SKU022,375,7,382
2025-08-03,4,3,SKU031,776,42,818
2025-08-03,5,1,SKU040,634,21,655
2025-08-03,6,1,SKU016,633,71,704
2025-08-03,6,2,SKU027,683,82,765
2025-08-03,6,3,SKU013,655,66,721
2025-08-03,7,1,SKU004,398,5,403
2025-08-03,7,3,SKU028,548,59,607
2025-08-03,8,1,SKU017,408,47,455
2025-08-03,8,2,SKU039,492,2,494
2025-08-03,8,3,SKU013,695,61,756
2025-08-03,9,1,SKU020,545,62,607
2025-08-03,9,2,SKU036,687,27,714
2025-08-03,9,3,SKU017,507,55,562
2025-08-03,10,1,SKU036,729,103,832
2025-08-03,10,3,SKU011,786,33,819
2025-08-03,11,1,SKU033,555,53,608
2025-08-03,11,2,SKU015,716,17,733
2025-08-03,11,3,SKU019,783,70,853
2025-08-03,12,1,SKU029,449,23,472
2025-08-03,12,2,SKU005,218,24,242
2025-08-03,12,3,SKU013,506,37,543
2025-08-03,13,1,SKU039,747,102,849
2025-08-03,13,2,SKU016,518,27,545
2025-08-03,13,3,SKU021,273,35,308
2025-08-03,14,1,SKU026,331,19,350
2025-08-03,14,3,SKU022,756,75,831
2025-08-03,15,1,SKU026,516,58,574
2025-08-03,15,2,SKU034,725,40,765
2025-08-03,15,3,SKU014,594,49,643
2025-08-04,1,1,SKU016,577,18,595
2025-08-04,1,2,SKU024,494,60,554
2025-08-04,1,3,SKU018,764,4,768
2025-08-04,2,1,SKU012,365,41,406
2025-08-04,2,2,SKU012,416,2,418
2025-08-04,2,3,SKU039,518,39,557
2025-08-04,3,1,SKU008,653,18,671
2025-08-04,3,2,SKU028,553,59,612
2025-08-04,3,3,SKU012,428,47,475
2025-08-04,4,1,SKU015,417,28,445
2025-08-04,4,2,SKU007,209,23,232
2025-08-04,4,3,SKU008,245,34,279
2025-08-04,5,1,SKU003,202,17,219
2025-08-04,5,2,SKU022,403,51,454
2025-08-04,5,3,SKU027,387,48,435
2025-08-04,6,1,SKU027,613,78,691
2025-08-04,6,2,SKU004,605,46,651
2025-08-04,6,3,SKU025,315,35,350
2025-08-04,7,1,SKU019,615,22,637
2025-08-04,7,2,SKU016,512,60,572
2025-08-04,7,3,SKU008,529,64,593
2025-08-04,8,1,SKU036,624,40,664
2025-08-04,8,2,SKU025,302,12,314
2025-08-04,8,3,SKU022,479,57,536
2025-08-04,9,1,SKU029,577,10,587
2025-08-04,9,2,SKU039,707,56,763
2025-08-04,10,1,SKU017,690,13,703
2025-08-04,10,2,SKU016,527,8,535
2025-08-04,10,3,SKU040,365,29,394
2025-08-04,11,1,SKU027,600,31,631
2025-08-04,11,2,SKU021,428,4,432
2025-08-04,11,3,SKU026,324,2,326
2025-08-04,12,1,SKU039,211,24,235
2025-08-04,12,2,SKU018,481,41,522
2025-08-04,12,3,SKU015,587,12,599
2025-08-04,13,1,SKU023,341,19,360
2025-08-04,13,2,SKU016,582,8,590
2025-08-04,13,3,SKU026,434,60,494
2025-08-04,14,2,SKU007,659,58,717
2025-08-04,14,3,SKU015,588,44,632
2025-08-04,15,1,SKU033,566,75,641
2025-08-04,15,2,SKU026,400,38,438
2025-08-04,15,3,SKU034,510,51,561
2025-08-05,1,1,SKU006,420,24,444
2025-08-05,1,2,SKU015,666,81,747
2025-08-05,1,3,SKU027,739,73,812
2025-08-05,2,2,SKU020,645,19,664
2025-08-05,2,3,SKU040,327,11,338
2025-08-05,3,1,SKU017,778,108,886
2025-08-05,3,2,SKU001,414,15,429
2025-08-05,3,3,SKU031,205,4,209
2025-08-05,4,1,SKU017,725,38,763
2025-08-05,4,2,SKU023,455,44,499
2025-08-05,4,3,SKU016,355,26,381
2025-08-05,5,1,SKU038,565,48,613
2025-08-05,6,1,SKU018,740,90,830
2025-08-05,6,2,SKU004,763,109,872
2025-08-05,6,3,SKU036,207,7,214
2025-08-05,7,1,SKU024,645,88,733
2025-08-05,7,2,SKU022,345,20,365
2025-08-05,7,3,SKU026,679,83,762
2025-08-05,8,1,SKU034,288,36,324
2025-08-05,8,2,SKU035,402,52,454
2025-08-05,8,3,SKU035,706,14,720
2025-08-05,9,1,SKU013,788,31,819
2025-08-05,9,2,SKU013,470,24,494
2025-08-05,9,3,SKU027,717,99,816
2025-08-05,10,1,SKU036,411,42,453
2025-08-05,10,2,SKU010,450,53,503
2025-08-05,10,3,SKU002,718,22,740
2025-08-05,11,1,SKU012,575,34,609
2025-08-05,11,2,SKU002,407,42,449
2025-08-05,11,3,SKU003,612,39,651
2025-08-05,12,1,SKU022,595,42,637
2025-08-05,12,3,SKU023,341,2,343
2025-08-05,13,1,SKU033,740,90,830
2025-08-05,13,2,SKU002,214,25,239
2025-08-05,14,1,SKU032,698,40,738
2025-08-05,14,2,SKU004,368,26,394
2025-08-05,14,3,SKU021,789,12,801
2025-08-05,15,1,SKU003,211,1,212
2025-08-05,15,2,SKU022,740,53,793
2025-08-05,15,3,SKU018,282,32,314
2025-08-06,1,2,SKU036,799,113,912
2025-08-06,1,3,SKU028,428,42,470
2025-08-06,2,1,SKU015,589,29,618
2025-08-06,2,2,SKU022,622,72,694
2025-08-06,2,3,SKU013,765,86,851
2025-08-06,3,1,SKU038,566,47,613
2025-08-06,3,2,SKU017,274,16,290
2025-08-06,3,3,SKU008,717,12,729
2025-08-06,4,1,SKU015,304,1,305
2025-08-06,4,3,SKU039,696,28,724
2025-08-06,5,1,SKU033,545,16,561
2025-08-06,5,2,SKU019,253,17,270
2025-08-06,6,1,SKU023,323,23,346
2025-08-06,6,2,SKU030,696,94,790
2025-08-06,6,3,SKU036,415,26,441
2025-08-06,7,1,SKU030,569,5,574
2025-08-06,7,2,SKU008,545,27,572
2025-08-06,7,3,SKU002,614,50,664
2025-08-06,8,2,SKU025,457,54,511
2025-08-06,8,3,SKU034,549,60,609
2025-08-06,9,1,SKU035,316,12,328
2025-08-06,9,2,SKU002,413,22,435
2025-08-06,9,3,SKU026,694,55,749
2025-08-06,10,1,SKU003,482,18,500
2025-08-06,10,3,SKU026,232,21,253
2025-08-06,11,1,SKU006,673,9,682
2025-08-06,11,2,SKU004,236,4,240
2025-08-06,11,3,SKU010,292,11,303
2025-08-06,12,1,SKU040,542,63,605
2025-08-06,12,2,SKU016,577,39,616
2025-08-06,12,3,SKU015,633,25,658
2025-08-06,13,1,SKU017,511,2,513
2025-08-06,13,2,SKU022,688,52,740
2025-08-06,13,3,SKU031,212,8,220
2025-08-06,14,1,SKU031,527,75,602
2025-08-06,14,2,SKU016,419,20,439
2025-08-06,14,3,SKU002,222,22,244
2025-08-06,15,1,SKU034,413,50,463
2025-08-06,15,2,SKU035,673,52,725
2025-08-06,15,3,SKU020,412,40,452
2025-08-07,1,1,SKU029,520,21,541
2025-08-07,1,2,SKU030,703,100,803
2025-08-07,1,3,SKU024,649,86,735
2025-08-07,2,1,SKU011,651,42,693
2025-08-07,2,2,SKU018,306,11,317
2025-08-07,2,3,SKU015,292,12,304
2025-08-07,3,1,SKU022,356,0,356
2025-08-07,3,2,SKU020,492,16,508
2025-08-07,3,3,SKU039,475,38,513
2025-08-07,4,1,SKU040,300,33,333
2025-08-07,4,2,SKU022,205,23,228
2025-08-07,4,3,SKU021,660,59,719
2025-08-07,5,1,SKU009,206,2,208
2025-08-07,5,2,SKU018,320,41,361
2025-08-07,5,3,SKU033,572,18,590
2025-08-07,6,1,SKU005,442,11,453
2025-08-07,6,3,SKU027,783,31,814
2025-08-07,7,2,SKU025,540,36,576
2025-08-07,7,3,SKU039,646,86,732
2025-08-07,8,1,SKU016,543,5,548
2025-08-07,8,2,SKU027,716,91,807
2025-08-07,8,3,SKU004,215,1,216
2025-08-07,9,2,SKU020,332,21,353
2025-08-07,9,3,SKU008,242,3,245
2025-08-07,10,1,SKU004,488,19,507
2025-08-07,11,1,SKU033,499,44,543
2025-08-07,11,2,SKU031,485,68,553
2025-08-07,12,1,SKU026,540,41,581
2025-08-07,12,2,SKU030,347,36,383
2025-08-07,12,3,SKU039,202,4,206
2025-08-07,13,2,SKU018,742,29,771
2025-08-07,13,3,SKU008,695,88,783
2025-08-07,14,2,SKU006,411,8,419
2025-08-07,14,3,SKU017,732,100,832
2025-08-07,15,1,SKU025,437,26,463
2025-08-07,15,2,SKU007,421,52,473
2025-08-07,15,3,SKU007,549,54,603
2025-08-08,1,1,SKU017,427,14,441
2025-08-08,1,2,SKU011,594,16,610
2025-08-08,2,1,SKU016,521,36,557
2025-08-08,2,2,SKU035,743,101,844
2025-08-08,3,1,SKU021,301,8,309
2025-08-08,3,2,SKU032,570,63,633
2025-08-08,3,3,SKU035,280,38,318
2025-08-08,4,1,SKU001,388,41,429
2025-08-08,4,2,SKU018,782,36,818
2025-08-08,5,2,SKU006,729,6,735
2025-08-08,5,3,SKU001,590,0,590
2025-08-08,6,1,SKU029,648,5,653
2025-08-08,6,2,SKU027,722,99,821
2025-08-08,6,3,SKU001,373,10,383
2025-08-08,7,1,SKU040,540,66,606
2025-08-08,7,2,SKU036,633,52,685
2025-08-08,7,3,SKU003,621,79,700
2025-08-08,8,1,SKU034,497,70,567
2025-08-08,8,3,SKU003,232,20,252
2025-08-08,9,1,SKU016,795,26,821
2025-08-08,9,2,SKU005,395,9,404
2025-08-08,9,3,SKU007,522,28,550
2025-08-08,10,1,SKU003,252,8,260
2025-08-08,10,2,SKU036,459,49,508
2025-08-08,10,3,SKU033,249,31,280
2025-08-08,11,1,SKU002,485,15,500
2025-08-08,11,2,SKU028,570,2,572
2025-08-08,11,3,SKU037,362,30,392
2025-08-08,12,1,SKU020,219,4,223
2025-08-08,12,2,SKU025,767,114,881
2025-08-08,12,3,SKU023,220,24,244
2025-08-08,13,1,SKU018,380,0,380
2025-08-08,13,2,SKU011,756,96,852
2025-08-08,14,1,SKU006,742,33,775
2025-08-08,14,3,SKU003,290,26,316
2025-08-08,15,2,SKU037,655,75,730
2025-08-08,15,3,SKU007,710,47,757
2025-08-09,1,1,SKU017,639,15,654
2025-08-09,1,2,SKU027,628,28,656
2025-08-09,1,3,SKU011,605,6,611
2025-08-09,2,1,SKU013,264,28,292
2025-08-09,2,2,SKU017,468,4,472
2025-08-09,2,3,SKU022,256,21,277
2025-08-09,3,1,SKU005,764,107,871
2025-08-09,3,2,SKU015,620,15,635
2025-08-09,3,3,SKU019,333,27,360
2025-08-09,4,1,SKU005,429,18,447
2025-08-09,4,2,SKU035,644,77,721
2025-08-09,4,3,SKU018,765,41,806
2025-08-09,5,1,SKU010,219,2,221
2025-08-09,5,2,SKU011,487,24,511
2025-08-09,5,3,SKU031,400,28,428
2025-08-09,6,1,SKU015,563,60,623
2025-08-09,6,2,SKU015,388,44,432
2025-08-09,6,3,SKU002,302,6,308
2025-08-09,7,1,SKU002,465,55,520
2025-08-09,7,2,SKU028,436,53,489
2025-08-09,7,3,SKU028,442,52,494
2025-08-09,8,1,SKU017,536,62,598
2025-08-09,8,2,SKU009,511,1,512
2025-08-09,8,3,SKU019,473,31,504
2025-08-09,9,1,SKU028,215,26,241
2025-08-09,9,2,SKU004,221,1,222
2025-08-09,9,3,SKU035,533,30,563
2025-08-09,10,1,SKU017,663,15,678
2025-08-09,10,2,SKU031,564,71,635
2025-08-09,10,3,SKU029,629,0,629
2025-08-09,11,1,SKU005,610,9,619
2025-08-09,11,2,SKU007,440,8,448
2025-08-09,12,1,SKU023,207,6,213
2025-08-09,12,2,SKU039,541,25,566
2025-08-09,12,3,SKU014,229,11,240
2025-08-09,13,1,SKU027,319,28,347
2025-08-09,13,2,SKU007,660,83,743
2025-08-09,13,3,SKU032,637,80,717
2025-08-09,14,2,SKU032,209,26,235
2025-08-09,14,3,SKU035,313,31,344
2025-08-09,15,1,SKU026,490,13,503
2025-08-09,15,2,SKU020,437,27,464
2025-08-09,15,3,SKU036,244,32,276
2025-08-10,1,1,SKU040,722,99,821
2025-08-10,1,2,SKU033,614,70,684
2025-08-10,1,3,SKU010,673,53,726
2025-08-10,2,1,SKU036,524,38,562
2025-08-10,2,2,SKU037,499,48,547
2025-08-10,2,3,SKU037,365,43,408
2025-08-10,3,2,SKU033,531,2,533
2025-08-10,3,3,SKU009,756,70,826
2025-08-10,4,1,SKU023,202,27,229
2025-08-10,4,2,SKU040,735,88,823
2025-08-10,4,3,SKU021,700,100,800
2025-08-10,5,1,SKU022,463,15,478
2025-08-10,5,2,SKU014,735,44,779
2025-08-10,6,1,SKU010,522,50,572
2025-08-10,6,3,SKU014,386,13,399
2025-08-10,7,1,SKU023,511,74,585
2025-08-10,7,2,SKU001,753,40,793
2025-08-10,7,3,SKU021,640,24,664
2025-08-10,8,1,SKU009,411,8,419
2025-08-10,9,1,SKU039,326,45,371
2025-08-10,9,2,SKU009,321,5,326
2025-08-10,9,3,SKU020,686,54,740
2025-08-10,10,2,SKU018,426,49,475
2025-08-10,10,3,SKU004,720,73,793
2025-08-10,11,2,SKU033,350,0,350
2025-08-10,11,3,SKU038,713,38,751
2025-08-10,12,1,SKU023,768,11,779
2025-08-10,13,1,SKU025,380,45,425
2025-08-10,13,2,SKU040,689,46,735
2025-08-10,13,3,SKU033,288,8,296
2025-08-10,14,1,SKU018,708,61,769
2025-08-10,14,2,SKU028,648,8,656
2025-08-10,15,1,SKU025,325,30,355
2025-08-10,15,2,SKU037,493,25,518
2025-08-10,15,3,SKU011,577,27,604
2025-08-11,1,1,SKU028,743,5,748
2025-08-11,1,2,SKU002,357,25,382
2025-08-11,1,3,SKU019,718,84,802
2025-08-11,2,1,SKU037,266,0,266
2025-08-11,2,2,SKU034,696,39,735
2025-08-11,2,3,SKU035,315,12,327
2025-08-11,3,1,SKU032,784,2,786
2025-08-11,3,2,SKU018,462,45,507
2025-08-11,3,3,SKU031,774,46,820
2025-08-11,4,2,SKU029,590,17,607
2025-08-11,4,3,SKU017,231,3,234
2025-08-11,5,1,SKU038,418,5,423
2025-08-11,5,2,SKU018,221,14,235
2025-08-11,5,3,SKU035,299,41,340
2025-08-11,6,2,SKU015,642,10,652
2025-08-11,6,3,SKU025,202,17,219
2025-08-11,7,1,SKU006,612,15,627
2025-08-11,7,2,SKU006,621,7,628
2025-08-11,7,3,SKU033,679,10,689
2025-08-11,8,1,SKU030,597,8,605
2025-08-11,8,2,SKU034,262,7,269
2025-08-11,9,1,SKU008,395,41,436
2025-08-11,9,2,SKU031,673,10,683
2025-08-11,9,3,SKU001,796,94,890
2025-08-11,10,2,SKU027,689,51,740
2025-08-11,10,3,SKU029,765,101,866
2025-08-11,11,1,SKU007,419,33,452
2025-08-11,11,2,SKU037,328,24,352
2025-08-11,11,3,SKU037,326,11,337
2025-08-11,12,1,SKU020,783,62,845
2025-08-11,12,2,SKU017,372,3,375
2025-08-11,12,3,SKU030,523,8,531
2025-08-11,13,1,SKU026,514,1,515
2025-08-11,13,2,SKU018,297,22,319
2025-08-11,13,3,SKU008,439,22,461
2025-08-11,14,1,SKU028,658,33,691
2025-08-11,14,2,SKU028,639,6,645
2025-08-11,14,3,SKU037,216,28,244
2025-08-11,15,2,SKU016,670,58,728
2025-08-11,15,3,SKU014,760,50,810
2025-08-12,1,1,SKU031,527,29,556
2025-08-12,1,2,SKU030,698,79,777
2025-08-12,1,3,SKU032,683,91,774
2025-08-12,2,1,SKU006,261,14,275
2025-08-12,3,1,SKU025,220,3,223
2025-08-12,3,2,SKU001,570,3,573
2025-08-12,4,1,SKU032,213,15,228
2025-08-12,4,2,SKU019,412,10,422
2025-08-12,4,3,SKU019,352,19,371
2025-08-12,5,2,SKU029,587,54,641
2025-08-12,6,1,SKU010,415,37,452
2025-08-12,6,3,SKU014,549,15,564
2025-08-12,7,1,SKU004,406,26,432
2025-08-12,7,2,SKU015,490,60,550
2025-08-12,7,3,SKU011,552,31,583
2025-08-12,8,1,SKU017,480,4,484
2025-08-12,8,2,SKU019,260,20,280
2025-08-12,8,3,SKU017,249,16,265
2025-08-12,10,1,SKU019,534,70,604
2025-08-12,10,2,SKU009,616,13,629
2025-08-12,10,3,SKU025,682,21,703
2025-08-12,11,1,SKU019,411,23,434
2025-08-12,11,2,SKU031,313,3,316
2025-08-12,12,1,SKU027,537,77,614
2025-08-12,12,2,SKU006,658,65,723
2025-08-12,12,3,SKU014,712,13,725
2025-08-12,13,1,SKU007,506,17,523
2025-08-12,13,2,SKU037,395,13,408
2025-08-12,13,3,SKU001,674,87,761
2025-08-12,14,1,SKU011,314,27,341
2025-08-12,14,3,SKU021,589,42,631
2025-08-12,15,1,SKU004,240,10,250
2025-08-12,15,2,SKU013,291,13,304
2025-08-12,15,3,SKU023,668,57,725
2025-08-13,1,1,SKU017,528,34,562
2025-08-13,1,3,SKU038,466,20,486
2025-08-13,2,1,SKU028,380,50,430
2025-08-13,2,2,SKU022,422,13,435
2025-08-13,2,3,SKU005,352,24,376
2025-08-13,3,1,SKU029,562,34,596
2025-08-13,3,3,SKU037,570,16,586
2025-08-13,4,2,SKU020,536,48,584
2025-08-13,5,1,SKU009,200,15,215
2025-08-13,5,3,SKU027,577,62,639
2025-08-13,6,2,SKU028,493,51,544
2025-08-13,6,3,SKU024,600,59,659
2025-08-13,7,1,SKU022,684,56,740
2025-08-13,7,2,SKU011,254,20,274
2025-08-13,8,1,SKU003,332,47,379
2025-08-13,8,2,SKU024,256,20,276
2025-08-13,8,3,SKU030,682,63,745
2025-08-13,9,1,SKU040,736,57,793
2025-08-13,9,2,SKU008,266,16,282
2025-08-13,9,3,SKU010,761,76,837
2025-08-13,10,1,SKU035,755,42,797
2025-08-13,10,2,SKU032,399,51,450
2025-08-13,11,1,SKU010,459,27,486
2025-08-13,11,2,SKU008,499,15,514
2025-08-13,11,3,SKU017,386,32,418
2025-08-13,12,1,SKU017,358,7,365
2025-08-13,12,2,SKU023,374,23,397
2025-08-13,12,3,SKU040,244,2,246
2025-08-13,14,1,SKU031,730,33,763
2025-08-13,14,2,SKU028,263,16,279
2025-08-13,14,3,SKU008,768,106,874
2025-08-13,15,1,SKU026,392,25,417
2025-08-13,15,2,SKU010,611,2,613
2025-08-13,15,3,SKU024,487,44,531
2025-08-14,1,1,SKU013,529,29,558
2025-08-14,1,2,SKU018,531,24,555
2025-08-14,1,3,SKU017,731,59,790
2025-08-14,2,2,SKU006,403,56,459
2025-08-14,2,3,SKU031,464,40,504
2025-08-14,3,1,SKU038,674,7,681
2025-08-14,3,2,SKU036,358,9,367
2025-08-14,3,3,SKU025,559,39,598
2025-08-14,4,1,SKU017,500,44,544
2025-08-14,4,2,SKU035,619,26,645
2025-08-14,4,3,SKU024,667,70,737
2025-08-14,5,1,SKU005,279,17,296
2025-08-14,5,3,SKU027,254,35,289
2025-08-14,6,1,SKU036,254,26,280
2025-08-14,6,2,SKU020,535,22,557
2025-08-14,6,3,SKU014,377,50,427
2025-08-14,7,1,SKU030,428,31,459
2025-08-14,7,2,SKU020,580,8,588
2025-08-14,7,3,SKU028,349,28,377
2025-08-14,8,1,SKU011,249,6,255
2025-08-14,8,2,SKU007,689,92,781
2025-08-14,9,1,SKU001,691,27,718
2025-08-14,9,2,SKU024,692,61,753
2025-08-14,9,3,SKU035,420,36,456
2025-08-14,10,2,SKU016,588,13,601
2025-08-14,11,1,SKU003,261,35,296
2025-08-14,11,2,SKU011,647,76,723
2025-08-14,12,3,SKU017,336,21,357
2025-08-14,13,2,SKU038,600,28,628
2025-08-14,13,3,SKU030,787,114,901
2025-08-14,14,1,SKU026,748,20,768
2025-08-14,14,2,SKU028,451,35,486
2025-08-14,14,3,SKU036,427,16,443
2025-08-14,15,1,SKU028,566,38,604
2025-08-14,15,3,SKU030,468,17,485
2025-08-15,1,1,SKU033,624,63,687
2025-08-15,1,3,SKU008,500,0,500
2025-08-15,2,1,SKU024,663,20,683
2025-08-15,2,2,SKU023,735,36,771
2025-08-15,2,3,SKU009,686,33,719
2025-08-15,3,1,SKU039,447,9,456
2025-08-15,3,3,SKU035,625,16,641
2025-08-15,4,1,SKU033,561,57,618
2025-08-15,4,2,SKU023,796,31,827
2025-08-15,4,3,SKU038,579,72,651
2025-08-15,5,1,SKU014,646,66,712
2025-08-15,5,2,SKU015,296,1,297
2025-08-15,5,3,SKU039,337,6,343
2025-08-15,6,1,SKU010,286,37,323
2025-08-15,6,2,SKU034,665,97,762
2025-08-15,7,1,SKU033,301,22,323
2025-08-15,7,2,SKU017,428,36,464
2025-08-15,7,3,SKU027,760,106,866
2025-08-15,8,1,SKU037,306,33,339
2025-08-15,8,2,SKU036,679,35,714
2025-08-15,8,3,SKU004,635,1,636
2025-08-15,9,1,SKU037,343,11,354
2025-08-15,9,3,SKU021,250,3,253
2025-08-15,10,1,SKU002,214,16,230
2025-08-15,10,2,SKU016,239,6,245
2025-08-15,10,3,SKU039,630,70,700
2025-08-15,11,1,SKU016,320,12,332
2025-08-15,11,2,SKU015,466,43,509
2025-08-15,11,3,SKU023,715,27,742
2025-08-15,12,1,SKU024,358,34,392
2025-08-15,12,2,SKU008,774,27,801
2025-08-15,12,3,SKU009,760,70,830
2025-08-15,13,2,SKU007,335,11,346
2025-08-15,14,1,SKU016,663,76,739
2025-08-15,14,2,SKU016,222,24,246
2025-08-15,14,3,SKU034,718,34,752
2025-08-15,15,1,SKU040,392,40,432
2025-08-16,1,1,SKU034,440,51,491
2025-08-16,1,2,SKU037,483,51,534
2025-08-16,1,3,SKU021,661,19,680
2025-08-16,2,2,SKU009,411,49,460
2025-08-16,2,3,SKU013,717,50,767
2025-08-16,3,1,SKU005,738,57,795
2025-08-16,3,2,SKU005,309,29,338
2025-08-16,3,3,SKU012,404,22,426
2025-08-16,4,1,SKU038,346,8,354
2025-08-16,4,2,SKU028,431,19,450
2025-08-16,4,3,SKU020,488,10,498
2025-08-16,5,1,SKU007,747,25,772
2025-08-16,5,2,SKU028,386,33,419
2025-08-16,5,3,SKU022,344,37,381
2025-08-16,6,1,SKU020,386,15,401
2025-08-16,6,2,SKU037,446,39,485
2025-08-16,6,3,SKU024,735,7,742
2025-08-16,7,1,SKU010,675,69,744
2025-08-16,7,2,SKU008,341,26,367
2025-08-16,7,3,SKU027,471,67,538
2025-08-16,8,1,SKU036,747,70,817
2025-08-16,8,2,SKU035,682,2,684
2025-08-16,8,3,SKU029,745,23,768
2025-08-16,9,1,SKU015,668,43,711
2025-08-16,9,2,SKU004,487,65,552
2025-08-16,9,3,SKU008,564,8,572
2025-08-16,10,1,SKU038,563,33,596
2025-08-16,10,2,SKU012,310,9,319
2025-08-16,10,3,SKU036,394,22,416
2025-08-16,11,1,SKU003,457,56,513
2025-08-16,11,3,SKU035,781,78,859
2025-08-16,12,1,SKU036,298,8,306
2025-08-16,12,2,SKU017,465,31,496
2025-08-16,12,3,SKU004,600,35,635
2025-08-16,13,1,SKU022,592,7,599
2025-08-16,13,2,SKU009,790,10,800
2025-08-16,14,1,SKU039,430,58,488
2025-08-16,14,2,SKU023,200,20,220
2025-08-16,14,3,SKU005,252,4,256
2025-08-16,15,1,SKU032,702,74,776
2025-08-16,15,2,SKU030,291,2,293
2025-08-16,15,3,SKU023,577,17,594
2025-08-17,1,1,SKU033,301,15,316
2025-08-17,1,2,SKU007,494,21,515
2025-08-17,2,1,SKU011,706,70,776
2025-08-17,2,2,SKU037,443,43,486
2025-08-17,2,3,SKU022,564,60,624
2025-08-17,3,1,SKU002,488,32,520
2025-08-17,3,2,SKU018,775,84,859
2025-08-17,3,3,SKU014,281,41,322
2025-08-17,4,1,SKU007,604,46,650
2025-08-17,4,2,SKU034,663,33,696
2025-08-17,4,3,SKU027,463,36,499
2025-08-17,5,2,SKU013,482,39,521
2025-08-17,6,1,SKU015,507,31,538
2025-08-17,6,2,SKU008,453,65,518
2025-08-17,6,3,SKU007,424,32,456
2025-08-17,7,1,SKU007,546,29,575
2025-08-17,7,3,SKU010,321,18,339
2025-08-17,8,1,SKU032,705,44,749
2025-08-17,8,2,SKU035,449,57,506
2025-08-17,8,3,SKU005,405,59,464
2025-08-17,9,1,SKU020,415,48,463
2025-08-17,9,2,SKU003,515,4,519
2025-08-17,9,3,SKU014,637,25,662
2025-08-17,10,1,SKU021,202,19,221
2025-08-17,10,2,SKU005,650,31,681
2025-08-17,10,3,SKU001,591,74,665
2025-08-17,11,1,SKU011,438,40,478
2025-08-17,11,2,SKU012,746,38,784
2025-08-17,11,3,SKU021,739,37,776
2025-08-17,12,1,SKU030,439,58,497
2025-08-17,12,3,SKU006,620,24,644
2025-08-17,13,1,SKU036,487,70,557
2025-08-17,13,2,SKU010,713,78,791
2025-08-17,13,3,SKU021,424,55,479
2025-08-17,14,1,SKU025,496,1,497
2025-08-17,14,2,SKU022,279,29,308
2025-08-17,14,3,SKU035,745,87,832
2025-08-17,15,1,SKU018,235,12,247
2025-08-17,15,3,SKU036,276,5,281
2025-08-18,1,1,SKU040,600,76,676
2025-08-18,1,2,SKU022,763,65,828
2025-08-18,1,3,SKU021,324,25,349
2025-08-18,2,1,SKU040,691,45,736
2025-08-18,2,3,SKU009,227,18,245
2025-08-18,3,1,SKU027,285,10,295
2025-08-18,3,2,SKU037,374,25,399
2025-08-18,4,1,SKU029,614,68,682
2025-08-18,4,3,SKU040,536,49,585
2025-08-18,5,1,SKU012,476,9,485
2025-08-18,5,2,SKU006,620,5,625
2025-08-18,5,3,SKU005,756,27,783
2025-08-18,6,1,SKU012,559,29,588
2025-08-18,6,2,SKU021,359,4,363
2025-08-18,6,3,SKU009,613,59,672
2025-08-18,7,1,SKU014,766,48,814
2025-08-18,7,2,SKU034,427,61,488
2025-08-18,7,3,SKU024,714,30,744
2025-08-18,8,1,SKU001,337,2,339
2025-08-18,8,2,SKU033,404,27,431
2025-08-18,8,3,SKU038,770,57,827
2025-08-18,9,1,SKU035,493,18,511
2025-08-18,9,2,SKU024,656,88,744
2025-08-18,9,3,SKU013,643,13,656
2025-08-18,10,1,SKU025,436,55,491
2025-08-18,10,2,SKU014,617,91,708
2025-08-18,10,3,SKU017,339,15,354
2025-08-18,11,1,SKU008,774,105,879
2025-08-18,11,2,SKU039,619,72,691
2025-08-18,11,3,SKU036,646,20,666
2025-08-18,12,1,SKU001,658,48,706
2025-08-18,12,2,SKU018,664,7,671
2025-08-18,12,3,SKU022,314,4,318
2025-08-18,13,2,SKU039,742,9,751
2025-08-18,13,3,SKU006,784,4,788
2025-08-18,14,1,SKU026,564,33,597
2025-08-18,14,2,SKU025,285,29,314
2025-08-18,15,3,SKU017,595,52,647
2025-08-19,1,1,SKU004,350,42,392
2025-08-19,1,2,SKU008,451,3,454
2025-08-19,2,2,SKU015,397,1,398
2025-08-19,2,3,SKU009,449,66,515
2025-08-19,3,2,SKU021,758,25,783
2025-08-19,3,3,SKU019,335,15,350
2025-08-19,4,1,SKU023,424,13,437
2025-08-19,4,2,SKU025,458,42,500
2025-08-19,4,3,SKU010,708,56,764
2025-08-19,5,1,SKU025,288,42,330
2025-08-19,5,2,SKU030,539,60,599
2025-08-19,5,3,SKU016,375,7,382
2025-08-19,6,1,SKU023,338,1,339
2025-08-19,6,2,SKU017,782,46,828
2025-08-19,6,3,SKU006,426,30,456
2025-08-19,7,1,SKU033,506,45,551
2025-08-19,7,2,SKU014,532,34,566
2025-08-19,8,1,SKU036,272,16,288
2025-08-19,8,3,SKU007,503,2,505
2025-08-19,9,1,SKU015,418,48,466
2025-08-19,9,2,SKU023,341,37,378
2025-08-19,9,3,SKU026,567,9,576
2025-08-19,10,1,SKU040,216,21,237
2025-08-19,10,2,SKU017,368,8,376
2025-08-19,10,3,SKU018,609,80,689
2025-08-19,11,1,SKU026,630,66,696
2025-08-19,11,2,SKU028,780,11,791
2025-08-19,11,3,SKU024,648,73,721
2025-08-19,12,1,SKU039,773,66,839
2025-08-19,12,2,SKU025,298,12,310
2025-08-19,12,3,SKU011,794,97,891
2025-08-19,13,1,SKU014,285,36,321
2025-08-19,13,2,SKU019,405,28,433
2025-08-19,13,3,SKU014,333,8,341
2025-08-19,14,3,SKU031,436,46,482
2025-08-19,15,1,SKU035,581,2,583
2025-08-19,15,3,SKU034,219,17,236
2025-08-20,1,1,SKU030,451,40,491
2025-08-20,1,2,SKU015,402,18,420
2025-08-20,1,3,SKU039,748,43,791
2025-08-20,2,2,SKU035,499,68,567
2025-08-20,2,3,SKU002,601,23,624
2025-08-20,3,1,SKU007,347,23,370
2025-08-20,3,3,SKU017,670,80,750
2025-08-20,4,2,SKU036,283,10,293
2025-08-20,4,3,SKU009,599,74,673
2025-08-20,5,1,SKU026,690,50,740
2025-08-20,5,3,SKU010,591,67,658
2025-08-20,6,2,SKU010,395,22,417
2025-08-20,7,1,SKU024,211,20,231
2025-08-20,7,2,SKU040,732,53,785
2025-08-20,7,3,SKU006,798,64,862
2025-08-20,8,1,SKU029,499,0,499
2025-08-20,8,2,SKU016,682,67,749
2025-08-20,8,3,SKU031,756,97,853
2025-08-20,9,1,SKU007,531,53,584
2025-08-20,9,2,SKU020,591,55,646
2025-08-20,9,3,SKU019,669,7,676
2025-08-20,10,1,SKU019,739,23,762
2025-08-20,10,2,SKU007,259,29,288
2025-08-20,10,3,SKU032,619,8,627
2025-08-20,11,1,SKU025,205,14,219
2025-08-20,11,2,SKU024,733,69,802
2025-08-20,11,3,SKU033,745,37,782
2025-08-20,12,1,SKU038,211,6,217
2025-08-20,12,2,SKU002,513,17,530
2025-08-20,13,1,SKU032,380,13,393
2025-08-20,13,2,SKU001,396,58,454
2025-08-20,13,3,SKU014,714,17,731
2025-08-20,14,1,SKU003,389,16,405
2025-08-20,14,2,SKU028,294,36,330
2025-08-20,14,3,SKU002,505,74,579
2025-08-20,15,1,SKU040,307,10,317
2025-08-20,15,2,SKU010,735,2,737
2025-08-20,15,3,SKU031,621,27,648
2025-08-21,1,1,SKU039,639,11,650
2025-08-21,1,2,SKU023,489,52,541
2025-08-21,1,3,SKU031,305,36,341
2025-08-21,2,1,SKU022,233,6,239
2025-08-21,2,2,SKU006,717,5,722
2025-08-21,2,3,SKU010,770,87,857
2025-08-21,3,2,SKU018,534,56,590
2025-08-21,4,1,SKU001,744,106,850
2025-08-21,4,3,SKU036,349,1,350
2025-08-21,5,1,SKU013,439,64,503
2025-08-21,5,2,SKU013,333,31,364
2025-08-21,5,3,SKU019,485,62,547
2025-08-21,6,1,SKU035,280,31,311
2025-08-21,6,2,SKU028,516,0,516
2025-08-21,6,3,SKU029,411,12,423
2025-08-21,7,1,SKU038,515,22,537
2025-08-21,7,3,SKU033,660,44,704
2025-08-21,8,1,SKU036,481,24,505
2025-08-21,8,2,SKU032,780,49,829
2025-08-21,8,3,SKU036,731,73,804
2025-08-21,9,1,SKU033,258,5,263
2025-08-21,9,2,SKU012,374,48,422
2025-08-21,10,1,SKU006,663,4,667
2025-08-21,10,2,SKU039,481,54,535
2025-08-21,10,3,SKU030,629,15,644
2025-08-21,11,1,SKU035,729,85,814
2025-08-21,11,2,SKU018,527,77,604
2025-08-21,11,3,SKU016,246,6,252
2025-08-21,12,1,SKU022,301,9,310
2025-08-21,12,2,SKU003,439,49,488
2025-08-21,12,3,SKU007,452,0,452
2025-08-21,13,2,SKU002,340,39,379
2025-08-21,13,3,SKU001,287,39,326
2025-08-21,14,1,SKU038,410,32,442
2025-08-21,14,2,SKU005,763,32,795
2025-08-21,14,3,SKU008,245,16,261
2025-08-21,15,1,SKU006,431,63,494
2025-08-21,15,2,SKU030,771,40,811
2025-08-21,15,3,SKU013,272,36,308
2025-08-22,1,1,SKU037,540,80,620
2025-08-22,1,2,SKU026,558,79,637
2025-08-22,2,1,SKU017,428,1,429
2025-08-22,2,2,SKU012,771,19,790
2025-08-22,2,3,SKU038,208,1,209
2025-08-22,3,1,SKU018,424,15,439
2025-08-22,3,2,SKU025,793,51,844
2025-08-22,4,1,SKU012,687,53,740
2025-08-22,4,2,SKU016,279,16,295
2025-08-22,4,3,SKU035,209,10,219
2025-08-22,5,1,SKU033,726,107,833
2025-08-22,5,2,SKU035,692,63,755
2025-08-22,5,3,SKU034,426,57,483
2025-08-22,6,1,SKU014,574,34,608
2025-08-22,6,3,SKU008,715,55,770
2025-08-22,7,3,SKU038,482,30,512
2025-08-22,8,1,SKU037,671,98,769
2025-08-22,8,2,SKU019,307,34,341
2025-08-22,8,3,SKU014,327,10,337
2025-08-22,9,2,SKU015,456,37,493
2025-08-22,9,3,SKU012,505,0,505
2025-08-22,10,1,SKU037,726,95,821
2025-08-22,10,2,SKU026,455,54,509
2025-08-22,10,3,SKU006,609,84,693
2025-08-22,11,1,SKU017,368,10,378
2025-08-22,11,2,SKU031,759,16,775
2025-08-22,11,3,SKU015,622,79,701
2025-08-22,12,1,SKU023,339,10,349
2025-08-22,12,2,SKU006,323,5,328
2025-08-22,12,3,SKU025,402,2,404
2025-08-22,13,1,SKU008,314,32,346
2025-08-22,13,3,SKU030,290,27,317
2025-08-22,14,1,SKU006,328,13,341
2025-08-22,15,2,SKU004,542,54,596
2025-08-22,15,3,SKU033,746,82,828
2025-08-23,1,1,SKU032,712,51,763
2025-08-23,1,2,SKU018,321,41,362
2025-08-23,1,3,SKU025,346,33,379
2025-08-23,2,1,SKU030,344,45,389
2025-08-23,2,2,SKU033,530,55,585
2025-08-23,2,3,SKU038,716,57,773
2025-08-23,3,2,SKU031,540,65,605
2025-08-23,4,1,SKU010,785,89,874
2025-08-23,4,2,SKU006,364,26,390
2025-08-23,4,3,SKU028,588,79,667
2025-08-23,5,1,SKU037,430,22,452
2025-08-23,5,2,SKU002,790,52,842
2025-08-23,5,3,SKU026,607,30,637
2025-08-23,6,1,SKU012,454,9,463
2025-08-23,6,2,SKU039,253,10,263
2025-08-23,6,3,SKU012,630,8,638
2025-08-23,7,1,SKU018,339,31,370
2025-08-23,7,2,SKU025,305,44,349
2025-08-23,7,3,SKU033,222,31,253
2025-08-23,8,2,SKU014,341,24,365
2025-08-23,8,3,SKU020,424,51,475
2025-08-23,9,1,SKU031,702,96,798
2025-08-23,9,2,SKU034,626,67,693
2025-08-23,10,1,SKU010,354,14,368
2025-08-23,10,2,SKU020,362,35,397
2025-08-23,11,1,SKU010,401,43,444
2025-08-23,11,2,SKU025,775,3,778
2025-08-23,11,3,SKU014,363,50,413
2025-08-23,12,1,SKU012,609,71,680
2025-08-23,12,2,SKU021,329,15,344
2025-08-23,12,3,SKU017,752,53,805
2025-08-23,13,1,SKU006,464,37,501
2025-08-23,13,2,SKU032,439,47,486
2025-08-23,13,3,SKU016,496,67,563
2025-08-23,14,1,SKU024,236,21,257
2025-08-23,14,2,SKU024,558,65,623
2025-08-23,14,3,SKU038,200,22,222
2025-08-23,15,1,SKU020,655,61,716
2025-08-23,15,2,SKU019,527,65,592
2025-08-24,1,1,SKU017,389,44,433
2025-08-24,1,2,SKU008,425,17,442
2025-08-24,1,3,SKU014,375,34,409
2025-08-24,2,1,SKU007,395,35,430
2025-08-24,2,2,SKU039,621,13,634
2025-08-24,2,3,SKU012,451,7,458
2025-08-24,3,1,SKU007,547,23,570
2025-08-24,3,3,SKU033,408,1,409
2025-08-24,4,1,SKU002,605,46,651
2025-08-24,4,2,SKU037,689,55,744
2025-08-24,4,3,SKU038,343,31,374
2025-08-24,5,1,SKU037,733,96,829
2025-08-24,5,2,SKU008,328,43,371
2025-08-24,5,3,SKU014,725,47,772
2025-08-24,6,1,SKU015,570,31,601
2025-08-24,6,2,SKU012,327,27,354
2025-08-24,6,3,SKU024,790,90,880
2025-08-24,7,3,SKU022,279,39,318
2025-08-24,8,1,SKU033,379,35,414
2025-08-24,8,2,SKU030,503,12,515
2025-08-24,8,3,SKU013,729,77,806
2025-08-24,9,1,SKU017,516,65,581
2025-08-24,9,2,SKU036,349,16,365
2025-08-24,9,3,SKU009,298,42,340
2025-08-24,10,1,SKU040,202,13,215
2025-08-24,10,2,SKU037,450,9,459
2025-08-24,10,3,SKU032,371,3,374
2025-08-24,11,1,SKU008,378,54,432
2025-08-24,11,2,SKU027,345,43,388
2025-08-24,12,1,SKU012,337,45,382
2025-08-24,12,2,SKU024,358,29,387
2025-08-24,12,3,SKU010,312,41,353
2025-08-24,13,1,SKU005,357,27,384
2025-08-24,13,2,SKU013,354,11,365
2025-08-24,13,3,SKU026,501,26,527
2025-08-24,14,1,SKU036,673,49,722
2025-08-24,14,2,SKU039,433,19,452
2025-08-24,14,3,SKU004,225,23,248
2025-08-25,1,2,SKU016,745,87,832
2025-08-25,1,3,SKU010,610,67,677
2025-08-25,2,1,SKU002,491,65,556
2025-08-25,2,2,SKU017,476,61,537
2025-08-25,2,3,SKU017,487,15,502
2025-08-25,3,1,SKU008,688,101,789
2025-08-25,3,2,SKU009,663,86,749
2025-08-25,4,1,SKU033,352,32,384
2025-08-25,4,2,SKU019,460,67,527
2025-08-25,4,3,SKU025,263,12,275
2025-08-25,5,2,SKU002,756,108,864
2025-08-25,5,3,SKU029,722,53,775
2025-08-25,6,1,SKU023,581,61,642
2025-08-25,6,3,SKU017,467,2,469
2025-08-25,7,1,SKU036,360,21,381
2025-08-25,7,2,SKU005,337,42,379
2025-08-25,7,3,SKU036,250,1,251
2025-08-25,8,1,SKU004,540,37,577
2025-08-25,8,2,SKU027,662,41,703
2025-08-25,8,3,SKU020,330,35,365
2025-08-25,9,1,SKU034,349,47,396
2025-08-25,9,2,SKU035,702,66,768
2025-08-25,9,3,SKU023,273,23,296
2025-08-25,10,1,SKU010,242,21,263
2025-08-25,10,2,SKU001,763,24,787
2025-08-25,10,3,SKU032,779,47,826
2025-08-25,11,1,SKU004,790,39,829
2025-08-25,11,2,SKU018,648,12,660
2025-08-25,11,3,SKU020,664,61,725
2025-08-25,12,1,SKU023,450,54,504
2025-08-25,12,2,SKU023,359,39,398
2025-08-25,12,3,SKU026,484,51,535
2025-08-25,13,1,SKU038,452,45,497
2025-08-25,13,2,SKU025,222,12,234
2025-08-25,15,1,SKU011,353,37,390
2025-08-25,15,2,SKU035,599,26,625
2025-08-25,15,3,SKU021,452,14,466
2025-08-26,1,2,SKU019,508,27,535
2025-08-26,1,3,SKU004,712,93,805
2025-08-26,2,1,SKU029,366,17,383
2025-08-26,2,3,SKU034,251,13,264
2025-08-26,3,1,SKU029,509,19,528
2025-08-26,3,2,SKU024,336,29,365
2025-08-26,3,3,SKU039,519,11,530
2025-08-26,4,1,SKU027,713,97,810
2025-08-26,5,1,SKU007,382,48,430
2025-08-26,5,2,SKU015,572,22,594
2025-08-26,6,1,SKU024,582,39,621
2025-08-26,6,2,SKU027,631,65,696
2025-08-26,6,3,SKU035,497,70,567
2025-08-26,7,1,SKU013,443,48,491
2025-08-26,7,2,SKU009,700,56,756
2025-08-26,7,3,SKU009,772,114,886
2025-08-26,8,1,SKU016,203,18,221
2025-08-26,8,2,SKU024,292,39,331
2025-08-26,8,3,SKU015,564,70,634
2025-08-26,9,1,SKU013,412,13,425
2025-08-26,9,2,SKU008,432,24,456
2025-08-26,9,3,SKU034,416,36,452
2025-08-26,10,1,SKU008,517,54,571
2025-08-26,10,2,SKU030,301,27,328
2025-08-26,10,3,SKU029,732,6,738
2025-08-26,11,1,SKU033,359,29,388
2025-08-26,11,2,SKU014,672,16,688
2025-08-26,12,1,SKU003,735,48,783
2025-08-26,12,2,SKU012,742,49,791
2025-08-26,12,3,SKU018,268,23,291
2025-08-26,13,1,SKU018,597,3,600
2025-08-26,13,2,SKU027,216,26,242
2025-08-26,13,3,SKU003,457,61,518
2025-08-26,14,1,SKU014,469,2,471
2025-08-26,14,2,SKU037,474,12,486
2025-08-26,14,3,SKU003,346,28,374
2025-08-26,15,1,SKU020,799,46,845
2025-08-26,15,2,SKU015,210,20,230
2025-08-27,1,1,SKU016,486,63,549
2025-08-27,1,2,SKU008,209,20,229
2025-08-27,1,3,SKU009,701,93,794
2025-08-27,2,2,SKU026,351,15,366
2025-08-27,2,3,SKU018,762,93,855
2025-08-27,3,1,SKU009,761,10,771
2025-08-27,3,3,SKU017,246,8,254
2025-08-27,4,1,SKU009,611,59,670
2025-08-27,4,2,SKU018,344,2,346
2025-08-27,4,3,SKU030,210,15,225
2025-08-27,5,2,SKU021,790,35,825
2025-08-27,5,3,SKU001,254,13,267
2025-08-27,6,1,SKU022,461,42,503
2025-08-27,6,2,SKU036,339,42,381
2025-08-27,6,3,SKU020,468,26,494
2025-08-27,7,2,SKU007,796,101,897
2025-08-27,7,3,SKU033,372,49,421
2025-08-27,8,1,SKU026,766,100,866
2025-08-27,8,2,SKU016,745,81,826
2025-08-27,8,3,SKU017,241,17,258
2025-08-27,9,1,SKU007,350,47,397
2025-08-27,9,2,SKU001,751,78,829
2025-08-27,10,1,SKU034,535,51,586
2025-08-27,10,2,SKU029,773,39,812
2025-08-27,10,3,SKU035,414,38,452
2025-08-27,11,1,SKU010,611,32,643
2025-08-27,11,2,SKU034,288,26,314
2025-08-27,11,3,SKU016,264,38,302
2025-08-27,12,1,SKU007,287,15,302
2025-08-27,12,2,SKU001,792,107,899
2025-08-27,12,3,SKU029,539,7,546
2025-08-27,13,1,SKU005,622,13,635
2025-08-27,13,2,SKU010,610,74,684
2025-08-27,13,3,SKU037,435,23,458
2025-08-27,14,1,SKU030,759,30,789
2025-08-27,14,2,SKU025,366,24,390
2025-08-27,14,3,SKU001,390,40,430
2025-08-27,15,3,SKU033,393,3,396
2025-08-28,1,1,SKU010,244,24,268
2025-08-28,1,3,SKU032,736,74,810
2025-08-28,2,1,SKU035,522,9,531
2025-08-28,2,2,SKU032,440,37,477
2025-08-28,2,3,SKU037,474,39,513
2025-08-28,3,1,SKU037,390,21,411
2025-08-28,3,2,SKU009,532,7,539
2025-08-28,3,3,SKU007,531,4,535
2025-08-28,4,1,SKU038,345,12,357
2025-08-28,4,2,SKU019,754,88,842
2025-08-28,5,1,SKU020,428,13,441
2025-08-28,5,2,SKU001,581,46,627
2025-08-28,5,3,SKU038,308,43,351
2025-08-28,6,1,SKU025,204,17,221
2025-08-28,6,2,SKU037,247,13,260
2025-08-28,7,1,SKU024,303,12,315
2025-08-28,7,2,SKU015,706,99,805
2025-08-28,7,3,SKU016,446,59,505
2025-08-28,8,1,SKU037,337,12,349
2025-08-28,8,2,SKU027,234,16,250
2025-08-28,8,3,SKU008,723,18,741
2025-08-28,9,1,SKU012,425,32,457
2025-08-28,9,2,SKU002,650,59,709
2025-08-28,9,3,SKU036,569,7,576
2025-08-28,10,1,SKU027,775,20,795
2025-08-28,10,2,SKU027,686,32,718
2025-08-28,10,3,SKU029,623,10,633
2025-08-28,11,1,SKU015,486,15,501
2025-08-28,11,2,SKU014,593,23,616
2025-08-28,11,3,SKU020,681,37,718
2025-08-28,12,2,SKU004,346,42,388
2025-08-28,12,3,SKU018,354,12,366
2025-08-28,13,2,SKU036,528,58,586
2025-08-28,13,3,SKU002,257,24,281
2025-08-28,14,1,SKU014,647,31,678
2025-08-28,14,2,SKU013,314,4,318
2025-08-28,14,3,SKU015,307,44,351
2025-08-28,15,1,SKU003,618,50,668
2025-08-28,15,2,SKU020,538,3,541
2025-08-28,15,3,SKU019,325,36,361
2025-08-29,1,1,SKU015,658,68,726
2025-08-29,1,2,SKU001,596,52,648
2025-08-29,1,3,SKU018,457,15,472
2025-08-29,2,1,SKU029,348,32,380
2025-08-29,2,3,SKU018,763,12,775
2025-08-29,3,2,SKU027,266,19,285
2025-08-29,3,3,SKU036,704,19,723
2025-08-29,4,1,SKU029,456,54,510
2025-08-29,4,3,SKU037,262,33,295
2025-08-29,5,1,SKU022,739,74,813
2025-08-29,5,2,SKU020,445,26,471
2025-08-29,5,3,SKU004,617,83,700
2025-08-29,6,1,SKU029,283,29,312
2025-08-29,6,2,SKU021,339,12,351
2025-08-29,6,3,SKU005,208,9,217
2025-08-29,7,1,SKU027,510,34,544
2025-08-29,7,3,SKU039,432,51,483
2025-08-29,8,1,SKU022,250,10,260
2025-08-29,8,2,SKU027,732,20,752
2025-08-29,8,3,SKU033,383,7,390
2025-08-29,9,1,SKU018,360,21,381
2025-08-29,9,2,SKU019,723,61,784
2025-08-29,9,3,SKU030,269,5,274
2025-08-29,10,1,SKU016,655,24,679
2025-08-29,10,2,SKU039,315,25,340
2025-08-29,10,3,SKU028,467,29,496
2025-08-29,11,1,SKU010,308,13,321
2025-08-29,11,2,SKU010,591,83,674
2025-08-29,11,3,SKU004,518,9,527
2025-08-29,12,1,SKU004,470,53,523
2025-08-29,12,2,SKU002,745,105,850
2025-08-29,13,1,SKU013,379,24,403
2025-08-29,13,2,SKU022,642,0,642
2025-08-29,13,3,SKU035,517,2,519
2025-08-29,14,1,SKU025,528,26,554
2025-08-29,14,3,SKU019,693,95,788
2025-08-29,15,2,SKU024,719,42,761
2025-08-30,1,1,SKU020,557,45,602
2025-08-30,1,2,SKU034,223,19,242
2025-08-30,1,3,SKU013,331,47,378
2025-08-30,2,1,SKU010,353,44,397
2025-08-30,2,2,SKU028,584,12,596
2025-08-30,2,3,SKU006,474,69,543
2025-08-30,3,2,SKU028,275,3,278
2025-08-30,4,1,SKU018,683,15,698
2025-08-30,4,3,SKU022,657,29,686
2025-08-30,5,1,SKU005,610,72,682
2025-08-30,5,2,SKU029,365,33,398
2025-08-30,5,3,SKU035,738,85,823
2025-08-30,6,1,SKU020,515,40,555
2025-08-30,6,2,SKU017,503,28,531
2025-08-30,6,3,SKU016,255,29,284
2025-08-30,7,1,SKU030,515,63,578
2025-08-30,7,2,SKU010,690,94,784
2025-08-30,7,3,SKU009,640,85,725
2025-08-30,8,1,SKU038,337,34,371
2025-08-30,8,2,SKU012,709,24,733
2025-08-30,8,3,SKU037,301,12,313
2025-08-30,9,1,SKU037,548,23,571
2025-08-30,9,2,SKU016,521,36,557
2025-08-30,9,3,SKU004,433,10,443
2025-08-30,10,1,SKU005,431,48,479
2025-08-30,10,3,SKU015,466,35,501
2025-08-30,11,1,SKU013,491,41,532
2025-08-30,11,3,SKU040,212,29,241
2025-08-30,12,2,SKU022,653,31,684
2025-08-30,12,3,SKU014,706,55,761
2025-08-30,13,1,SKU003,674,64,738
2025-08-30,13,2,SKU039,353,51,404
2025-08-30,14,1,SKU017,478,49,527
2025-08-30,14,2,SKU026,786,24,810
2025-08-30,14,3,SKU008,415,8,423
2025-08-30,15,1,SKU021,668,95,763
2025-08-30,15,2,SKU038,343,36,379
2025-08-30,15,3,SKU002,790,48,838
2025-08-31,1,1,SKU018,617,54,671
2025-08-31,1,2,SKU003,667,45,712
2025-08-31,1,3,SKU033,453,12,465
2025-08-31,2,1,SKU022,564,70,634
2025-08-31,2,2,SKU009,378,19,397
2025-08-31,2,3,SKU017,753,63,816
2025-08-31,3,2,SKU016,752,1,753
2025-08-31,3,3,SKU031,231,28,259
2025-08-31,4,1,SKU013,208,21,229
2025-08-31,4,2,SKU026,501,58,559
2025-08-31,4,3,SKU002,307,12,319
2025-08-31,5,1,SKU001,553,15,568
2025-08-31,5,2,SKU019,259,37,296
2025-08-31,5,3,SKU008,233,8,241
2025-08-31,6,1,SKU038,688,8,696
2025-08-31,6,2,SKU037,719,54,773
2025-08-31,6,3,SKU027,765,95,860
2025-08-31,7,1,SKU036,254,13,267
2025-08-31,7,2,SKU039,769,27,796
2025-08-31,7,3,SKU020,476,34,510
2025-08-31,8,1,SKU029,244,23,267
2025-08-31,8,2,SKU026,374,32,406
2025-08-31,8,3,SKU012,601,29,630
2025-08-31,9,1,SKU017,664,32,696
2025-08-31,9,2,SKU003,520,66,586
2025-08-31,9,3,SKU033,586,3,589
2025-08-31,10,1,SKU023,626,59,685
2025-08-31,10,2,SKU015,604,85,689
2025-08-31,10,3,SKU013,309,9,318
2025-08-31,11,1,SKU038,609,6,615
2025-08-31,11,2,SKU027,316,15,331
2025-08-31,12,1,SKU024,755,103,858
2025-08-31,12,2,SKU005,393,29,422
2025-08-31,12,3,SKU022,397,40,437
2025-08-31,13,1,SKU002,373,4,377
2025-08-31,13,3,SKU014,625,16,641
2025-08-31,14,1,SKU024,436,10,446
2025-08-31,14,2,SKU039,606,79,685
2025-08-31,15,1,SKU009,637,71,708
2025-08-31,15,2,SKU006,511,8,519
2025-08-31,15,3,SKU006,493,58,551
2025-09-01,1,1,SKU034,295,1,296
2025-09-01,1,2,SKU022,468,50,518
2025-09-01,2,1,SKU005,742,83,825
2025-09-01,2,3,SKU010,292,37,329
2025-09-01,3,1,SKU038,323,28,351
2025-09-01,3,2,SKU004,330,17,347
2025-09-01,3,3,SKU012,440,33,473
2025-09-01,4,1,SKU016,209,26,235
2025-09-01,4,2,SKU033,420,33,453
2025-09-01,4,3,SKU004,398,3,401
2025-09-01,5,1,SKU004,443,21,464
2025-09-01,5,3,SKU003,525,69,594
2025-09-01,6,1,SKU039,645,83,728
2025-09-01,6,3,SKU039,523,40,563
2025-09-01,7,1,SKU017,201,24,225
2025-09-01,7,2,SKU034,355,3,358
2025-09-01,8,1,SKU024,388,11,399
2025-09-01,8,2,SKU014,440,56,496
2025-09-01,8,3,SKU012,679,96,775
2025-09-01,9,1,SKU034,274,27,301
2025-09-01,9,2,SKU019,648,85,733
2025-09-01,10,1,SKU033,589,74,663
2025-09-01,10,2,SKU023,336,28,364
2025-09-01,10,3,SKU015,409,51,460
2025-09-01,11,1,SKU025,587,80,667
2025-09-01,11,2,SKU038,538,21,559
2025-09-01,11,3,SKU007,450,30,480
2025-09-01,12,1,SKU006,507,73,580
2025-09-01,12,2,SKU009,783,32,815
2025-09-01,12,3,SKU025,541,73,614
2025-09-01,13,1,SKU032,622,81,703
2025-09-01,13,2,SKU032,226,19,245
2025-09-01,13,3,SKU014,678,87,765
2025-09-01,14,1,SKU018,344,45,389
2025-09-01,14,2,SKU024,297,41,338
2025-09-01,14,3,SKU036,265,20,285
2025-09-01,15,1,SKU005,258,18,276
2025-09-01,15,2,SKU023,259,34,293
2025-09-01,15,3,SKU007,357,3,360
2025-09-02,1,1,SKU022,406,4,410
2025-09-02,1,2,SKU015,440,64,504
2025-09-02,1,3,SKU011,647,87,734
2025-09-02,2,1,SKU002,599,5,604
2025-09-02,2,2,SKU006,304,28,332
2025-09-02,2,3,SKU022,779,104,883
2025-09-02,3,2,SKU036,705,47,752
2025-09-02,3,3,SKU024,570,57,627
2025-09-02,4,1,SKU018,762,78,840
2025-09-02,4,2,SKU015,547,39,586
2025-09-02,4,3,SKU036,539,79,618
2025-09-02,5,2,SKU024,391,44,435
2025-09-02,5,3,SKU030,532,10,542
2025-09-02,6,2,SKU024,364,41,405
2025-09-02,6,3,SKU007,598,69,667
2025-09-02,7,1,SKU040,334,40,374
2025-09-02,7,2,SKU002,348,19,367
2025-09-02,8,2,SKU007,245,12,257
2025-09-02,9,1,SKU016,497,2,499
2025-09-02,9,2,SKU035,491,53,544
2025-09-02,9,3,SKU030,671,24,695
2025-09-02,10,1,SKU014,519,46,565
2025-09-02,10,2,SKU034,434,37,471
2025-09-02,11,1,SKU015,452,46,498
2025-09-02,11,2,SKU002,794,33,827
2025-09-02,11,3,SKU040,355,28,383
2025-09-02,12,1,SKU038,283,10,293
2025-09-02,12,2,SKU023,214,24,238
2025-09-02,12,3,SKU018,306,11,317
2025-09-02,13,1,SKU019,624,52,676
2025-09-02,13,2,SKU014,203,1,204
2025-09-02,13,3,SKU032,583,51,634
2025-09-02,14,1,SKU019,718,60,778
2025-09-02,14,2,SKU040,548,36,584
2025-09-02,14,3,SKU017,627,67,694
2025-09-02,15,2,SKU015,210,0,210
2025-09-02,15,3,SKU014,594,17,611
2025-09-03,1,1,SKU040,716,14,730
2025-09-03,1,2,SKU031,793,17,810
2025-09-03,1,3,SKU003,404,31,435
2025-09-03,2,1,SKU021,419,52,471
2025-09-03,2,2,SKU012,421,5,426
2025-09-03,2,3,SKU012,458,8,466
2025-09-03,3,2,SKU023,540,58,598
2025-09-03,3,3,SKU022,598,31,629
2025-09-03,4,1,SKU017,684,86,770
2025-09-03,4,2,SKU004,666,18,684
2025-09-03,4,3,SKU024,268,29,297
2025-09-03,5,1,SKU001,700,23,723
2025-09-03,5,2,SKU025,581,58,639
2025-09-03,5,3,SKU018,337,12,349
2025-09-03,6,1,SKU015,724,24,748
2025-09-03,6,2,SKU035,690,39,729
2025-09-03,6,3,SKU019,223,10,233
2025-09-03,7,1,SKU033,563,9,572
2025-09-03,7,2,SKU021,262,37,299
2025-09-03,7,3,SKU005,363,25,388
2025-09-03,8,1,SKU031,587,13,600
2025-09-03,8,2,SKU017,352,32,384
2025-09-03,8,3,SKU032,223,15,238
2025-09-03,9,1,SKU021,318,38,356
2025-09-03,9,2,SKU011,499,15,514
2025-09-03,9,3,SKU004,492,58,550
2025-09-03,10,1,SKU011,734,27,761
2025-09-03,10,3,SKU010,660,62,722
2025-09-03,11,1,SKU040,341,35,376
2025-09-03,11,2,SKU004,657,29,686
2025-09-03,11,3,SKU004,256,30,286
2025-09-03,12,1,SKU006,402,49,451
2025-09-03,12,2,SKU005,579,67,646
2025-09-03,12,3,SKU020,351,6,357
2025-09-03,13,1,SKU001,434,46,480
2025-09-03,14,1,SKU011,232,14,246
2025-09-03,14,2,SKU017,416,6,422
2025-09-03,14,3,SKU019,413,21,434
2025-09-03,15,1,SKU031,423,14,437
2025-09-03,15,2,SKU018,594,10,604
2025-09-03,15,3,SKU016,217,14,231
2025-09-04,1,1,SKU017,431,19,450
2025-09-04,1,2,SKU029,416,60,476
2025-09-04,1,3,SKU014,454,48,502
2025-09-04,2,1,SKU027,337,31,368
2025-09-04,2,2,SKU005,790,96,886
2025-09-04,2,3,SKU034,450,15,465
2025-09-04,3,1,SKU022,578,29,607
2025-09-04,3,3,SKU014,560,47,607
2025-09-04,4,1,SKU019,765,36,801
2025-09-04,4,3,SKU030,350,9,359
2025-09-04,5,1,SKU040,406,54,460
2025-09-04,5,2,SKU004,722,90,812
2025-09-04,5,3,SKU029,213,18,231
2025-09-04,6,1,SKU040,768,15,783
2025-09-04,6,2,SKU031,578,53,631
2025-09-04,6,3,SKU019,729,78,807
2025-09-04,7,1,SKU004,304,1,305
2025-09-04,7,3,SKU019,748,10,758
2025-09-04,8,1,SKU014,782,58,840
2025-09-04,8,2,SKU021,628,0,628
2025-09-04,8,3,SKU009,788,21,809
2025-09-04,9,3,SKU017,524,60,584
2025-09-04,10,1,SKU013,547,16,563
2025-09-04,10,2,SKU011,742,75,817
2025-09-04,10,3,SKU023,382,34,416
2025-09-04,11,1,SKU007,507,34,541
2025-09-04,11,2,SKU026,520,45,565
2025-09-04,11,3,SKU024,288,28,316
2025-09-04,12,1,SKU029,337,30,367
2025-09-04,12,2,SKU007,407,47,454
2025-09-04,12,3,SKU001,628,75,703
2025-09-04,13,1,SKU033,556,26,582
2025-09-04,13,2,SKU013,486,15,501
2025-09-04,14,1,SKU036,570,44,614
2025-09-04,14,3,SKU028,384,11,395
2025-09-04,15,1,SKU039,764,110,874
2025-09-04,15,2,SKU026,215,25,240
2025-09-04,15,3,SKU024,785,33,818
2025-09-05,1,1,SKU020,708,26,734
2025-09-05,1,2,SKU032,523,17,540
2025-09-05,1,3,SKU031,570,23,593
2025-09-05,2,1,SKU002,654,5,659
2025-09-05,2,2,SKU005,400,52,452
2025-09-05,2,3,SKU026,471,15,486
2025-09-05,3,1,SKU008,705,36,741
2025-09-05,3,2,SKU003,577,45,622
2025-09-05,3,3,SKU016,416,50,466
2025-09-05,4,2,SKU035,401,54,455
2025-09-05,4,3,SKU018,559,32,591
2025-09-05,5,1,SKU005,204,20,224
2025-09-05,5,2,SKU020,459,2,461
2025-09-05,5,3,SKU030,425,23,448
2025-09-05,6,1,SKU038,767,93,860
2025-09-05,6,2,SKU027,621,86,707
2025-09-05,6,3,SKU017,495,11,506
2025-09-05,7,1,SKU011,370,44,414
2025-09-05,7,2,SKU036,749,16,765
2025-09-05,8,1,SKU032,632,41,673
2025-09-05,8,2,SKU012,440,59,499
2025-09-05,8,3,SKU022,636,4,640
2025-09-05,9,1,SKU003,511,45,556
2025-09-05,9,2,SKU027,450,2,452
2025-09-05,9,3,SKU021,703,56,759
2025-09-05,10,3,SKU022,584,84,668
2025-09-05,11,1,SKU007,550,40,590
2025-09-05,11,2,SKU040,421,0,421
2025-09-05,11,3,SKU006,557,22,579
2025-09-05,12,2,SKU040,436,36,472
2025-09-05,12,3,SKU035,400,27,427
2025-09-05,13,1,SKU023,562,8,570
2025-09-05,13,2,SKU024,229,12,241
2025-09-05,13,3,SKU015,347,5,352
2025-09-05,14,1,SKU023,301,12,313
2025-09-05,14,2,SKU039,666,4,670
2025-09-05,14,3,SKU028,436,19,455
2025-09-05,15,1,SKU031,433,6,439
2025-09-05,15,2,SKU035,694,7,701
2025-09-05,15,3,SKU015,467,33,500
2025-09-06,1,2,SKU031,521,43,564
2025-09-06,1,3,SKU031,405,44,449
2025-09-06,2,1,SKU007,680,24,704
2025-09-06,3,1,SKU025,500,4,504
2025-09-06,3,3,SKU029,568,14,582
2025-09-06,4,1,SKU001,207,26,233
2025-09-06,4,3,SKU001,484,49,533
2025-09-06,5,1,SKU002,688,9,697
2025-09-06,5,3,SKU005,239,5,244
2025-09-06,6,1,SKU021,351,48,399
2025-09-06,6,2,SKU029,643,78,721
2025-09-06,6,3,SKU012,517,46,563
2025-09-06,7,1,SKU022,636,62,698
2025-09-06,7,2,SKU040,399,51,450
2025-09-06,7,3,SKU016,223,18,241
2025-09-06,8,1,SKU017,687,44,731
2025-09-06,8,2,SKU002,239,26,265
2025-09-06,8,3,SKU017,428,12,440
2025-09-06,9,1,SKU021,670,59,729
2025-09-06,9,2,SKU035,414,33,447
2025-09-06,10,1,SKU031,278,12,290
2025-09-06,10,2,SKU032,417,37,454
2025-09-06,10,3,SKU032,438,45,483
2025-09-06,11,1,SKU017,413,25,438
2025-09-06,11,2,SKU002,721,23,744
2025-09-06,11,3,SKU017,642,70,712
2025-09-06,12,1,SKU015,235,28,263
2025-09-06,12,2,SKU005,725,58,783
2025-09-06,12,3,SKU024,789,16,805
2025-09-06,13,1,SKU013,614,84,698
2025-09-06,13,2,SKU028,566,37,603
2025-09-06,13,3,SKU004,329,4,333
2025-09-06,14,1,SKU036,306,38,344
2025-09-06,14,2,SKU036,305,27,332
2025-09-06,14,3,SKU027,750,74,824
2025-09-06,15,1,SKU037,370,40,410
2025-09-06,15,3,SKU001,490,34,524
2025-09-07,1,1,SKU026,386,6,392
2025-09-07,1,2,SKU004,445,22,467
2025-09-07,1,3,SKU012,219,15,234
2025-09-07,2,1,SKU016,727,69,796
2025-09-07,2,3,SKU006,733,27,760
2025-09-07,3,1,SKU014,654,60,714
2025-09-07,3,2,SKU023,662,35,697
2025-09-07,3,3,SKU038,611,7,618
2025-09-07,4,1,SKU019,373,40,413
2025-09-07,4,2,SKU017,655,87,742
2025-09-07,5,1,SKU019,647,55,702
2025-09-07,5,2,SKU017,276,28,304
2025-09-07,5,3,SKU022,689,91,780
2025-09-07,6,1,SKU002,655,65,720
2025-09-07,6,2,SKU020,644,72,716
2025-09-07,7,1,SKU032,276,11,287
2025-09-07,7,2,SKU013,744,109,853
2025-09-07,7,3,SKU032,686,94,780
2025-09-07,8,2,SKU039,770,28,798
2025-09-07,8,3,SKU011,754,104,858
2025-09-07,9,2,SKU016,708,4,712
2025-09-07,10,1,SKU011,251,28,279
2025-09-07,10,2,SKU037,655,81,736
2025-09-07,11,1,SKU030,413,18,431
2025-09-07,11,2,SKU028,620,86,706
2025-09-07,12,1,SKU033,695,12,707
2025-09-07,12,2,SKU012,614,18,632
2025-09-07,12,3,SKU031,555,0,555
2025-09-07,13,1,SKU026,534,30,564
2025-09-07,13,3,SKU006,501,59,560
2025-09-07,14,1,SKU019,459,37,496
2025-09-07,14,2,SKU024,369,15,384
2025-09-07,14,3,SKU022,786,115,901
2025-09-07,15,2,SKU013,237,28,265
2025-09-07,15,3,SKU013,432,63,495
2025-09-08,1,2,SKU014,320,18,338
2025-09-08,1,3,SKU040,262,23,285
2025-09-08,2,1,SKU037,526,35,561
2025-09-08,2,2,SKU004,673,41,714
2025-09-08,2,3,SKU033,393,41,434
2025-09-08,3,1,SKU009,657,43,700
2025-09-08,3,2,SKU023,624,65,689
2025-09-08,4,3,SKU011,522,45,567
2025-09-08,5,1,SKU023,219,0,219
2025-09-08,5,2,SKU032,254,11,265
2025-09-08,5,3,SKU037,732,89,821
2025-09-08,6,1,SKU008,590,37,627
2025-09-08,6,2,SKU010,761,58,819
2025-09-08,6,3,SKU035,543,27,570
2025-09-08,7,1,SKU037,497,65,562
2025-09-08,7,3,SKU038,735,104,839
2025-09-08,8,1,SKU033,310,12,322
2025-09-08,8,2,SKU030,339,7,346
2025-09-08,9,1,SKU022,567,29,596
2025-09-08,9,3,SKU007,477,23,500
2025-09-08,10,1,SKU014,229,0,229
2025-09-08,10,2,SKU035,556,67,623
2025-09-08,10,3,SKU005,491,36,527
2025-09-08,11,1,SKU037,248,7,255
2025-09-08,11,2,SKU006,590,28,618
2025-09-08,11,3,SKU002,490,18,508
2025-09-08,12,1,SKU019,348,49,397
2025-09-08,12,2,SKU026,614,17,631
2025-09-08,12,3,SKU036,669,77,746
2025-09-08,13,1,SKU039,544,77,621
2025-09-08,13,2,SKU025,368,6,374
2025-09-08,13,3,SKU039,210,26,236
2025-09-08,14,2,SKU014,216,16,232
2025-09-08,14,3,SKU036,566,28,594
2025-09-08,15,1,SKU036,763,26,789
2025-09-08,15,2,SKU031,647,79,726
2025-09-08,15,3,SKU016,448,55,503
2025-09-09,1,1,SKU036,665,64,729
2025-09-09,1,2,SKU018,625,6,631
2025-09-09,1,3,SKU037,560,68,628
2025-09-09,2,2,SKU037,440,29,469
2025-09-09,2,3,SKU015,368,20,388
2025-09-09,3,1,SKU028,398,24,422
2025-09-09,3,2,SKU016,549,64,613
2025-09-09,3,3,SKU027,655,14,669
2025-09-09,4,2,SKU005,544,23,567
2025-09-09,4,3,SKU011,683,43,726
2025-09-09,5,1,SKU027,500,18,518
2025-09-09,5,2,SKU025,366,44,410
2025-09-09,5,3,SKU009,391,41,432
2025-09-09,6,1,SKU002,349,38,387
2025-09-09,6,3,SKU022,368,10,378
2025-09-09,7,1,SKU023,380,26,406
2025-09-09,7,2,SKU037,510,13,523
2025-09-09,7,3,SKU029,381,36,417
2025-09-09,8,2,SKU038,335,7,342
2025-09-09,8,3,SKU007,718,101,819
2025-09-09,9,1,SKU023,489,39,528
2025-09-09,9,3,SKU037,358,25,383
2025-09-09,10,1,SKU033,310,42,352
2025-09-09,10,2,SKU023,509,46,555
2025-09-09,10,3,SKU023,575,12,587
2025-09-09,11,1,SKU010,768,111,879
2025-09-09,11,3,SKU014,705,81,786
2025-09-09,12,1,SKU005,694,54,748
2025-09-09,12,2,SKU036,297,10,307
2025-09-09,12,3,SKU020,303,40,343
2025-09-09,13,2,SKU002,306,12,318
2025-09-09,13,3,SKU040,321,14,335
2025-09-09,14,2,SKU039,635,87,722
2025-09-09,14,3,SKU029,624,70,694
2025-09-09,15,2,SKU011,270,15,285
2025-09-09,15,3,SKU028,308,5,313
2025-09-10,1,1,SKU027,593,76,669
2025-09-10,1,3,SKU006,313,15,328
2025-09-10,2,1,SKU014,447,55,502
2025-09-10,3,1,SKU009,503,2,505
2025-09-10,3,2,SKU040,715,80,795
2025-09-10,3,3,SKU024,327,23,350
2025-09-10,4,1,SKU027,314,23,337
2025-09-10,4,3,SKU027,728,58,786
2025-09-10,5,1,SKU027,691,15,706
2025-09-10,5,2,SKU025,610,68,678
2025-09-10,5,3,SKU035,412,26,438
2025-09-10,6,2,SKU005,541,58,599
2025-09-10,6,3,SKU032,791,103,894
2025-09-10,7,1,SKU038,343,47,390
2025-09-10,7,2,SKU029,253,2,255
2025-09-10,7,3,SKU035,264,9,273
2025-09-10,8,1,SKU007,766,47,813
2025-09-10,8,2,SKU008,581,23,604
2025-09-10,8,3,SKU005,616,68,684
2025-09-10,9,1,SKU039,248,25,273
2025-09-10,9,2,SKU008,415,29,444
2025-09-10,9,3,SKU002,613,32,645
2025-09-10,10,2,SKU016,235,9,244
2025-09-10,10,3,SKU023,512,33,545
2025-09-10,11,1,SKU026,207,21,228
2025-09-10,11,2,SKU032,758,19,777
2025-09-10,12,1,SKU024,608,13,621
2025-09-10,12,2,SKU018,623,28,651
2025-09-10,13,1,SKU009,755,70,825
2025-09-10,13,2,SKU014,580,10,590
2025-09-10,13,3,SKU035,718,26,744
2025-09-10,14,2,SKU035,704,64,768
2025-09-10,15,1,SKU031,503,2,505
2025-09-10,15,3,SKU012,390,21,411
2025-09-11,1,1,SKU013,453,62,515
2025-09-11,1,2,SKU006,761,63,824
2025-09-11,2,1,SKU016,688,70,758
2025-09-11,2,2,SKU021,724,97,821
2025-09-11,2,3,SKU040,517,60,577
2025-09-11,3,1,SKU038,328,4,332
2025-09-11,3,2,SKU027,684,24,708
2025-09-11,3,3,SKU007,260,20,280
2025-09-11,4,1,SKU005,640,47,687
2025-09-11,4,2,SKU020,551,41,592
2025-09-11,4,3,SKU031,446,8,454
2025-09-11,5,1,SKU040,666,0,666
2025-09-11,6,1,SKU007,735,30,765
2025-09-11,7,2,SKU018,514,58,572
2025-09-11,7,3,SKU013,455,46,501
2025-09-11,8,1,SKU037,640,23,663
2025-09-11,8,2,SKU014,227,24,251
2025-09-11,8,3,SKU033,259,11,270
2025-09-11,9,1,SKU040,227,21,248
2025-09-11,9,2,SKU031,571,45,616
2025-09-11,9,3,SKU022,518,52,570
2025-09-11,10,3,SKU005,269,35,304
2025-09-11,11,1,SKU015,454,9,463
2025-09-11,11,2,SKU021,360,6,366
2025-09-11,12,1,SKU021,385,30,415
2025-09-11,12,2,SKU028,575,75,650
2025-09-11,12,3,SKU031,573,53,626
2025-09-11,13,1,SKU026,412,60,472
2025-09-11,13,2,SKU016,571,18,589
2025-09-11,13,3,SKU028,716,97,813
2025-09-11,14,1,SKU018,615,61,676
2025-09-11,14,2,SKU026,653,13,666
2025-09-11,14,3,SKU007,296,42,338
2025-09-11,15,1,SKU012,210,18,228
2025-09-12,1,2,SKU021,576,8,584
2025-09-12,2,2,SKU021,361,44,405
2025-09-12,2,3,SKU013,450,57,507
2025-09-12,3,1,SKU017,223,12,235
2025-09-12,3,2,SKU031,359,43,402
2025-09-12,3,3,SKU021,784,12,796
2025-09-12,4,1,SKU020,534,76,610
2025-09-12,4,2,SKU034,430,52,482
2025-09-12,5,1,SKU040,497,51,548
2025-09-12,5,2,SKU018,731,82,813
2025-09-12,5,3,SKU026,633,49,682
2025-09-12,6,1,SKU040,426,13,439
2025-09-12,6,2,SKU031,625,81,706
2025-09-12,6,3,SKU020,548,81,629
2025-09-12,7,1,SKU008,775,87,862
2025-09-12,7,2,SKU034,489,43,532
2025-09-12,7,3,SKU021,576,3,579
2025-09-12,8,1,SKU031,618,70,688
2025-09-12,8,2,SKU025,492,45,537
2025-09-12,8,3,SKU039,367,24,391
2025-09-12,9,2,SKU017,265,19,284
2025-09-12,9,3,SKU026,602,3,605
2025-09-12,10,2,SKU016,769,34,803
2025-09-12,11,1,SKU017,638,24,662
2025-09-12,11,2,SKU019,613,4,617
2025-09-12,11,3,SKU017,785,34,819
2025-09-12,12,1,SKU020,224,11,235
2025-09-12,12,2,SKU032,361,53,414
2025-09-12,12,3,SKU016,705,52,757
2025-09-12,13,1,SKU035,218,15,233
2025-09-12,13,2,SKU013,682,43,725
2025-09-12,13,3,SKU022,754,96,850
2025-09-12,14,1,SKU033,211,12,223
2025-09-12,14,2,SKU017,405,3,408
2025-09-12,15,1,SKU012,784,101,885
2025-09-12,15,2,SKU022,603,4,607
2025-09-12,15,3,SKU040,285,11,296
2025-09-13,1,1,SKU013,752,101,853
2025-09-13,1,2,SKU009,568,48,616
2025-09-13,1,3,SKU038,477,23,500
2025-09-13,2,1,SKU013,713,80,793
2025-09-13,2,2,SKU033,748,37,785
2025-09-13,2,3,SKU033,771,31,802
2025-09-13,3,1,SKU019,362,30,392
2025-09-13,3,2,SKU017,388,23,411
2025-09-13,3,3,SKU017,557,7,564
2025-09-13,4,1,SKU031,797,45,842
2025-09-13,4,3,SKU014,332,41,373
2025-09-13,5,1,SKU016,617,23,640
2025-09-13,5,2,SKU034,728,22,750
2025-09-13,6,3,SKU010,451,1,452
2025-09-13,7,1,SKU005,674,15,689
2025-09-13,7,2,SKU037,637,80,717
2025-09-13,7,3,SKU023,234,10,244
2025-09-13,8,2,SKU010,603,13,616
2025-09-13,8,3,SKU001,483,52,535
2025-09-13,9,1,SKU037,715,24,739
2025-09-13,9,2,SKU040,747,70,817
2025-09-13,9,3,SKU031,740,43,783
2025-09-13,10,2,SKU032,219,8,227
2025-09-13,10,3,SKU038,410,0,410
2025-09-13,11,1,SKU017,485,5,490
2025-09-13,11,2,SKU038,642,60,702
2025-09-13,11,3,SKU036,518,41,559
2025-09-13,12,1,SKU011,414,30,444
2025-09-13,12,2,SKU038,581,27,608
2025-09-13,12,3,SKU005,782,12,794
2025-09-13,13,1,SKU012,356,5,361
2025-09-13,13,2,SKU005,205,16,221
2025-09-13,13,3,SKU025,371,11,382
2025-09-13,14,3,SKU002,257,23,280
2025-09-13,15,1,SKU019,589,36,625
2025-09-13,15,2,SKU008,208,29,237
2025-09-13,15,3,SKU028,371,40,411
2025-09-14,1,1,SKU035,549,56,605
2025-09-14,1,2,SKU036,722,61,783
2025-09-14,1,3,SKU006,563,54,617
2025-09-14,2,1,SKU015,646,11,657
2025-09-14,2,2,SKU014,281,11,292
2025-09-14,2,3,SKU001,512,61,573
2025-09-14,3,1,SKU033,661,3,664
2025-09-14,3,3,SKU009,710,86,796
2025-09-14,4,1,SKU014,708,29,737
2025-09-14,4,2,SKU010,296,36,332
2025-09-14,4,3,SKU028,466,37,503
2025-09-14,5,1,SKU003,207,17,224
2025-09-14,5,2,SKU028,461,17,478
2025-09-14,5,3,SKU013,739,57,796
2025-09-14,6,2,SKU024,573,33,606
2025-09-14,6,3,SKU004,774,12,786
2025-09-14,7,2,SKU008,430,30,460
2025-09-14,7,3,SKU029,277,33,310
2025-09-14,8,1,SKU011,517,23,540
2025-09-14,8,2,SKU011,645,0,645
2025-09-14,8,3,SKU036,245,0,245
2025-09-14,9,1,SKU014,481,66,547
2025-09-14,9,3,SKU005,565,67,632
2025-09-14,10,1,SKU039,453,40,493
2025-09-14,10,2,SKU026,676,83,759
2025-09-14,11,1,SKU029,419,21,440
2025-09-14,11,2,SKU016,678,13,691
2025-09-14,11,3,SKU019,648,69,717
2025-09-14,12,1,SKU004,241,22,263
2025-09-14,12,2,SKU024,290,36,326
2025-09-14,12,3,SKU029,258,16,274
2025-09-14,13,2,SKU002,436,53,489
2025-09-14,13,3,SKU037,498,9,507
2025-09-14,14,1,SKU017,419,58,477
2025-09-14,14,2,SKU031,736,8,744
2025-09-14,14,3,SKU022,446,34,480
2025-09-14,15,1,SKU027,746,100,846
2025-09-14,15,2,SKU032,455,33,488
2025-09-14,15,3,SKU027,598,79,677
2025-09-15,1,1,SKU038,456,14,470
2025-09-15,1,2,SKU025,515,36,551
2025-09-15,1,3,SKU025,229,17,246
2025-09-15,2,1,SKU009,215,10,225
2025-09-15,2,2,SKU028,738,91,829
2025-09-15,2,3,SKU007,789,52,841
2025-09-15,3,1,SKU014,750,30,780
2025-09-15,3,2,SKU032,307,7,314
2025-09-15,3,3,SKU010,782,65,847
2025-09-15,4,1,SKU038,203,25,228
2025-09-15,4,2,SKU020,763,83,846
2025-09-15,4,3,SKU030,254,13,267
2025-09-15,5,1,SKU032,752,45,797
2025-09-15,5,2,SKU001,312,32,344
2025-09-15,5,3,SKU015,750,104,854
2025-09-15,6,1,SKU014,726,25,751
2025-09-15,6,3,SKU026,641,84,725
2025-09-15,7,1,SKU024,475,0,475
2025-09-15,7,2,SKU009,773,100,873
2025-09-15,7,3,SKU009,406,37,443
2025-09-15,8,1,SKU019,529,68,597
2025-09-15,8,2,SKU027,269,21,290
2025-09-15,8,3,SKU023,515,30,545
2025-09-15,9,1,SKU038,254,24,278
2025-09-15,9,2,SKU032,695,10,705
2025-09-15,9,3,SKU015,547,71,618
2025-09-15,10,1,SKU039,730,78,808
2025-09-15,10,2,SKU014,349,50,399
2025-09-15,10,3,SKU001,473,63,536
2025-09-15,11,2,SKU026,772,52,824
2025-09-15,11,3,SKU015,376,43,419
2025-09-15,12,1,SKU011,366,3,369
2025-09-15,12,2,SKU009,742,76,818
2025-09-15,12,3,SKU016,399,57,456
2025-09-15,13,1,SKU035,493,44,537
2025-09-15,13,2,SKU004,279,10,289
2025-09-15,13,3,SKU033,267,3,270
2025-09-15,14,1,SKU021,319,1,320
2025-09-15,14,2,SKU036,246,3,249
2025-09-15,14,3,SKU029,343,10,353
2025-09-15,15,1,SKU011,482,52,534
2025-09-15,15,3,SKU035,446,47,493
2025-09-16,1,2,SKU027,606,57,663
2025-09-16,1,3,SKU003,207,22,229
2025-09-16,2,1,SKU001,279,22,301
2025-09-16,2,2,SKU039,520,13,533
2025-09-16,2,3,SKU024,383,1,384
2025-09-16,3,1,SKU034,436,2,438
2025-09-16,3,2,SKU029,491,68,559
2025-09-16,3,3,SKU031,226,7,233
2025-09-16,4,1,SKU021,545,55,600
2025-09-16,4,2,SKU004,518,50,568
2025-09-16,5,1,SKU015,675,66,741
2025-09-16,5,2,SKU014,456,1,457
2025-09-16,5,3,SKU032,202,25,227
2025-09-16,6,1,SKU023,201,2,203
2025-09-16,6,2,SKU002,335,0,335
2025-09-16,6,3,SKU032,654,50,704
2025-09-16,7,1,SKU007,590,79,669
2025-09-16,7,3,SKU011,398,4,402
2025-09-16,8,1,SKU015,264,10,274
2025-09-16,8,2,SKU036,444,1,445
2025-09-16,8,3,SKU002,647,33,680
2025-09-16,9,1,SKU001,593,18,611
2025-09-16,9,2,SKU026,261,21,282
2025-09-16,9,3,SKU025,293,29,322
2025-09-16,10,1,SKU021,283,38,321
2025-09-16,11,2,SKU020,288,6,294
2025-09-16,11,3,SKU017,671,57,728
2025-09-16,12,3,SKU023,662,83,745
2025-09-16,13,1,SKU025,753,27,780
2025-09-16,13,2,SKU020,587,86,673
2025-09-16,13,3,SKU027,547,9,556
2025-09-16,14,1,SKU007,698,92,790
2025-09-16,14,2,SKU034,576,19,595
2025-09-16,14,3,SKU027,498,16,514
2025-09-16,15,1,SKU013,781,96,877
2025-09-16,15,2,SKU021,713,45,758
2025-09-16,15,3,SKU032,576,72,648
2025-09-17,1,1,SKU030,708,92,800
2025-09-17,1,3,SKU036,363,51,414
2025-09-17,2,1,SKU029,546,6,552
2025-09-17,2,2,SKU004,410,17,427
2025-09-17,2,3,SKU039,482,63,545
2025-09-17,3,2,SKU007,528,55,583
2025-09-17,4,1,SKU024,345,27,372
2025-09-17,4,2,SKU031,740,89,829
2025-09-17,4,3,SKU039,557,50,607
2025-09-17,5,1,SKU028,283,5,288
2025-09-17,5,2,SKU020,468,18,486
2025-09-17,5,3,SKU024,259,17,276
2025-09-17,6,1,SKU011,533,2,535
2025-09-17,7,1,SKU031,661,97,758
2025-09-17,7,2,SKU008,427,2,429
2025-09-17,7,3,SKU015,246,5,251
2025-09-17,8,2,SKU033,577,8,585
2025-09-17,8,3,SKU002,760,94,854
2025-09-17,9,1,SKU011,396,52,448
2025-09-17,9,2,SKU011,553,7,560
2025-09-17,9,3,SKU021,235,21,256
2025-09-17,10,2,SKU020,290,33,323
2025-09-17,10,3,SKU023,403,48,451
2025-09-17,11,3,SKU021,498,30,528
2025-09-17,12,1,SKU023,612,74,686
2025-09-17,12,2,SKU025,647,22,669
2025-09-17,12,3,SKU006,233,16,249
2025-09-17,13,3,SKU034,525,39,564
2025-09-17,14,1,SKU027,608,57,665
2025-09-17,14,3,SKU029,494,30,524
2025-09-17,15,1,SKU015,417,24,441
2025-09-17,15,2,SKU018,761,18,779
2025-09-17,15,3,SKU016,682,75,757
2025-09-18,1,1,SKU033,565,10,575
2025-09-18,1,2,SKU023,386,40,426
2025-09-18,1,3,SKU003,373,42,415
2025-09-18,2,1,SKU001,264,26,290
2025-09-18,2,2,SKU009,701,88,789
2025-09-18,2,3,SKU036,336,42,378
2025-09-18,3,1,SKU038,757,26,783
2025-09-18,3,2,SKU003,254,25,279
2025-09-18,3,3,SKU034,599,16,615
2025-09-18,4,2,SKU006,437,1,438
2025-09-18,4,3,SKU028,494,41,535
2025-09-18,5,1,SKU029,266,27,293
2025-09-18,5,2,SKU032,728,105,833
2025-09-18,5,3,SKU016,382,12,394
2025-09-18,6,1,SKU029,493,26,519
2025-09-18,6,2,SKU023,358,43,401
2025-09-18,6,3,SKU036,796,99,895
2025-09-18,7,1,SKU031,319,32,351
2025-09-18,7,2,SKU027,368,13,381
2025-09-18,7,3,SKU024,347,41,388
2025-09-18,8,1,SKU019,201,16,217
2025-09-18,8,2,SKU007,654,70,724
2025-09-18,8,3,SKU014,772,26,798
2025-09-18,9,1,SKU022,778,80,858
2025-09-18,9,2,SKU038,455,0,455
2025-09-18,9,3,SKU028,451,36,487
2025-09-18,10,1,SKU027,429,26,455
2025-09-18,10,2,SKU017,395,45,440
2025-09-18,10,3,SKU030,623,82,705
2025-09-18,11,1,SKU019,390,28,418
2025-09-18,11,2,SKU024,413,40,453
2025-09-18,11,3,SKU035,317,3,320
2025-09-18,12,1,SKU007,367,51,418
2025-09-18,12,2,SKU002,618,14,632
2025-09-18,12,3,SKU032,619,54,673
2025-09-18,13,1,SKU035,752,71,823
2025-09-18,13,2,SKU011,393,56,449
2025-09-18,13,3,SKU039,675,67,742
2025-09-18,14,1,SKU032,454,18,472
2025-09-18,14,3,SKU009,408,48,456
2025-09-18,15,1,SKU016,402,26,428
2025-09-18,15,2,SKU022,584,31,615
2025-09-18,15,3,SKU018,720,85,805
2025-09-19,2,1,SKU013,398,34,432
2025-09-19,2,2,SKU009,275,31,306
2025-09-19,3,1,SKU026,748,111,859
2025-09-19,3,2,SKU021,293,10,303
2025-09-19,3,3,SKU023,488,50,538
2025-09-19,4,1,SKU029,640,22,662
2025-09-19,4,2,SKU040,435,55,490
2025-09-19,4,3,SKU025,598,6,604
2025-09-19,5,1,SKU005,663,79,742
2025-09-19,5,2,SKU035,578,48,626
2025-09-19,5,3,SKU024,236,12,248
2025-09-19,6,1,SKU007,289,17,306
2025-09-19,6,2,SKU019,512,49,561
2025-09-19,6,3,SKU030,448,43,491
2025-09-19,7,1,SKU029,450,51,501
2025-09-19,7,2,SKU025,651,90,741
2025-09-19,7,3,SKU014,339,38,377
2025-09-19,8,1,SKU011,276,27,303
2025-09-19,8,2,SKU033,270,22,292
2025-09-19,8,3,SKU031,592,62,654
2025-09-19,9,2,SKU009,691,91,782
2025-09-19,9,3,SKU028,720,101,821
2025-09-19,10,1,SKU009,619,17,636
2025-09-19,10,2,SKU007,653,82,735
2025-09-19,10,3,SKU005,682,23,705
2025-09-19,11,1,SKU032,571,37,608
2025-09-19,11,2,SKU037,734,64,798
2025-09-19,12,1,SKU034,256,35,291
2025-09-19,12,2,SKU015,561,20,581
2025-09-19,12,3,SKU038,372,18,390
2025-09-19,13,2,SKU006,277,6,283
2025-09-19,13,3,SKU016,659,73,732
2025-09-19,14,1,SKU022,675,98,773
2025-09-19,14,2,SKU011,580,24,604
2025-09-19,14,3,SKU009,702,39,741
2025-09-19,15,1,SKU028,354,7,361
2025-09-19,15,2,SKU030,746,97,843
2025-09-19,15,3,SKU026,473,46,519
2025-09-20,1,1,SKU023,491,9,500
2025-09-20,1,2,SKU014,506,56,562
2025-09-20,1,3,SKU019,519,41,560
2025-09-20,2,1,SKU034,749,33,782
2025-09-20,2,2,SKU039,734,42,776
2025-09-20,3,1,SKU008,549,30,579
2025-09-20,3,2,SKU035,611,13,624
2025-09-20,3,3,SKU025,444,48,492
2025-09-20,4,1,SKU010,777,25,802
2025-09-20,4,3,SKU015,277,9,286
2025-09-20,5,1,SKU013,424,58,482
2025-09-20,5,2,SKU015,418,17,435
2025-09-20,5,3,SKU016,284,25,309
2025-09-20,6,1,SKU003,709,42,751
2025-09-20,6,2,SKU016,706,21,727
2025-09-20,6,3,SKU009,756,46,802
2025-09-20,7,1,SKU040,388,47,435
2025-09-20,7,2,SKU001,727,0,727
2025-09-20,7,3,SKU024,750,81,831
2025-09-20,8,1,SKU018,458,17,475
2025-09-20,8,3,SKU023,339,11,350
2025-09-20,9,1,SKU037,571,4,575
2025-09-20,9,2,SKU009,427,25,452
2025-09-20,9,3,SKU002,200,29,229
2025-09-20,10,1,SKU002,372,50,422
2025-09-20,10,2,SKU037,747,89,836
2025-09-20,10,3,SKU021,634,38,672
2025-09-20,11,1,SKU011,588,16,604
2025-09-20,11,2,SKU003,248,19,267
2025-09-20,11,3,SKU010,228,10,238
2025-09-20,12,1,SKU013,393,24,417
2025-09-20,12,2,SKU021,358,47,405
2025-09-20,12,3,SKU028,330,37,367
2025-09-20,13,1,SKU007,791,15,806
2025-09-20,13,2,SKU024,253,5,258
2025-09-20,14,1,SKU024,448,2,450
2025-09-20,14,2,SKU039,583,74,657
2025-09-20,14,3,SKU004,278,36,314
2025-09-20,15,1,SKU027,637,90,727
2025-09-20,15,3,SKU011,792,100,892
2025-09-21,1,1,SKU006,498,31,529
2025-09-21,1,3,SKU027,227,23,250
2025-09-21,2,1,SKU037,361,38,399
2025-09-21,2,3,SKU020,620,40,660
2025-09-21,3,1,SKU014,623,91,714
2025-09-21,3,2,SKU030,689,59,748
2025-09-21,3,3,SKU039,268,4,272
2025-09-21,4,1,SKU037,618,61,679
2025-09-21,4,2,SKU012,492,43,535
2025-09-21,4,3,SKU024,427,41,468
2025-09-21,5,1,SKU030,735,57,792
2025-09-21,5,2,SKU023,591,53,644
2025-09-21,5,3,SKU018,500,19,519
2025-09-21,6,1,SKU020,273,35,308
2025-09-21,6,2,SKU024,260,26,286
2025-09-21,7,1,SKU034,487,47,534
2025-09-21,7,2,SKU037,281,38,319
2025-09-21,7,3,SKU020,730,84,814
2025-09-21,8,1,SKU039,392,55,447
2025-09-21,8,3,SKU011,312,28,340
2025-09-21,9,2,SKU021,621,66,687
2025-09-21,9,3,SKU023,693,17,710
2025-09-21,10,1,SKU002,410,18,428
2025-09-21,10,2,SKU007,245,9,254
2025-09-21,11,1,SKU040,231,15,246
2025-09-21,11,3,SKU002,496,48,544
2025-09-21,12,1,SKU005,395,37,432
2025-09-21,12,3,SKU028,591,22,613
2025-09-21,13,2,SKU016,208,1,209
2025-09-21,13,3,SKU001,264,28,292
2025-09-21,14,2,SKU034,230,31,261
2025-09-21,14,3,SKU020,759,1,760
2025-09-21,15,1,SKU038,760,9,769
2025-09-21,15,2,SKU037,621,15,636
2025-09-22,1,1,SKU040,793,116,909
2025-09-22,1,3,SKU027,343,50,393
2025-09-22,2,1,SKU005,314,41,355
2025-09-22,2,2,SKU036,758,37,795
2025-09-22,2,3,SKU016,535,54,589
2025-09-22,3,1,SKU031,738,41,779
2025-09-22,3,3,SKU012,644,29,673
2025-09-22,4,1,SKU034,460,40,500
2025-09-22,4,2,SKU023,747,93,840
2025-09-22,5,1,SKU040,581,66,647
2025-09-22,5,3,SKU003,421,26,447
2025-09-22,6,1,SKU002,381,45,426
2025-09-22,6,2,SKU035,300,10,310
2025-09-22,6,3,SKU029,496,66,562
2025-09-22,7,1,SKU030,417,4,421
2025-09-22,7,2,SKU015,222,13,235
2025-09-22,7,3,SKU027,424,39,463
2025-09-22,8,1,SKU017,660,77,737
2025-09-22,8,2,SKU036,600,66,666
2025-09-22,8,3,SKU032,473,4,477
2025-09-22,9,2,SKU036,590,83,673
2025-09-22,9,3,SKU031,645,86,731
2025-09-22,10,1,SKU002,770,21,791
2025-09-22,10,3,SKU034,562,47,609
2025-09-22,11,1,SKU001,695,46,741
2025-09-22,12,1,SKU019,551,30,581
2025-09-22,12,2,SKU036,404,27,431
2025-09-22,12,3,SKU011,715,74,789
2025-09-22,13,1,SKU019,365,8,373
2025-09-22,13,2,SKU013,548,44,592
2025-09-22,13,3,SKU033,482,68,550
2025-09-22,14,1,SKU037,457,21,478
2025-09-22,14,2,SKU006,766,10,776
2025-09-22,15,1,SKU025,510,36,546
2025-09-22,15,2,SKU008,400,52,452
2025-09-22,15,3,SKU013,325,12,337
2025-09-23,1,2,SKU009,781,87,868
2025-09-23,1,3,SKU024,443,57,500
2025-09-23,2,1,SKU009,422,1,423
2025-09-23,2,2,SKU031,219,23,242
2025-09-23,2,3,SKU011,631,64,695
2025-09-23,3,1,SKU027,574,64,638
2025-09-23,3,2,SKU025,232,17,249
2025-09-23,3,3,SKU032,646,68,714
2025-09-23,4,1,SKU017,233,25,258
2025-09-23,4,2,SKU011,520,76,596
2025-09-23,4,3,SKU002,405,35,440
2025-09-23,5,2,SKU012,666,28,694
2025-09-23,5,3,SKU013,621,22,643
2025-09-23,6,1,SKU005,368,34,402
2025-09-23,6,2,SKU025,250,24,274
2025-09-23,6,3,SKU028,651,96,747
2025-09-23,7,1,SKU003,348,10,358
2025-09-23,7,2,SKU002,605,54,659
2025-09-23,7,3,SKU011,765,55,820
2025-09-23,8,1,SKU033,455,63,518
2025-09-23,8,2,SKU029,482,22,504
2025-09-23,8,3,SKU002,676,67,743
2025-09-23,9,1,SKU013,359,36,395
2025-09-23,9,2,SKU008,685,60,745
2025-09-23,9,3,SKU005,317,46,363
2025-09-23,10,1,SKU019,244,24,268
2025-09-23,10,2,SKU028,652,9,661
2025-09-23,10,3,SKU032,499,50,549
2025-09-23,11,2,SKU003,396,36,432
2025-09-23,11,3,SKU015,465,44,509
2025-09-23,12,1,SKU038,477,3,480
2025-09-23,12,2,SKU039,583,14,597
2025-09-23,12,3,SKU012,750,42,792
2025-09-23,13,1,SKU023,324,40,364
2025-09-23,13,2,SKU005,467,49,516
2025-09-23,13,3,SKU037,316,4,320
2025-09-23,14,1,SKU009,212,7,219
2025-09-23,14,2,SKU027,757,46,803
2025-09-23,14,3,SKU021,536,59,595
2025-09-23,15,1,SKU021,298,28,326
2025-09-23,15,2,SKU004,359,51,410
2025-09-24,1,1,SKU001,278,29,307
2025-09-24,1,2,SKU038,304,27,331
2025-09-24,1,3,SKU032,672,73,745
2025-09-24,2,1,SKU006,333,33,366
2025-09-24,2,3,SKU035,438,52,490
2025-09-24,3,2,SKU016,210,17,227
2025-09-24,3,3,SKU030,776,97,873
2025-09-24,4,1,SKU013,759,81,840
2025-09-24,4,2,SKU017,713,90,803
2025-09-24,4,3,SKU002,237,9,246
2025-09-24,5,1,SKU036,426,19,445
2025-09-24,5,2,SKU039,269,39,308
2025-09-24,6,1,SKU029,636,38,674
2025-09-24,6,2,SKU021,336,2,338
2025-09-24,6,3,SKU038,417,9,426
2025-09-24,7,1,SKU020,602,40,642
2025-09-24,8,1,SKU037,368,23,391
2025-09-24,8,2,SKU039,364,8,372
2025-09-24,8,3,SKU028,535,38,573
2025-09-24,9,1,SKU015,352,11,363
2025-09-24,9,2,SKU030,286,6,292
2025-09-24,9,3,SKU027,248,35,283
2025-09-24,10,1,SKU027,281,30,311
2025-09-24,10,2,SKU001,640,94,734
2025-09-24,10,3,SKU020,486,43,529
2025-09-24,11,1,SKU005,689,78,767
2025-09-24,11,2,SKU037,682,14,696
2025-09-24,11,3,SKU001,506,7,513
2025-09-24,12,1,SKU015,295,41,336
2025-09-24,12,2,SKU018,799,6,805
2025-09-24,12,3,SKU033,597,30,627
2025-09-24,13,1,SKU035,594,76,670
2025-09-24,13,3,SKU029,638,10,648
2025-09-24,14,1,SKU018,710,80,790
2025-09-24,14,3,SKU001,354,5,359
2025-09-24,15,1,SKU032,658,14,672
2025-09-24,15,2,SKU023,526,19,545
2025-09-24,15,3,SKU031,230,16,246
2025-09-25,1,1,SKU031,397,40,437
2025-09-25,1,2,SKU030,711,16,727
2025-09-25,1,3,SKU034,778,100,878
2025-09-25,2,2,SKU003,474,64,538
2025-09-25,2,3,SKU018,442,11,453
2025-09-25,3,1,SKU019,239,2,241
2025-09-25,3,3,SKU017,412,14,426
2025-09-25,4,1,SKU019,272,1,273
2025-09-25,4,2,SKU034,625,0,625
2025-09-25,5,1,SKU011,600,14,614
2025-09-25,5,2,SKU030,510,39,549
2025-09-25,5,3,SKU016,437,32,469
2025-09-25,6,1,SKU037,581,4,585
2025-09-25,6,2,SKU022,685,72,757
2025-09-25,6,3,SKU038,638,24,662
2025-09-25,7,1,SKU025,454,54,508
2025-09-25,7,2,SKU005,368,4,372
2025-09-25,7,3,SKU002,565,35,600
2025-09-25,8,1,SKU019,521,9,530
2025-09-25,8,2,SKU034,442,46,488
2025-09-25,8,3,SKU019,444,43,487
2025-09-25,9,1,SKU017,232,28,260
2025-09-25,9,2,SKU031,463,23,486
2025-09-25,10,1,SKU037,302,15,317
2025-09-25,10,2,SKU010,565,39,604
2025-09-25,10,3,SKU015,552,69,621
2025-09-25,11,1,SKU007,362,9,371
2025-09-25,11,2,SKU001,552,80,632
2025-09-25,12,1,SKU030,519,37,556
2025-09-25,12,3,SKU034,329,47,376
2025-09-25,14,1,SKU035,778,99,877
2025-09-25,14,2,SKU016,284,4,288
2025-09-25,14,3,SKU010,619,10,629
2025-09-25,15,2,SKU038,577,57,634
2025-09-25,15,3,SKU031,524,21,545
2025-09-26,1,1,SKU023,612,37,649
2025-09-26,1,2,SKU017,416,1,417
2025-09-26,2,1,SKU004,273,31,304
2025-09-26,2,2,SKU029,284,5,289
2025-09-26,2,3,SKU007,287,15,302
2025-09-26,3,2,SKU026,213,29,242
2025-09-26,3,3,SKU007,699,64,763
2025-09-26,4,1,SKU030,414,37,451
2025-09-26,4,2,SKU006,249,5,254
2025-09-26,4,3,SKU022,232,31,263
2025-09-26,5,1,SKU006,681,69,750
2025-09-26,5,2,SKU033,207,10,217
2025-09-26,5,3,SKU002,227,2,229
2025-09-26,6,2,SKU008,478,47,525
2025-09-26,6,3,SKU009,639,72,711
2025-09-26,7,1,SKU027,364,46,410
2025-09-26,7,2,SKU015,311,31,342
2025-09-26,7,3,SKU023,260,33,293
2025-09-26,8,1,SKU012,719,50,769
2025-09-26,8,3,SKU015,468,8,476
2025-09-26,9,1,SKU011,364,37,401
2025-09-26,9,2,SKU009,272,22,294
2025-09-26,9,3,SKU029,269,0,269
2025-09-26,10,2,SKU040,799,6,805
2025-09-26,10,3,SKU028,254,31,285
2025-09-26,11,1,SKU002,435,2,437
2025-09-26,11,2,SKU023,245,23,268
2025-09-26,11,3,SKU033,278,11,289
2025-09-26,12,1,SKU002,502,36,538
2025-09-26,12,2,SKU038,427,11,438
2025-09-26,12,3,SKU028,785,55,840
2025-09-26,13,1,SKU025,492,28,520
2025-09-26,13,2,SKU029,356,49,405
2025-09-26,13,3,SKU013,681,10,691
2025-09-26,14,1,SKU009,750,17,767
2025-09-26,14,2,SKU009,374,50,424
2025-09-26,14,3,SKU017,685,56,741
2025-09-26,15,2,SKU009,353,2,355
2025-09-26,15,3,SKU021,717,63,780
2025-09-27,1,1,SKU026,207,11,218
2025-09-27,1,2,SKU036,623,8,631
2025-09-27,1,3,SKU035,583,81,664
2025-09-27,2,1,SKU035,654,90,744
2025-09-27,2,2,SKU013,482,50,532
2025-09-27,2,3,SKU003,797,100,897
2025-09-27,3,2,SKU010,493,43,536
2025-09-27,3,3,SKU036,605,48,653
2025-09-27,4,1,SKU007,485,9,494
2025-09-27,4,3,SKU003,585,6,591
2025-09-27,5,1,SKU032,672,44,716
2025-09-27,5,3,SKU037,630,4,634
2025-09-27,6,1,SKU012,482,11,493
2025-09-27,6,2,SKU023,755,0,755
2025-09-27,6,3,SKU032,486,46,532
2025-09-27,7,1,SKU025,612,17,629
2025-09-27,7,2,SKU034,763,88,851
2025-09-27,7,3,SKU018,770,36,806
2025-09-27,8,1,SKU010,729,79,808
2025-09-27,8,2,SKU014,577,32,609
2025-09-27,9,1,SKU023,366,46,412
2025-09-27,9,2,SKU022,492,10,502
2025-09-27,9,3,SKU013,375,20,395
2025-09-27,10,2,SKU027,760,2,762
2025-09-27,10,3,SKU014,248,7,255
2025-09-27,11,1,SKU020,260,12,272
2025-09-27,11,2,SKU028,566,54,620
2025-09-27,11,3,SKU038,468,37,505
2025-09-27,12,1,SKU036,516,53,569
2025-09-27,12,2,SKU030,359,50,409
2025-09-27,13,1,SKU003,510,4,514
2025-09-27,13,2,SKU001,666,23,689
2025-09-27,13,3,SKU018,275,17,292
2025-09-27,14,2,SKU039,674,25,699
2025-09-27,15,1,SKU035,491,57,548
2025-09-27,15,2,SKU038,318,16,334
2025-09-28,1,1,SKU039,377,33,410
2025-09-28,1,2,SKU006,450,14,464
2025-09-28,1,3,SKU039,632,34,666
2025-09-28,2,1,SKU005,438,64,502
2025-09-28,2,2,SKU036,743,34,777
2025-09-28,2,3,SKU020,353,10,363
2025-09-28,3,1,SKU009,435,63,498
2025-09-28,3,2,SKU007,254,12,266
2025-09-28,3,3,SKU001,523,75,598
2025-09-28,4,1,SKU021,425,3,428
2025-09-28,4,3,SKU019,379,24,403
2025-09-28,5,1,SKU022,498,69,567
2025-09-28,5,2,SKU008,327,9,336
2025-09-28,5,3,SKU008,204,2,206
2025-09-28,6,3,SKU022,211,14,225
2025-09-28,7,1,SKU034,521,16,537
2025-09-28,7,3,SKU004,607,42,649
2025-09-28,8,1,SKU011,441,54,495
2025-09-28,8,3,SKU020,572,57,629
2025-09-28,9,1,SKU001,246,28,274
2025-09-28,9,2,SKU013,760,0,760
2025-09-28,9,3,SKU036,515,71,586
2025-09-28,10,1,SKU013,397,15,412
2025-09-28,10,2,SKU002,654,0,654
2025-09-28,11,1,SKU025,441,26,467
2025-09-28,11,2,SKU009,658,93,751
2025-09-28,12,1,SKU040,489,29,518
2025-09-28,12,2,SKU034,648,85,733
2025-09-28,12,3,SKU020,711,13,724
2025-09-28,13,1,SKU033,523,10,533
2025-09-28,13,2,SKU010,234,19,253
2025-09-28,13,3,SKU019,566,75,641
2025-09-28,14,1,SKU034,501,66,567
2025-09-28,14,3,SKU018,456,57,513
2025-09-28,15,1,SKU031,489,8,497
2025-09-28,15,2,SKU011,570,7,577
2025-09-29,1,1,SKU001,780,45,825
2025-09-29,1,2,SKU031,790,17,807
2025-09-29,2,1,SKU023,430,63,493
2025-09-29,2,2,SKU036,729,25,754
2025-09-29,2,3,SKU020,547,53,600
2025-09-29,3,1,SKU037,648,15,663
2025-09-29,4,1,SKU013,475,52,527
2025-09-29,4,2,SKU009,415,33,448
2025-09-29,4,3,SKU040,749,38,787
2025-09-29,5,2,SKU011,597,87,684
2025-09-29,6,2,SKU027,787,68,855
2025-09-29,6,3,SKU035,493,5,498
2025-09-29,7,1,SKU004,668,68,736
2025-09-29,7,2,SKU012,318,10,328
2025-09-29,7,3,SKU002,397,4,401
2025-09-29,8,1,SKU040,408,10,418
2025-09-29,8,2,SKU021,752,26,778
2025-09-29,8,3,SKU008,735,25,760
2025-09-29,9,1,SKU016,335,25,360
2025-09-29,9,2,SKU028,292,7,299
2025-09-29,9,3,SKU035,794,41,835
2025-09-29,10,1,SKU010,355,44,399
2025-09-29,10,3,SKU016,392,0,392
2025-09-29,11,1,SKU036,733,63,796
2025-09-29,11,2,SKU018,765,20,785
2025-09-29,11,3,SKU023,450,33,483
2025-09-29,12,1,SKU029,760,113,873
2025-09-29,12,2,SKU003,318,34,352
2025-09-29,12,3,SKU013,477,65,542
2025-09-29,13,1,SKU013,441,10,451
2025-09-29,13,2,SKU015,286,10,296
2025-09-29,13,3,SKU033,523,39,562
2025-09-29,14,1,SKU031,379,7,386
2025-09-29,14,2,SKU033,383,43,426
2025-09-29,14,3,SKU013,780,39,819
2025-09-29,15,3,SKU014,324,6,330
2025-09-30,1,1,SKU015,561,38,599
2025-09-30,1,2,SKU038,279,14,293
2025-09-30,1,3,SKU027,755,13,768
2025-09-30,2,1,SKU033,725,11,736
2025-09-30,2,3,SKU030,226,20,246
2025-09-30,3,1,SKU036,767,64,831
2025-09-30,3,2,SKU009,331,2,333
2025-09-30,3,3,SKU016,454,10,464
2025-09-30,4,1,SKU024,310,32,342
2025-09-30,4,2,SKU007,333,1,334
2025-09-30,4,3,SKU019,670,7,677
2025-09-30,5,1,SKU004,324,18,342
2025-09-30,5,3,SKU009,526,64,590
2025-09-30,6,1,SKU005,448,64,512
2025-09-30,6,2,SKU037,312,23,335
2025-09-30,6,3,SKU021,660,26,686
2025-09-30,7,1,SKU010,664,58,722
2025-09-30,7,3,SKU028,656,46,702
2025-09-30,8,1,SKU033,377,25,402
2025-09-30,8,2,SKU031,505,42,547
2025-09-30,8,3,SKU027,743,66,809
2025-09-30,9,1,SKU038,264,14,278
2025-09-30,9,3,SKU016,551,3,554
2025-09-30,10,1,SKU035,402,35,437
2025-09-30,11,3,SKU036,324,43,367
2025-09-30,12,1,SKU034,439,59,498
2025-09-30,12,2,SKU023,382,6,388
2025-09-30,12,3,SKU005,494,56,550
2025-09-30,13,1,SKU011,261,13,274
2025-09-30,13,2,SKU030,636,1,637
2025-09-30,13,3,SKU024,547,22,569
2025-09-30,14,1,SKU028,271,3,274
2025-09-30,14,2,SKU035,278,32,310
2025-09-30,14,3,SKU018,583,21,604
2025-09-30,15,1,SKU013,611,67,678
2025-09-30,15,2,SKU015,737,31,768
2025-09-30,15,3,SKU016,759,107,866
